,摘要,关键词,第一章,第二章,第三章,第四章,第五章,总词频,加权得分
vlc,4,0,11,22,0,2,1,40,8.85
vlc系统,8,0,8,5,1,0,0,22,9.866666666666667
调光,1,1,16,17,7,12,3,57,12.441666666666666
o-ofdm调制,1,0,5,16,6,1,1,30,5.558333333333334
ofdm,4,0,7,14,6,4,1,36,9.283333333333333
通信,2,0,4,15,3,2,0,26,5.583333333333333
数字调光,0,0,3,9,0,0,0,12,1.5
模拟调光,2,0,6,9,5,6,2,30,7.016666666666667
o-ofdm,1,0,3,3,0,0,0,7,1.75
频谱效率,1,0,10,21,13,7,0,52,9.708333333333332
调光功能,1,0,3,3,0,0,0,7,1.75
调光技术,6,0,11,16,1,4,9,47,12.758333333333333
性能,1,0,6,13,8,5,2,35,7.0
led,1,0,3,5,4,6,0,19,4.416666666666666
发光亮度,1,0,2,1,8,0,1,13,3.55
调光技,0,0,4,3,0,0,0,7,0.875
照明,1,0,3,8,0,1,0,13,2.6166666666666667
dm,3,0,2,1,1,0,0,7,3.6166666666666667
ofdm调制,1,0,4,5,1,1,0,12,2.6083333333333334
信号,1,0,11,49,30,25,1,117,22.03333333333333
rf-ofdm,1,0,2,1,0,0,0,4,1.375
亮度,5,0,9,13,21,16,2,66,17.175
无线射频频谱资源,0,0,2,0,0,0,0,2,0.25
系统调光技术,0,0,3,0,1,0,1,5,0.8583333333333334
多链路,1,0,8,4,0,7,1,21,4.433333333333334
单链路,0,0,6,6,6,3,2,23,4.158333333333333
调制,5,0,2,22,14,10,3,56,14.525
调光性能,2,0,2,1,4,0,2,11,3.825
多链路系统,0,0,4,0,0,8,3,15,3.158333333333333
单链路vlc,0,0,1,0,0,0,0,1,0.125
模拟调光性能,0,0,2,1,1,0,0,4,0.6166666666666667
系统,0,0,3,4,3,5,4,19,3.775
速率,0,0,1,5,0,0,0,6,0.75
复杂度,0,0,1,4,1,0,0,6,0.8666666666666667
快速开关特性,0,0,1,1,0,0,0,2,0.25
通信性能,3,0,5,3,14,6,2,33,9.316666666666666
调制信号,0,0,1,3,0,0,0,4,0.5
幅度,0,0,1,10,1,0,0,12,1.6166666666666667
占空比,0,0,1,8,0,0,0,9,1.125
正向电流,0,0,1,1,0,0,0,2,0.25
正向驱动电流,0,0,1,1,0,0,0,2,0.25
ofdm-vlc系统,3,0,10,13,6,5,6,43,9.983333333333334
ofdm-vlc,0,0,3,1,0,1,1,6,0.9833333333333334
单极化,0,0,1,1,0,0,0,2,0.25
发送信号,0,0,3,3,11,6,0,23,4.858333333333333
调制方案,0,0,1,0,0,0,0,1,0.125
opticalofdm,2,0,1,3,0,0,0,6,2.5
flip-ofdmu,0,0,1,0,0,0,0,1,0.125
unipolarofdm,0,0,1,1,0,0,0,2,0.25
u-ofdm,0,0,1,4,0,0,0,5,0.625
clippedoptical,0,0,1,0,0,0,0,1,0.125
asymmetrically,0,0,1,1,0,0,0,2,0.25
aco-ofdm,1,0,6,10,29,3,1,50,10.975
doptical,0,0,2,0,1,0,0,3,0.4916666666666667
directcurrent,1,0,1,1,0,0,0,3,1.25
dco-ofdm,1,0,9,16,36,13,4,79,16.933333333333334
复ofdm信号,0,0,1,0,0,0,0,1,0.125
实信号,1,0,1,6,1,0,0,9,2.1166666666666667
directdetection,1,0,1,0,0,0,0,2,1.125
intensitymodulation,1,0,1,0,0,0,0,2,1.125
直接检测,1,0,1,0,0,0,0,2,1.125
强度调制,1,0,1,1,0,0,0,3,1.25
multiplex,1,0,1,0,0,0,0,2,1.125
ion,0,0,1,0,1,0,0,2,0.3666666666666667
orthogonalfrequency,1,0,1,0,0,0,0,2,1.125
正交频分复用,1,0,1,0,0,0,0,2,1.125
radiofrequency,1,0,1,0,0,0,0,2,1.125
射频,1,0,1,1,0,0,0,3,1.25
抗码间干扰特性,0,0,1,0,0,0,0,1,0.125
通信速率,1,0,1,5,0,2,0,9,2.2333333333333334
高速通信,1,0,2,3,0,1,0,7,1.8666666666666667
带宽,0,0,1,7,0,1,0,9,1.2416666666666667
调制带宽,0,0,1,2,0,0,0,3,0.375
高速调制特性,0,0,1,0,0,0,0,1,0.125
通信功能,0,0,1,0,0,0,0,1,0.125
生态效益,1,0,1,1,0,0,1,4,1.4916666666666667
能源节约,1,0,1,1,0,0,0,3,1.25
照明系统,1,0,1,2,0,0,0,4,1.375
led照明,0,0,1,0,0,0,0,1,0.125
led照明装置,0,0,1,0,0,0,0,1,0.125
可见光频谱资源,0,0,1,0,0,0,0,1,0.125
频段,0,0,1,0,0,0,0,1,0.125
vlc)口,0,0,1,0,0,0,0,1,0.125
visiblelightcommunication,1,0,1,0,0,0,0,2,1.125
可见光通信,1,1,2,41,0,0,4,49,9.341666666666667
照明装置,1,0,1,0,0,0,0,2,1.125
荧光灯,0,0,1,0,0,0,0,1,0.125
白炽灯,0,0,1,0,0,0,0,1,0.125
功耗,1,0,1,0,0,0,0,2,1.125
lightemittingdio,1,0,1,0,0,0,0,2,1.125
发光二极管,1,0,1,0,0,0,0,2,1.125
固态照明技术,0,0,1,1,0,0,0,2,0.25
高速无线通信,0,0,1,0,0,0,0,1,0.125
物联网,0,0,1,0,0,0,0,1,0.125
移动互联网,0,0,1,0,0,0,0,1,0.125
调光参数,0,0,7,0,2,0,0,9,1.3583333333333334
st-ofdm,1,0,3,0,0,9,0,13,3.55
空间,2,0,3,0,0,6,1,12,4.066666666666666
频谱效率性能,0,0,3,0,0,3,0,6,1.1
dco-ofdm调制,1,0,3,2,2,3,0,11,2.833333333333333
仿真,0,0,5,0,3,6,0,14,2.8
接收信噪比,0,0,5,1,1,2,0,9,1.475
削峰噪声,0,0,5,0,9,3,0,17,3.525
aad-ofdm,1,0,2,0,4,8,1,16,4.391666666666667
sd-ofdm,1,0,2,1,0,8,1,13,3.55
发送端,0,0,2,5,9,5,1,22,4.5
lightcommunication,0,0,2,0,0,0,0,2,0.25
ber,0,0,2,1,3,3,0,9,1.825
通信约束,0,0,2,0,0,0,0,2,0.25
可见光通信系统,0,0,4,13,0,0,1,18,2.3666666666666667
withdimmingcontrol,0,0,1,0,0,0,0,1,0.125
opticalofdmforvisible,0,0,1,0,0,0,0,1,0.125
transmitted,0,0,1,0,0,0,0,1,0.125
separately,0,0,1,0,0,1,0,2,0.3666666666666667
宽范围调光,0,0,1,0,0,1,0,2,0.3666666666666667
仿真结,0,0,1,0,0,0,0,1,0.125
系统性能,0,0,1,0,0,0,0,1,0.125
空间调光,0,0,1,0,0,3,0,4,0.85
空间特性,0,0,1,0,0,0,0,1,0.125
器件,0,0,1,0,0,0,0,1,0.125
单链路系统,0,0,1,0,1,2,2,6,1.3333333333333333
st-ofdm调制,0,0,1,0,0,4,2,7,1.575
叠加性,0,0,1,0,0,1,1,3,0.6083333333333334
极性,0,0,1,2,1,1,0,5,0.8583333333333334
dco-ofdm信号,1,0,1,6,9,6,0,23,5.5
双极,0,0,1,0,0,1,0,2,0.3666666666666667
多链路场景,0,0,1,3,0,0,1,5,0.7416666666666667
光ofdm调制,0,0,1,0,0,0,0,1,0.125
高频谱效率,0,0,1,0,0,1,0,2,0.3666666666666667
withdimmingcontrolx,0,0,1,0,0,0,0,1,0.125
rent,0,0,1,0,1,0,0,2,0.3666666666666667
directc,0,0,1,0,0,0,0,1,0.125
asymmetrical,0,0,1,0,1,0,0,2,0.3666666666666667
二分穷举搜索,0,0,1,0,0,0,0,1,0.125
门限,0,0,1,0,0,0,0,1,0.125
切换门限,0,0,1,0,0,0,0,1,0.125
亮度水平,0,0,2,0,1,0,0,3,0.4916666666666667
调制方,0,0,1,0,0,0,0,1,0.125
单极性特性,0,0,1,1,0,0,0,2,0.25
aco-ofdm调制,0,0,1,4,4,0,1,10,1.8333333333333333
均比特性,0,0,1,0,0,0,0,1,0.125
双极性信号,0,0,1,11,0,6,1,19,3.1916666666666664
性能曲线,0,0,2,0,0,0,0,2,0.25
参数,0,0,1,2,2,4,0,9,1.825
光功率,0,0,1,1,35,4,0,41,9.675
流偏置,0,0,1,0,0,0,0,1,0.125
比例因子,0,0,1,0,13,4,0,18,4.233333333333333
系统模型,0,0,3,0,0,0,0,3,0.375
ear,1,0,1,0,0,0,0,2,1.125
innovation,1,0,1,0,0,0,0,2,1.125
huawei,1,0,1,0,0,0,0,2,1.125
华为创新研究,1,0,1,0,0,0,0,2,1.125
仿真参数,0,0,4,5,4,3,0,16,2.8166666666666664
调光亮度水平,0,0,2,0,0,0,0,2,0.25
仿真分,0,0,2,0,0,0,0,2,0.25
通信性能约束,0,0,2,0,0,0,0,2,0.25
建模信道,0,0,2,0,0,0,0,2,0.25
接收信号,0,0,2,2,5,5,0,14,2.9166666666666665
评估系统,0,0,1,0,0,0,0,1,0.125
性能评估,0,0,1,0,0,0,0,1,0.125
仿真验证,0,0,1,0,0,1,0,2,0.3666666666666667
lamp,1,0,1,0,0,7,1,10,3.0583333333333336
联合调光算法,0,0,1,0,0,0,0,1,0.125
信道增益,0,0,1,0,1,2,0,4,0.85
高速切换特性,0,0,0,1,0,0,0,1,0.125
可见光频谱,0,0,0,1,0,0,0,1,0.125
射频频谱资源,0,0,0,1,0,0,0,1,0.125
无线互联网,0,0,0,1,0,0,0,1,0.125
信息科技,0,0,0,1,0,0,0,1,0.125
电磁频谱,0,0,0,1,0,0,0,1,0.125
无线电波,0,0,0,1,0,0,0,1,0.125
信息,0,0,0,4,1,0,0,5,0.7416666666666667
射频信号,0,0,0,1,0,0,0,1,0.125
无线通信,0,0,0,5,0,0,0,5,0.625
白光,0,0,0,4,0,0,0,4,0.5
线性区间,0,0,0,2,0,0,0,2,0.25
调制电流信号,0,0,0,1,0,0,0,1,0.125
非线性失真,0,0,0,1,1,0,0,2,0.3666666666666667
接收端,0,0,0,15,10,7,1,33,6.225
调制特性曲线,0,0,0,1,0,0,0,1,0.125
光通信,0,0,0,1,0,0,0,1,0.125
射频通信,0,0,0,2,0,0,0,2,0.25
强度,0,0,0,3,0,0,0,3,0.375
调制光,0,0,0,1,0,0,0,1,0.125
三基色,0,0,0,1,0,0,0,1,0.125
rgb,0,0,0,1,0,0,0,1,0.125
荧光粉,0,0,0,1,0,0,0,1,0.125
蓝光技,0,0,0,1,0,0,0,1,0.125
光信号,0,0,0,6,2,2,0,10,1.7166666666666668
电信号,0,0,0,4,2,0,0,6,0.9833333333333334
调制器,0,0,0,2,0,0,0,2,0.25
原始信号,0,0,0,2,1,0,0,3,0.4916666666666667
信源,0,0,0,2,0,0,0,2,0.25
雪崩光电二极管,0,0,0,4,0,0,0,4,0.5
光电检测器,0,0,0,4,0,0,0,4,0.5
pin光电二极管,0,0,0,3,0,0,0,3,0.375
光电流增益,0,0,0,2,0,0,0,2,0.25
系统电路,0,0,0,1,0,0,0,1,0.125
线性度,0,0,0,1,0,0,0,1,0.125
温度补偿电路,0,0,0,1,0,0,0,1,0.125
无高偏置电压,0,0,0,1,0,0,0,1,0.125
电路,0,0,0,1,0,0,0,1,0.125
性质光电二极管,0,0,0,1,0,0,0,1,0.125
转换性能,0,0,0,1,0,0,0,1,0.125
接收性能,0,0,0,1,0,0,0,1,0.125
光电转换效率,0,0,0,1,0,0,0,1,0.125
功率,0,0,0,4,3,0,0,7,1.225
接收光信号,0,0,0,1,0,0,0,1,0.125
avalanchephotodio,0,0,0,1,0,0,0,1,0.125
光电二极管,0,0,0,3,1,0,0,4,0.6166666666666667
negative,0,0,0,1,0,0,0,1,0.125
intrmsic-,0,0,0,1,0,0,0,1,0.125
pin,0,0,0,1,0,0,0,1,0.125
信宿解调,0,0,0,1,0,0,0,1,0.125
解调器,0,0,0,2,0,0,0,2,0.25
光电检测装置,0,0,0,1,0,0,0,1,0.125
链路,0,0,0,7,0,0,0,7,0.875
接收器,0,0,0,11,0,0,0,11,1.375
nlos链路,0,0,0,7,0,0,0,7,0.875
信道,0,0,0,13,2,4,0,19,3.075
los链路,0,0,0,7,1,2,0,10,1.6
发射器,0,0,0,5,0,0,0,5,0.625
信道模型,0,0,0,4,0,1,0,5,0.7416666666666667
los链路信道模型,0,0,0,3,0,0,0,3,0.375
视距链路,0,0,0,3,0,0,0,3,0.375
障碍物,0,0,0,4,0,0,0,4,0.5
nlos链路信道模型,0,0,0,2,0,0,0,2,0.25
增益,0,0,0,3,0,1,0,4,0.6166666666666667
信道直流增益,0,0,0,2,0,0,0,2,0.25
光强,0,0,0,2,0,0,0,2,0.25
多径效应,0,0,0,2,0,0,0,2,0.25
直射光,0,0,0,2,0,0,0,2,0.25
非视距链路,0,0,0,2,0,0,0,2,0.25
定向链路,0,0,0,2,0,0,0,2,0.25
室内场景,0,0,0,2,0,0,0,2,0.25
反射分量,0,0,0,1,0,0,0,1,0.125
los链路分量,0,0,0,1,0,0,0,1,0.125
反射,0,0,0,1,0,0,0,1,0.125
折射率,0,0,0,1,0,1,0,2,0.3666666666666667
光汇聚器,0,0,0,1,0,0,0,1,0.125
视场半角,0,0,0,1,0,1,0,2,0.3666666666666667
光滤波透镜,0,0,0,1,0,0,0,1,0.125
入射角,0,0,0,1,0,1,0,2,0.3666666666666667
辐射角,0,0,0,1,0,1,0,2,0.3666666666666667
距离,0,0,0,2,0,2,0,4,0.7333333333333334
探测面平面面积,0,0,0,1,0,0,0,1,0.125
半功率半角,0,0,0,1,0,1,0,2,0.3666666666666667
朗伯阶数,0,0,0,1,0,0,0,1,0.125
郎伯辐射模型,0,0,0,1,0,0,0,1,0.125
辐射模型,0,0,0,1,0,0,0,1,0.125
白光led,0,0,0,1,0,0,0,1,0.125
直流增益,0,0,0,1,0,0,0,1,0.125
信道损耗,0,0,0,1,0,0,0,1,0.125
背景光,0,0,0,1,0,0,0,1,0.125
移动性,0,0,0,1,0,0,0,1,0.125
os链路,0,0,0,1,0,0,0,1,0.125
码间干扰,0,0,0,1,0,0,0,1,0.125
阴影效应,0,0,0,2,0,0,0,2,0.25
指向性,0,0,0,1,0,0,0,1,0.125
接收视角,0,0,0,1,0,0,0,1,0.125
漫射链路,0,0,0,1,0,0,0,1,0.125
收发器,0,0,0,1,0,0,0,1,0.125
高速率数据调制,0,0,0,1,0,0,0,1,0.125
光功率利用率,0,0,0,1,0,0,0,1,0.125
漫发射光信号,0,0,0,1,0,0,0,1,0.125
non-lineofsight,0,0,0,1,0,0,0,1,0.125
lineofsight,0,0,0,1,0,0,0,1,0.125
视距,0,0,0,1,0,0,0,1,0.125
非定向器件,0,0,0,1,0,0,0,1,0.125
非定向链路,0,0,0,1,0,0,0,1,0.125
定向接收器,0,0,0,1,0,0,0,1,0.125
定向发射器,0,0,0,1,0,0,0,1,0.125
混合链路,0,0,0,1,0,0,0,1,0.125
室内可见光通信链路,0,0,0,1,0,0,0,1,0.125
墙面反射,0,0,0,1,0,0,0,1,0.125
家具摆设,0,0,0,1,0,0,0,1,0.125
室内灯光,0,0,0,1,0,0,0,1,0.125
太阳光,0,0,0,1,0,0,0,1,0.125
建筑,0,0,0,1,0,0,0,1,0.125
天气,0,0,0,1,0,0,0,1,0.125
室外可见光通信信道,0,0,0,1,0,0,0,1,0.125
无线信道,0,0,0,2,0,0,0,2,0.25
有线通信信道,0,0,0,1,0,0,0,1,0.125
通信系统,0,0,0,3,2,0,0,5,0.8583333333333334
媒介,0,0,0,1,0,0,0,1,0.125
信号传输,0,0,0,1,0,0,0,1,0.125
光电转化,0,0,0,1,0,0,0,1,0.125
电光转换,0,0,0,1,0,0,0,1,0.125
信宿,0,0,0,1,0,0,0,1,0.125
光电转换装置,0,0,0,1,0,0,0,1,0.125
自由空间,0,0,0,2,0,1,0,3,0.4916666666666667
1vlc系统,0,0,0,1,0,0,0,1,0.125
可见光,0,0,0,4,0,0,0,4,0.5
可见光波段,0,0,0,4,0,0,0,4,0.5
红外,0,0,0,3,0,0,0,3,0.375
上行链路,0,0,0,3,0,0,0,3,0.375
上行链路技术,0,0,0,2,0,0,0,2,0.25
照明设备,0,0,0,2,0,0,0,2,0.25
收发端,0,0,0,2,0,0,0,2,0.25
路径损耗,0,0,0,2,0,0,0,2,0.25
光强度,0,0,0,3,0,0,0,3,0.375
光波,0,0,0,2,0,0,0,2,0.25
rf通信,0,0,0,2,0,0,0,2,0.25
安全保密性,0,0,0,2,0,0,0,2,0.25
无线技术,0,0,0,1,0,0,0,1,0.125
组网,0,0,0,2,0,0,0,2,0.25
无线上,0,0,0,1,0,0,0,1,0.125
红外上行信号,0,0,0,1,0,0,0,1,0.125
上行光信号,0,0,0,1,0,0,0,1,0.125
无线口,0,0,0,1,0,0,0,1,0.125
下行通信,0,0,0,1,0,0,0,1,0.125
干扰,0,0,0,1,0,0,0,1,0.125
环境光,0,0,0,1,0,0,0,1,0.125
太阳,0,0,0,1,0,0,0,1,0.125
环境光干扰,0,0,0,1,0,0,0,1,0.125
短距离通信,0,0,0,1,0,0,0,1,0.125
接收面积,0,0,0,1,1,0,0,2,0.3666666666666667
可见光通信信道,0,0,0,2,0,0,0,2,0.25
智能交通,0,0,0,3,0,0,0,3,0.375
智能家居,0,0,0,1,1,0,0,2,0.3666666666666667
发射基站,0,0,0,1,0,0,0,1,0.125
led照明设施,0,0,0,1,0,0,0,1,0.125
led照明设备,0,0,0,3,0,0,0,3,0.375
基站,0,0,0,1,0,0,0,1,0.125
工厂,0,0,0,1,0,0,0,1,0.125
飞机,0,0,0,1,0,0,0,1,0.125
医院,0,0,0,2,0,0,0,2,0.25
rf敏感领,0,0,0,1,0,0,0,1,0.125
电磁干扰,1,0,0,2,0,0,0,3,1.25
电磁污染,0,0,0,1,0,0,0,1,0.125
电磁辐射,0,0,0,1,0,0,0,1,0.125
可见光波,0,0,0,1,0,0,0,1,0.125
无电磁污染,0,0,0,1,0,0,0,1,0.125
室内可见光通信,0,0,0,1,0,0,0,1,0.125
衍射效应,0,0,0,1,0,0,0,1,0.125
纳米级别,0,0,0,1,0,0,0,1,0.125
波长,0,0,0,1,0,0,0,1,0.125
穿透性,0,0,0,1,0,0,0,1,0.125
电磁波信号,0,0,0,1,0,0,0,1,0.125
实验室速率,0,0,0,1,0,0,0,1,0.125
信噪比,0,0,0,1,1,1,0,3,0.6083333333333334
白光led灯,0,0,0,1,0,0,0,1,0.125
频谱授权,0,0,0,1,0,0,0,1,0.125
通信频谱,0,0,0,1,0,0,0,1,0.125
无线频谱资源,0,0,0,1,0,0,0,1,0.125
频谱资源,0,0,0,1,0,0,1,2,0.3666666666666667
无线通信技术,1,0,0,1,0,0,0,2,1.125
定位,0,0,0,3,0,0,0,3,0.375
定位算法,0,0,0,2,0,0,0,2,0.25
室内定位,0,0,0,2,0,0,0,2,0.25
道路故障检测,0,0,0,1,0,0,0,1,0.125
路况监测,0,0,0,1,0,0,0,1,0.125
车辆调度,0,0,0,1,0,0,0,1,0.125
信息交互,0,0,0,1,0,0,0,1,0.125
交通控制中心,0,0,0,1,0,0,0,1,0.125
可见光通信技术,0,0,0,2,0,0,0,2,0.25
交通系统,0,0,0,1,0,0,0,1,0.125
intelligenttransportationsystem,0,0,0,1,0,0,0,1,0.125
智能交通系统,0,0,0,1,0,0,0,1,0.125
无线宽带接入,0,0,0,1,0,0,0,1,0.125
飞机舱,0,0,0,1,0,0,0,1,0.125
电磁敏感区,0,0,0,1,0,0,0,1,0.125
智能家具系统,0,0,0,1,0,0,0,1,0.125
室内宽带接入,0,0,0,1,0,0,0,1,0.125
室内无线宽带接入,0,0,0,1,0,0,0,1,0.125
室内照明设,0,0,0,1,0,0,0,1,0.125
可见光室内定位技术,0,0,0,1,0,0,0,1,0.125
图像传感器,0,0,0,3,0,0,0,3,0.375
法口阴,0,0,0,1,0,0,0,1,0.125
arri,0,0,0,1,0,0,0,1,0.125
angle,0,0,0,1,0,0,0,1,0.125
到达角,0,0,0,1,0,0,0,1,0.125
dsignals,0,0,0,1,0,0,0,1,0.125
tdoa,0,0,0,1,0,0,0,1,0.125
arrival,0,0,0,1,0,0,0,1,0.125
timedifference,0,0,0,1,0,0,0,1,0.125
到达时间差,0,0,0,1,0,0,0,1,0.125
timeofarrival,0,0,0,1,0,0,0,1,0.125
到达时间,0,0,0,1,0,0,0,1,0.125
指纹法,0,0,0,1,0,0,0,1,0.125
近邻法,0,0,0,1,0,0,0,1,0.125
可见光室内定位算法,0,0,0,1,0,0,0,1,0.125
位置信息,0,0,0,1,0,0,0,1,0.125
照明光源,0,0,0,1,0,0,0,1,0.125
rf敏感区通信,0,0,0,1,0,0,0,1,0.125
军事保密通信,0,0,0,1,0,0,0,1,0.125
水下通信,0,0,0,1,0,0,0,1,0.125
室内定位系统,0,0,0,1,0,0,0,1,0.125
子信道,0,0,0,7,0,0,0,7,0.875
时隙,0,0,0,6,0,0,0,6,0.75
时间,0,0,0,6,0,0,0,6,0.75
rz-ook,0,0,0,5,0,0,0,5,0.625
ppm,0,0,0,5,0,0,0,5,0.625
nrz-ook,0,0,0,4,0,0,0,4,0.5
脉冲调制技术,0,0,0,4,0,0,0,4,0.5
并串变换,0,0,0,3,0,0,0,3,0.375
星座映射,0,0,0,5,0,0,0,5,0.625
fft,0,0,0,3,3,0,0,6,1.1
子载波,0,0,0,11,0,0,0,11,1.375
ppm信号,0,0,0,3,0,0,0,3,0.375
模拟信号,0,0,0,3,1,0,0,4,0.6166666666666667
pwm信号,0,0,0,14,0,0,0,14,1.75
光源,0,0,0,5,0,0,0,5,0.625
pam,0,0,0,3,0,0,0,3,0.375
脉冲调制,0,0,0,3,0,0,0,3,0.375
调制技术,1,0,0,4,0,0,0,5,1.5
ofdm符号,0,0,0,3,0,1,0,4,0.6166666666666667
ifft,0,0,0,2,3,1,0,6,1.2166666666666668
解调框,0,0,0,2,0,0,0,2,0.25
串并变换,0,0,0,2,0,0,0,2,0.25
ofdm技术,0,0,0,2,0,0,0,2,0.25
idft,0,0,0,2,0,0,0,2,0.25
dft,0,0,0,2,0,0,0,2,0.25
transfb,0,0,0,2,0,0,0,2,0.25
频谱,0,0,0,2,0,0,0,2,0.25
多载波调制技术,0,0,0,2,0,0,0,2,0.25
波形,0,0,0,2,0,0,0,2,0.25
调制长度,0,0,0,2,0,0,0,2,0.25
ppm符号,0,0,0,2,0,0,0,2,0.25
脉冲载波,0,0,0,2,0,0,0,2,0.25
功率利用率,0,0,0,2,0,0,0,2,0.25
调制波形,0,0,0,2,0,0,0,2,0.25
ook,0,0,0,2,0,0,0,2,0.25
比特,0,0,0,2,0,0,0,2,0.25
pwm,0,0,0,2,0,0,0,2,0.25
00k调制,0,0,0,2,0,0,0,2,0.25
脉冲振幅调制,0,0,0,2,0,0,0,2,0.25
脉冲序列,0,0,0,2,0,0,0,2,0.25
调制脉冲,0,0,0,2,0,0,0,2,0.25
ofdm调制技术,0,0,0,3,0,0,0,3,0.375
调制技,0,0,0,2,0,0,0,2,0.25
星座解映射,0,0,0,1,0,0,0,1,0.125
映射符号,0,0,0,1,0,0,0,1,0.125
串并,0,0,0,1,0,0,0,1,0.125
a/d,0,0,0,1,0,0,0,1,0.125
analogtodigital,0,0,0,1,0,0,0,1,0.125
模数转换,0,0,0,1,0,0,0,1,0.125
amplitudemodulation,0,0,0,1,0,0,0,1,0.125
quadrature,0,0,0,1,0,0,0,1,0.125
digitaltoanalog,0,0,0,1,0,0,0,1,0.125
数模转换,0,0,0,1,0,0,0,1,0.125
子载波采样值,0,0,0,1,0,0,0,1,0.125
数字系统,0,0,0,1,0,0,0,1,0.125
子数据流,0,0,0,1,0,0,0,1,0.125
qam符号,0,0,0,4,4,1,0,9,1.7083333333333333
bpsk符号,0,0,0,1,0,0,0,1,0.125
qam,0,0,0,2,1,0,0,3,0.4916666666666667
正交幅度调制,0,0,0,1,1,0,0,2,0.3666666666666667
bpsk,0,0,0,1,0,0,0,1,0.125
binaryphaseshiftkey,0,0,0,1,0,0,0,1,0.125
二进制相移键控,0,0,0,1,0,0,0,1,0.125
数据流信息,0,0,0,1,0,0,0,1,0.125
ofdm接收端,0,0,0,1,0,0,0,1,0.125
调制框,0,0,0,1,0,0,0,1,0.125
ofdm发送端,0,0,0,1,0,0,0,1,0.125
信道均衡,0,0,0,1,0,0,0,1,0.125
信道带宽,0,0,0,1,0,0,0,1,0.125
平坦性衰落,0,0,0,1,0,0,0,1,0.125
衰落,0,0,0,1,0,0,0,1,0.125
相关带宽,0,0,0,1,0,0,0,1,0.125
isi,1,0,0,1,0,0,0,2,1.125
相互干扰,0,0,0,1,0,0,0,1,0.125
传输,0,0,0,1,0,0,0,1,0.125
低速子数据流,0,0,0,1,0,0,0,1,0.125
高速数据信号,0,0,0,1,0,0,0,1,0.125
窄子信道,0,0,0,1,0,0,0,1,0.125
宽带信道,0,0,0,1,0,0,0,1,0.125
数字调制,0,0,0,1,0,0,0,1,0.125
接收端解调框,0,0,0,1,0,0,0,1,0.125
星座逆映射,0,0,0,1,0,0,0,1,0.125
发送端调制框,0,0,0,1,0,0,0,1,0.125
tw,0,0,0,1,0,0,0,1,0.125
wirelesslocalare,0,0,0,1,0,0,0,1,0.125
无线局域网,0,0,0,1,0,0,0,1,0.125
dvb,0,0,0,1,0,0,0,1,0.125
digitalvideobroadcasting,0,0,0,1,0,0,0,1,0.125
数字视频广播,0,0,0,1,0,0,0,1,0.125
dab,0,0,0,1,0,0,0,1,0.125
broadcasting,0,0,0,1,0,0,0,1,0.125
digitalaudio,0,0,0,1,0,0,0,1,0.125
数字音频广播,0,0,0,1,0,0,0,1,0.125
digitalsubscriberline,0,0,0,1,0,0,0,1,0.125
数字用户线路,0,0,0,1,0,0,0,1,0.125
有线,0,0,0,1,0,0,0,1,0.125
inversefastfouriertransform,0,0,0,1,0,0,0,1,0.125
快速傅里叶逆变换,0,0,0,1,0,0,0,1,0.125
fastfouriertransform,0,0,0,1,0,0,0,1,0.125
快速傅里叶变换,0,0,0,1,0,0,0,1,0.125
快速算法,0,0,0,1,0,0,0,1,0.125
ofdm运算,0,0,0,1,0,0,0,1,0.125
微电子技术,0,0,0,1,0,0,0,1,0.125
数字信号处理,0,0,0,1,0,0,0,1,0.125
ofdm理论,0,0,0,1,0,0,0,1,0.125
inversediscretefourier,0,0,0,1,0,0,0,1,0.125
离散傅里叶逆变换,0,0,0,1,0,0,0,1,0.125
discretefourier,0,0,0,1,0,0,0,1,0.125
离散傅里叶变换,0,0,0,1,0,0,0,1,0.125
ofdm信号,0,0,0,7,8,1,0,16,3.05
符号间隔,0,0,0,1,0,0,0,1,0.125
子载波间隔,0,0,0,1,0,0,0,1,0.125
多载波调制,0,0,0,1,0,0,0,1,0.125
高频无线通信,0,0,0,1,0,0,0,1,0.125
可见光ofdm,0,0,0,1,0,0,0,1,0.125
rf-ofdm调制,1,0,0,1,0,0,0,2,1.125
可见光系统,0,0,0,2,0,0,0,2,0.25
rf-ofdm调制技术,0,0,0,1,0,0,0,1,0.125
抗码间干扰,1,0,0,1,0,0,0,2,1.125
传输速率,0,0,0,2,1,0,0,3,0.4916666666666667
频谱利用率,0,0,0,3,0,0,0,3,0.375
符号,0,0,0,3,0,0,0,3,0.375
解调时,0,0,0,1,0,0,0,1,0.125
符号长度,0,0,0,1,0,0,0,1,0.125
脉冲时隙,0,0,0,1,0,0,0,1,0.125
数据信息,0,0,0,1,0,0,0,1,0.125
00k,0,0,0,1,0,0,0,1,0.125
脉冲信号,0,0,0,1,0,0,0,1,0.125
单脉冲信号,0,0,0,1,0,0,0,1,0.125
时间段,0,0,0,1,0,0,0,1,0.125
m位数据,0,0,0,1,0,0,0,1,0.125
二进制,0,0,0,1,0,0,0,1,0.125
功率控制,0,0,0,1,0,0,0,1,0.125
测量,0,0,0,1,0,0,0,1,0.125
数字化,0,0,0,1,0,0,0,1,0.125
电平,0,0,0,1,0,0,0,1,0.125
pam信号,0,0,0,1,0,0,0,1,0.125
抽样信号,0,0,0,1,0,0,0,1,0.125
脉冲幅度调制,0,0,0,1,0,0,0,1,0.125
窄脉冲串,0,0,0,1,0,0,0,1,0.125
冲激脉冲串,0,0,0,1,0,0,0,1,0.125
抽样定理,0,0,0,1,0,0,0,1,0.125
冲激脉冲序列,0,0,0,1,0,0,0,1,0.125
抗噪性能,0,0,0,1,0,0,0,1,0.125
rf无线通信,0,0,0,1,0,0,0,1,0.125
零电平,0,0,0,1,0,0,0,1,0.125
脉冲,0,0,0,1,0,0,0,1,0.125
tozer,0,0,0,1,0,0,0,1,0.125
归零码,0,0,0,1,0,0,0,1,0.125
notreturntozero,0,0,0,1,0,0,0,1,0.125
非归零码ook,0,0,0,1,0,0,0,1,0.125
幅值控制,0,0,0,1,0,0,0,1,0.125
二进制信号,0,0,0,1,0,0,0,1,0.125
ook调制,0,0,0,1,0,0,0,1,0.125
onoffkeying,0,0,0,1,0,0,0,1,0.125
开关键控调制,0,0,0,1,0,0,0,1,0.125
vppm,0,0,0,1,0,0,0,1,0.125
variableppm,0,0,0,1,0,0,0,1,0.125
可变脉冲位置调制,0,0,0,1,0,0,0,1,0.125
mppm,0,0,0,2,0,0,0,2,0.25
multipleppm,0,0,0,1,0,0,0,1,0.125
多脉冲位置调制,0,0,0,2,0,0,0,2,0.25
pulsepositionmodulation,0,0,0,1,0,0,0,1,0.125
脉冲位置调制,0,0,0,1,0,0,0,1,0.125
pulsewidthmodulation,0,0,0,2,0,0,0,2,0.25
脉冲宽度调制,0,0,0,2,0,0,0,2,0.25
pulseamplitudemodulation,0,0,0,1,0,0,0,1,0.125
相位,0,0,0,1,0,0,0,1,0.125
宽度,0,0,0,1,0,0,0,1,0.125
可见光通信调制,0,0,0,1,0,0,0,1,0.125
传输能力,0,0,0,1,0,0,0,1,0.125
基带信号,0,0,0,1,0,0,0,1,0.125
物理层,0,0,0,1,0,0,0,1,0.125
接收机,0,0,0,4,0,0,0,4,0.5
mimo技术,0,0,0,4,0,0,0,4,0.5
相关,0,0,0,3,0,0,0,3,0.375
高增益,0,0,0,2,0,0,0,2,0.25
los路径,0,0,0,2,0,0,0,2,0.25
校准,0,0,0,2,0,0,0,2,0.25
天线,0,0,0,3,0,0,0,3,0.375
相关性,0,0,0,2,0,0,0,2,0.25
可见光mimo,0,0,0,2,0,0,0,2,0.25
采样率,0,0,0,1,0,0,0,1,0.125
像素,0,0,0,1,0,0,0,1,0.125
硬件成本,0,0,0,1,0,0,0,1,0.125
球状接收机,0,0,0,1,0,0,0,1,0.125
非成像传感器,0,0,0,1,0,0,0,1,0.125
成像传感器,0,0,0,1,0,0,0,1,0.125
吞吐率,0,0,0,1,0,0,0,1,0.125
成像接收机,0,0,0,1,0,0,0,1,0.125
发射机,0,0,0,1,0,0,0,1,0.125
非成像接收机,0,0,0,1,0,0,0,1,0.125
可见光mimo系统,0,0,0,1,0,0,0,1,0.125
非负性,0,0,0,1,0,0,0,1,0.125
强度调制信号,0,0,0,1,0,0,0,1,0.125
亮度控制,0,0,0,1,0,0,0,1,0.125
mimo接收机,0,0,0,1,0,0,0,1,0.125
信道相关性,0,0,0,1,0,0,0,1,0.125
人工神经网络技术,0,0,0,1,0,0,0,1,0.125
交叉线路阻塞,0,0,0,1,0,0,0,1,0.125
功率失衡,0,0,0,1,0,0,0,1,0.125
系统信道,0,0,0,1,0,0,0,1,0.125
sm,0,0,0,1,0,0,0,1,0.125
可靠性,0,0,0,1,2,0,0,3,0.6083333333333334
可见光信道,0,0,0,2,0,0,0,2,0.25
关性,0,0,0,1,0,0,0,1,0.125
vlc信道,0,0,0,1,0,0,0,1,0.125
非相干特性,0,0,0,1,0,0,0,1,0.125
可见光信号,0,0,0,1,0,0,0,1,0.125
spatialmodulation,0,0,0,1,0,1,0,2,0.3666666666666667
空间调制,0,0,0,1,0,1,0,2,0.3666666666666667
smp,0,0,0,1,0,1,0,2,0.3666666666666667
spatialmultiplex,0,0,0,1,0,0,0,1,0.125
空间复用,0,0,0,1,0,0,0,1,0.125
repetitioncode,0,0,0,1,0,0,0,1,0.125
重复编码,0,0,0,1,0,4,0,5,1.0916666666666668
数据流,0,0,0,1,0,0,0,1,0.125
并行信道,0,0,0,1,0,0,0,1,0.125
容量,0,0,0,2,0,0,0,2,0.25
发送功率,0,0,0,1,0,0,0,1,0.125
mimo系统,0,0,0,2,0,0,0,2,0.25
室内照明系统,0,0,0,1,0,0,0,1,0.125
imo技,0,0,0,1,0,0,0,1,0.125
2m,0,0,0,1,0,0,0,1,0.125
水平切换,0,0,0,5,0,0,0,5,0.625
multipleacces,0,0,0,4,0,0,0,4,0.5
小区,0,0,0,3,0,0,0,3,0.375
组网技术,0,0,0,4,0,0,0,4,0.5
垂直切换,0,0,0,2,0,0,0,2,0.25
rf组网,0,0,0,2,0,0,0,2,0.25
多址接入技术,0,0,0,2,0,0,0,2,0.25
可见光网络切换技术,0,0,0,2,0,0,0,2,0.25
网络,0,0,0,2,0,0,0,2,0.25
鲁棒性,0,0,0,1,0,0,0,1,0.125
连通性,0,0,0,1,0,0,0,1,0.125
垂直,0,0,0,1,0,0,0,1,0.125
近紫外等,0,0,0,1,0,0,0,1,0.125
广播特性,0,0,0,1,0,0,0,1,0.125
混合多址技术,0,0,0,1,0,0,0,1,0.125
ofdma,0,0,0,1,0,0,0,1,0.125
division,0,0,0,1,0,0,0,1,0.125
opticalorthogonalfrequency,0,0,0,1,0,0,0,1,0.125
光正交多址,0,0,0,1,0,0,0,1,0.125
scma,0,0,0,1,0,0,0,1,0.125
subcarriermultipleacces,0,0,0,1,0,0,0,1,0.125
副载波多址,0,0,0,1,0,0,0,1,0.125
otdma,0,0,0,1,0,0,0,1,0.125
opticaltimedivision,0,0,0,1,0,0,0,1,0.125
光时分多址,0,0,0,1,0,0,0,1,0.125
ocdma,0,0,0,1,0,0,0,1,0.125
opticalcodedivision,0,0,0,1,0,0,0,1,0.125
光码分多址,0,0,0,1,0,0,0,1,0.125
owdma,0,0,0,1,0,0,0,1,0.125
vision,1,0,0,1,0,0,0,2,1.125
opticalwavelength,0,0,0,1,0,0,0,1,0.125
光波分多址,0,0,0,1,0,0,0,1,0.125
光多址,0,0,0,1,0,0,0,1,0.125
电光垂直切换,0,0,0,1,0,0,0,1,0.125
wlan,0,0,0,1,0,0,0,1,0.125
光电垂直切换,0,0,0,1,0,0,0,1,0.125
热点,0,0,0,1,0,0,0,1,0.125
vlc热点,0,0,0,1,0,0,0,1,0.125
模糊,0,0,0,1,0,0,0,1,0.125
qos,0,0,0,1,0,0,0,1,0.125
垂直切换决策机制,0,0,0,1,0,0,0,1,0.125
模糊逻辑,0,0,0,1,0,0,0,1,0.125
可见光通信组网,0,0,0,1,0,0,0,1,0.125
资源,0,0,0,2,0,0,0,2,0.25
数字调光技术,0,0,0,2,0,0,0,2,0.25
色度漂移,0,0,0,2,0,0,0,2,0.25
模拟调光技术,0,0,0,2,0,0,0,2,0.25
绿色节能,0,0,0,1,0,0,0,1,0.125
调光控制技术,0,0,0,1,0,0,0,1,0.125
智能家居系统,0,0,0,1,0,0,0,1,0.125
电能,0,0,0,1,0,0,0,1,0.125
能源,0,0,0,1,0,0,0,1,0.125
能源危机,0,0,0,1,0,0,0,1,0.125
自然资源,0,0,0,1,0,0,0,1,0.125
空域调光,1,0,0,1,0,3,1,6,2.091666666666667
复杂,0,0,0,1,0,0,0,1,0.125
led驱动设备,0,0,0,1,0,0,0,1,0.125
电流脉冲,0,0,0,1,0,0,0,1,0.125
开关频率,0,0,0,1,0,0,0,1,0.125
视觉,0,0,0,1,0,0,0,1,0.125
闪烁,0,0,0,1,0,0,0,1,0.125
线性,0,0,0,1,0,0,0,1,0.125
发射功率,0,0,0,1,0,0,0,1,0.125
色度,0,0,0,1,0,0,0,1,0.125
电流,0,0,0,1,2,0,0,3,0.6083333333333334
output,0,0,0,1,0,0,0,1,0.125
multiple,0,0,0,1,0,0,0,1,0.125
-input,0,0,0,1,0,0,0,1,0.125
multi,0,0,0,1,0,0,0,1,0.125
mimo,0,0,0,2,0,0,0,2,0.25
vlc关键技术,0,0,0,1,0,0,0,1,0.125
白光led技术,0,0,0,1,0,0,0,1,0.125
传输介质,0,0,0,1,0,0,0,1,0.125
有线信道,0,0,0,1,0,0,0,1,0.125
光纤,0,0,0,1,0,0,0,1,0.125
信息载体,0,0,0,1,0,0,0,1,0.125
可见光通信臼,0,0,0,1,0,0,0,1,0.125
aco-ofdm信号,0,0,0,9,14,0,0,23,4.508333333333333
hermitian对称条件,0,0,0,7,0,0,0,7,0.875
单极性化,0,0,0,6,0,0,0,6,0.75
pm-ofdm,0,0,0,5,0,0,0,5,0.625
flip-ofdm信号,0,0,0,5,0,0,0,5,0.625
单极性信号,2,0,0,6,0,6,1,15,4.441666666666666
路径,0,0,0,4,0,0,0,4,0.5
虚部,0,0,0,4,0,0,0,4,0.5
实部,0,0,0,4,0,0,0,4,0.5
长度,0,0,0,4,2,1,0,7,1.225
载波,0,0,0,4,0,0,0,4,0.5
只调制偶载波,0,0,0,5,0,0,0,5,0.625
零值削峰,0,0,0,4,1,2,0,7,1.225
半波奇对称特性,0,0,0,4,0,0,0,4,0.5
奇载波,0,0,0,4,1,0,0,5,0.7416666666666667
see-ofdm,0,0,0,3,0,0,0,3,0.375
双极性,0,0,0,3,0,1,0,4,0.6166666666666667
直流偏置,0,0,0,5,13,7,0,25,5.458333333333333
flip-ofdm,0,0,0,4,0,0,0,4,0.5
平均功率,0,0,0,3,5,1,0,9,1.825
只调制奇载波,0,0,0,3,0,0,0,3,0.375
偶载波,0,0,0,3,0,0,0,3,0.375
子载波调制,0,0,0,3,0,0,0,3,0.375
对称条件,0,0,0,3,0,0,0,3,0.375
hermitian,0,0,0,3,0,0,0,3,0.375
复信号,0,0,0,3,0,0,0,3,0.375
解调,0,0,0,2,1,0,0,3,0.4916666666666667
叠加,0,0,0,2,0,0,0,2,0.25
系统复杂度,0,0,0,2,0,0,0,2,0.25
非对称重建,0,0,0,2,0,0,0,2,0.25
复杂性,0,0,0,2,0,0,0,2,0.25
功率效率,0,0,0,2,0,0,0,2,0.25
单极性实信号,0,0,0,2,0,0,0,2,0.25
对称特性,0,0,0,2,0,0,0,2,0.25
复双极性信号,0,0,0,2,0,0,0,2,0.25
新信号,0,0,0,2,0,0,0,2,0.25
光功率效率,0,0,0,2,0,0,0,2,0.25
调制偶载波,0,0,0,2,0,0,0,2,0.25
幅值,0,0,0,2,1,0,0,3,0.4916666666666667
奇数,0,0,0,2,0,0,0,2,0.25
载波数,0,0,0,2,0,0,0,2,0.25
偶数,0,0,0,2,0,0,0,2,0.25
调制奇载波,0,0,0,2,0,0,0,2,0.25
rf-ofdm信号,0,0,0,2,0,0,0,2,0.25
pam-dmt,0,0,0,1,0,0,0,1,0.125
enhancedaco-,0,0,0,1,0,0,0,1,0.125
eaco-ofdm,0,0,0,1,0,0,0,1,0.125
enhancedu-ofdm,0,0,0,1,0,0,0,1,0.125
eu-ofdm,0,0,0,1,0,0,0,1,0.125
路径数,0,0,0,1,0,0,0,1,0.125
路径信号,0,0,0,1,0,0,0,1,0.125
点数,0,0,0,1,0,0,0,1,0.125
半波对称特性,0,0,0,1,0,0,0,1,0.125
ent,0,0,0,1,0,0,0,1,0.125
fi,0,0,0,1,0,0,0,1,0.125
pectralandenergy,0,0,0,1,0,0,0,1,0.125
多层叠加,0,0,0,1,0,0,0,1,0.125
pr,0,0,0,1,0,1,0,2,0.3666666666666667
正值,0,0,0,1,0,0,0,1,0.125
光功率性能,0,0,0,1,0,0,0,1,0.125
削峰,0,0,0,1,5,4,0,10,2.3
压扩,0,0,0,1,0,0,0,1,0.125
线性压,0,0,0,1,0,0,0,1,0.125
负值,0,0,0,1,0,0,0,1,0.125
companded,0,0,0,1,0,0,0,1,0.125
非对称压扩,0,0,0,1,0,0,0,1,0.125
〃-ofdmpapr,0,0,0,1,0,0,0,1,0.125
filp-ofdm,0,0,0,1,0,0,0,1,0.125
双极性ofdm信号,0,0,0,1,0,0,0,1,0.125
载波调制,0,0,0,1,0,0,0,1,0.125
硬件,0,0,0,1,1,0,0,2,0.3666666666666667
rofdm,0,0,0,1,0,0,0,1,0.125
实单极性信号,0,0,0,1,0,0,0,1,0.125
双极性实信号,0,0,0,1,0,0,0,1,0.125
分离器,0,0,0,1,0,0,0,1,0.125
pm-ofdm信号,0,0,0,1,0,0,0,1,0.125
pm-ofdm调制,0,0,0,1,0,0,0,1,0.125
幅值图,0,0,0,1,0,0,0,1,0.125
阳〃调制,0,0,0,1,0,0,0,1,0.125
〃律压缩公,0,0,0,1,0,0,0,1,0.125
〃律压缩公式,0,0,0,1,0,0,0,1,0.125
信号号,0,0,0,1,0,0,0,1,0.125
实部虚部分离器,0,0,0,1,0,0,0,1,0.125
n-ofdm信号,0,0,0,1,0,0,0,1,0.125
positionmodulation,0,0,0,1,0,0,0,1,0.125
awofdm,0,0,0,1,0,0,0,1,0.125
u-ofdmo,0,0,0,1,0,0,0,1,0.125
符号同步,0,0,0,1,0,0,0,1,0.125
单极性化过程,0,0,0,1,0,0,0,1,0.125
fhp-ofdm,0,0,0,1,0,0,0,1,0.125
fgofdm,0,0,0,1,0,0,0,1,0.125
正半部分信号,0,0,0,1,0,0,0,1,0.125
峰无损失,0,0,0,1,0,0,0,1,0.125
零值,0,0,0,1,0,0,0,1,0.125
aco-ofdmo,0,0,0,1,0,0,0,1,0.125
单极性dco-ofdm信号,0,0,0,1,0,0,0,1,0.125
直流,0,0,0,1,0,0,0,1,0.125
双极性dco-ofdm信号,1,0,0,1,0,1,1,4,1.6083333333333334
hermiti血对称条件,0,0,0,1,0,0,0,1,0.125
dco-ofdmo,0,0,0,1,0,0,0,1,0.125
单极性,0,0,0,1,0,1,0,2,0.3666666666666667
信号特性,0,0,0,1,0,0,0,1,0.125
厄密特对称条件,0,0,0,1,0,0,0,1,0.125
工区,0,0,0,1,0,0,0,1,0.125
ti^trn,0,0,0,1,0,0,0,1,0.125
7ni,0,0,0,1,0,0,0,1,0.125
remexp,0,0,0,1,0,0,0,1,0.125
负半部分信号,0,0,0,1,0,0,0,1,0.125
ex,0,0,0,1,0,0,0,1,0.125
ilyrni,0,0,0,1,0,0,0,1,0.125
厄密特,0,0,0,1,0,0,0,1,0.125
o-ofdm信号,0,0,0,1,0,0,0,1,0.125
pwm调光控制,0,0,0,3,0,0,0,3,0.375
pam-dmt信号,0,0,0,3,0,0,0,3,0.375
mppm信号,0,0,0,2,0,0,0,2,0.25
比特数,0,0,0,2,0,0,0,2,0.25
频率,0,0,0,2,0,0,0,2,0.25
pwm数字调光,0,0,0,2,0,0,0,2,0.25
调制层数,0,0,0,1,0,0,0,1,0.125
调光范围,0,0,0,1,1,2,0,4,0.85
ma,0,0,0,1,0,0,0,1,0.125
do-ofdmcd,0,0,0,1,0,0,0,1,0.125
aho-ofdm信号,0,0,0,1,0,0,0,1,0.125
模拟调光控制,0,0,0,1,0,0,0,1,0.125
asymmetricalhybridopticalofdm,0,0,0,1,0,0,0,1,0.125
aho-ofdm,0,0,0,1,2,0,0,3,0.6083333333333334
混合调制,0,0,0,1,0,0,0,1,0.125
传输效率,0,0,0,1,0,0,0,1,0.125
线性比例,0,0,0,1,0,0,0,1,0.125
压扩变换调光,0,0,0,1,0,0,0,1,0.125
削峰失真,0,0,0,1,0,0,0,1,0.125
平均幅度,0,0,0,1,0,0,0,1,0.125
非对称线性压缩,0,0,0,1,0,0,0,1,0.125
下降沿,0,0,0,1,0,0,0,1,0.125
上升沿,0,0,0,1,0,0,0,1,0.125
同步技术,0,0,0,1,0,0,0,1,0.125
周期,0,0,0,1,0,0,0,1,0.125
码型效应,0,0,0,1,0,0,0,1,0.125
solt,0,0,0,1,0,0,0,1,0.125
调光控制,0,0,0,1,0,0,0,1,0.125
multi-pulsepositionmodulation,0,0,0,1,0,0,0,1,0.125
自适应qam,0,0,0,1,0,0,0,1,0.125
信号功率,0,0,0,1,0,0,0,1,0.125
biterrorratio,0,0,0,1,0,0,0,1,0.125
误比特率,0,0,0,1,0,0,0,1,0.125
qam调制,0,0,0,1,2,1,0,4,0.85
调制阶数,0,0,0,1,1,0,0,2,0.3666666666666667
pwm数字调光控制,0,0,0,1,0,0,0,1,0.125
quadratureamplitudemodulation,0,0,0,1,1,0,0,2,0.3666666666666667
自适应正交幅度调制,0,0,0,1,0,0,0,1,0.125
单位时间,0,0,0,1,0,0,0,1,0.125
-state,0,0,0,1,0,0,0,1,0.125
on-state,0,0,0,1,0,0,0,1,0.125
子载波频率,0,0,0,1,0,0,0,1,0.125
pam-dmt调制,0,0,0,1,0,0,0,1,0.125
单链路场景,0,0,0,1,0,0,1,2,0.3666666666666667
空间维度,0,0,0,2,0,4,3,9,1.9416666666666667
调节,0,0,0,1,0,0,0,1,0.125
发光led,1,0,0,1,0,4,1,7,2.333333333333333
调光方,0,0,0,1,0,0,0,1,0.125
spatialdimmingofdm,0,0,0,1,0,0,0,1,0.125
ok,0,0,0,1,0,0,0,1,0.125
天线子集,0,0,0,1,0,0,0,1,0.125
channelstateinformation,0,0,0,1,1,0,0,2,0.3666666666666667
信道状态信息,0,0,0,1,1,0,0,2,0.3666666666666667
o-ofdm调制技术,0,0,0,1,0,0,2,3,0.6083333333333334
正极性,0,0,0,1,0,0,0,1,0.125
传输信号,0,0,0,1,0,0,0,1,0.125
aad-ofdm调制,0,0,0,0,10,1,0,11,2.658333333333333
自适应系统,0,0,0,0,1,0,0,1,0.24166666666666667
直流偏置光,0,0,0,0,1,0,0,1,0.24166666666666667
非对称,0,0,0,0,1,0,0,1,0.24166666666666667
rectc,0,0,0,0,1,0,0,1,0.24166666666666667
直流分量,0,0,0,0,3,0,0,3,0.725
动态,0,0,0,0,4,0,0,4,0.9666666666666667
线性动态,0,0,0,0,5,0,0,5,1.2083333333333333
零子载波,0,0,0,0,2,1,0,3,0.725
实数,0,0,0,0,2,0,0,2,0.48333333333333334
加性高斯白噪声,0,0,0,0,3,0,0,3,0.725
变换模块,0,0,0,0,2,1,0,3,0.725
线性动态范围,0,0,0,0,2,1,0,3,0.725
点对点,0,0,0,0,4,0,0,4,0.9666666666666667
qam解调制,0,0,0,0,1,1,0,2,0.48333333333333334
帧解映射,0,0,0,0,2,2,0,4,0.9666666666666667
均衡模块,0,0,0,0,1,0,0,1,0.24166666666666667
信号逆变换,0,0,0,0,1,0,0,1,0.24166666666666667
有效信息,0,0,0,0,1,0,0,1,0.24166666666666667
sgexp,0,0,0,0,1,0,0,1,0.24166666666666667
加江水,0,0,0,0,1,0,0,1,0.24166666666666667
逆变换,0,0,0,0,1,2,0,3,0.725
苗刀,0,0,0,0,1,0,0,1,0.24166666666666667
直流偏置信息,0,0,0,0,1,0,0,1,0.24166666666666667
逆比例因子,0,0,0,0,1,0,0,1,0.24166666666666667
逆变换模块,0,0,0,0,1,1,0,2,0.48333333333333334
系数因子,0,0,0,0,1,0,0,1,0.24166666666666667
点对点通信,0,0,0,0,1,0,0,1,0.24166666666666667
信道增益系数,0,0,0,0,1,0,0,1,0.24166666666666667
模/数转换,0,0,0,0,2,0,0,2,0.48333333333333334
potordiode,0,0,0,0,1,0,0,1,0.24166666666666667
信道传播,0,0,0,0,1,0,0,1,0.24166666666666667
awgn,0,0,0,0,1,0,0,1,0.24166666666666667
additivewhitegaus,0,0,0,0,1,0,0,1,0.24166666666666667
散粒噪声,0,0,0,0,1,0,0,1,0.24166666666666667
热噪声,0,0,0,0,1,0,0,1,0.24166666666666667
vlc链路,0,0,0,0,1,0,0,1,0.24166666666666667
lineofsi,0,0,0,0,1,0,0,1,0.24166666666666667
直视,0,0,0,0,1,0,0,1,0.24166666666666667
数/模转换模块,0,0,0,0,1,0,0,1,0.24166666666666667
数字信号,0,0,0,0,1,0,0,1,0.24166666666666667
均值操作,0,0,0,0,1,0,0,1,0.24166666666666667
im/dd,0,0,0,0,1,0,0,1,0.24166666666666667
均衡,0,0,0,0,1,0,0,1,0.24166666666666667
电功率,0,0,0,0,7,0,0,7,1.6916666666666667
直流偏置操作,0,0,0,0,1,0,0,1,0.24166666666666667
比例压扩,0,0,0,0,1,0,0,1,0.24166666666666667
双因子调节法,0,0,0,0,1,0,0,1,0.24166666666666667
比例因子压,0,0,0,0,1,0,0,1,0.24166666666666667
信号变换,0,0,0,0,1,0,0,1,0.24166666666666667
vlc削峰操作,0,0,0,0,1,0,0,1,0.24166666666666667
补偿,0,0,0,0,1,0,0,1,0.24166666666666667
预畸变,0,0,0,0,1,0,0,1,0.24166666666666667
非线性特性,0,0,0,0,1,0,0,1,0.24166666666666667
削峰操,0,0,0,0,1,0,0,1,0.24166666666666667
动态范围,0,0,0,0,4,0,0,4,0.9666666666666667
方差,0,0,0,0,2,1,0,3,0.725
高斯分布,0,0,0,0,1,0,0,1,0.24166666666666667
零均值,0,0,0,0,1,0,0,1,0.24166666666666667
centrallimitthe,0,0,0,0,1,0,0,1,0.24166666666666667
中心极限定理,0,0,0,0,1,0,0,1,0.24166666666666667
ofdm信号网,0,0,0,0,1,0,0,1,0.24166666666666667
时域,0,0,0,0,1,0,0,1,0.24166666666666667
映射,0,0,0,0,1,0,0,1,0.24166666666666667
帧映射模块,0,0,0,0,2,0,0,2,0.48333333333333334
qam信号,0,0,0,0,1,0,0,1,0.24166666666666667
发送比特,0,0,0,0,1,0,0,1,0.24166666666666667
单链路vlc系统,3,0,0,0,1,1,0,5,3.4833333333333334
发光功率,0,0,0,0,2,0,0,2,0.48333333333333334
三维函数,0,0,0,0,2,0,0,2,0.48333333333333334
自适应切换,0,0,0,0,1,0,1,2,0.48333333333333334
biterrorrate,0,0,0,0,1,0,0,1,0.24166666666666667
比特误码率,0,0,0,0,1,0,0,1,0.24166666666666667
snr,0,0,0,0,7,2,0,9,2.175
noiserati,0,0,0,0,1,0,0,1,0.24166666666666667
signal,0,0,0,0,1,0,0,1,0.24166666666666667
变量,0,0,0,0,2,3,0,5,1.2083333333333333
二维图形,0,0,0,0,1,0,0,1,0.24166666666666667
三维图形,0,0,0,0,1,0,0,1,0.24166666666666667
取值,0,0,0,0,1,1,0,2,0.48333333333333334
uobc,0,0,0,0,1,0,0,1,0.24166666666666667
光功率比,0,0,0,0,1,0,0,1,0.24166666666666667
概率密度函数,0,0,0,0,1,0,0,1,0.24166666666666667
正态分布,0,0,0,0,1,0,0,1,0.24166666666666667
标准,0,0,0,0,1,0,0,1,0.24166666666666667
q函数,0,0,0,0,1,0,0,1,0.24166666666666667
aaxaa,0,0,0,0,1,0,0,1,0.24166666666666667
aa,0,0,0,0,1,0,0,1,0.24166666666666667
h-b,0,0,0,0,1,0,0,1,0.24166666666666667
吼演,0,0,0,0,1,0,0,1,0.24166666666666667
ou,0,0,0,0,1,0,0,1,0.24166666666666667
削峰模块,0,0,0,0,1,0,0,1,0.24166666666666667
开关模块,0,0,0,0,6,0,0,6,1.45
qam阶数,0,0,0,0,5,1,0,6,1.45
循环前缀,0,0,0,0,2,2,0,4,0.9666666666666667
衰减因子,0,0,0,0,2,1,0,3,0.725
亮度门限,0,0,0,0,10,0,0,10,2.4166666666666665
亮度切换门限,1,0,0,0,2,0,0,3,1.4833333333333334
be,0,0,0,0,2,0,0,2,0.48333333333333334
帧映射,0,0,0,0,1,3,0,4,0.9666666666666667
频效,0,0,0,0,2,0,0,2,0.48333333333333334
mofdm-vlc系统,0,0,0,0,1,0,0,1,0.24166666666666667
m-,0,0,0,0,1,0,0,1,0.24166666666666667
qam调制阶数,0,0,0,0,2,0,0,2,0.48333333333333334
带宽利用因子,0,0,0,0,1,0,0,1,0.24166666666666667
比特信噪比,0,0,0,0,1,1,0,2,0.48333333333333334
信道噪声,0,0,0,0,1,0,0,1,0.24166666666666667
高斯噪声,0,0,0,0,1,0,0,1,0.24166666666666667
曲二,0,0,0,0,1,0,0,1,0.24166666666666667
co,0,0,0,0,1,0,0,1,0.24166666666666667
aax,0,0,0,0,1,0,0,1,0.24166666666666667
aaxax,0,0,0,0,1,0,0,1,0.24166666666666667
iff,0,0,0,0,1,0,0,1,0.24166666666666667
零值削峰损,0,0,0,0,1,0,0,1,0.24166666666666667
系数,0,0,0,0,1,0,0,1,0.24166666666666667
零值削峰操作,0,0,0,0,1,0,0,1,0.24166666666666667
阶跃函数,0,0,0,0,1,0,0,1,0.24166666666666667
削峰信号,0,0,0,0,1,1,0,2,0.48333333333333334
非高斯不相关噪声,0,0,0,0,1,0,0,1,0.24166666666666667
原始衰减信号,0,0,0,0,1,0,0,1,0.24166666666666667
高斯信号,0,0,0,0,1,0,0,1,0.24166666666666667
gang,0,0,0,0,1,1,0,2,0.48333333333333334
bus,0,0,0,0,1,1,0,2,0.48333333333333334
量化,0,0,0,0,1,0,0,1,0.24166666666666667
失真,0,0,0,0,1,0,0,1,0.24166666666666667
削峰操作,0,0,0,0,1,0,0,1,0.24166666666666667
定量评估系统,0,0,0,0,1,0,0,1,0.24166666666666667
亮度值,0,0,0,0,1,0,0,1,0.24166666666666667
光传感器模块,0,0,0,0,1,0,0,1,0.24166666666666667
模块,0,0,0,0,1,0,0,1,0.24166666666666667
光传感器,0,0,0,0,1,0,0,1,0.24166666666666667
aco-ofdm硬件,0,0,0,0,1,0,0,1,0.24166666666666667
ad-ofdm系统,0,0,0,0,1,0,0,1,0.24166666666666667
i接收端,0,0,0,0,1,0,0,1,0.24166666666666667
响f光襁信道,0,0,0,0,1,0,0,1,0.24166666666666667
光/电转换,0,0,0,0,1,0,0,1,0.24166666666666667
iw均衡,0,0,0,0,1,0,0,1,0.24166666666666667
fdco-,0,0,0,0,1,0,0,1,0.24166666666666667
接收比特,0,0,0,0,1,0,0,1,0.24166666666666667
却光线,0,0,0,0,1,0,0,1,0.24166666666666667
模转换,0,0,0,0,1,0,0,1,0.24166666666666667
住换i,0,0,0,0,1,0,0,1,0.24166666666666667
aoo-ofdm帧映射,0,0,0,0,1,0,0,1,0.24166666666666667
-qam调制,0,0,0,0,1,0,0,1,0.24166666666666667
光传^器,0,0,0,0,1,0,0,1,0.24166666666666667
实线方框,0,0,0,0,1,0,0,1,0.24166666666666667
黑色,0,0,0,0,1,0,0,1,0.24166666666666667
互补特性,0,0,0,0,1,0,0,1,0.24166666666666667
ber门限,0,0,0,0,6,1,0,7,1.6916666666666667
aad-ofdm系统,0,0,0,0,3,0,0,3,0.725
ber性能,0,0,0,0,11,5,0,16,3.8666666666666667
闭式,0,0,0,0,2,0,0,2,0.48333333333333334
ber值,0,0,0,0,2,0,0,2,0.48333333333333334
二分算法,0,0,0,0,2,0,0,2,0.48333333333333334
对称性,0,0,0,0,2,1,0,3,0.725
二分法,0,0,0,0,1,0,0,1,0.24166666666666667
黑线,0,0,0,0,1,0,0,1,0.24166666666666667
波动,0,0,0,0,2,0,0,2,0.48333333333333334
中间值,0,0,0,0,1,1,0,2,0.48333333333333334
hd,0,0,0,0,1,0,0,1,0.24166666666666667
迭代,0,0,0,0,1,0,0,1,0.24166666666666667
初始化,0,0,0,0,1,0,0,1,0.24166666666666667
数值解,0,0,0,0,1,0,0,1,0.24166666666666667
finincon,0,0,0,0,1,0,0,1,0.24166666666666667
函数,0,0,0,0,1,0,0,1,0.24166666666666667
非线性约束,0,0,0,0,1,0,0,1,0.24166666666666667
maxtj,0,0,0,0,1,0,0,1,0.24166666666666667
可靠通信,0,0,0,0,1,0,0,1,0.24166666666666667
led发光亮度,0,0,0,0,1,0,0,1,0.24166666666666667
约束条件,0,0,0,0,1,1,0,2,0.48333333333333334
目标函数,0,0,0,0,1,1,0,2,0.48333333333333334
接收snr,0,0,0,0,1,0,0,1,0.24166666666666667
允许电流,0,0,0,0,2,2,0,4,0.9666666666666667
可靠传输,0,0,0,0,2,0,0,2,0.48333333333333334
发送信噪比,0,0,0,0,2,1,0,3,0.725
2a,0,0,0,0,1,1,0,2,0.48333333333333334
室内信噪,0,0,0,0,1,0,0,1,0.24166666666666667
256,0,0,0,0,1,0,0,1,0.24166666666666667
filedof,0,0,0,0,1,0,0,1,0.24166666666666667
视场角,0,0,0,0,1,0,0,1,0.24166666666666667
信道增益瓶,0,0,0,0,1,0,0,1,0.24166666666666667
曲线,0,0,0,0,4,2,0,6,1.45
ber曲线,0,0,0,0,3,1,0,4,0.9666666666666667
调光等级,0,0,0,0,2,0,0,2,0.48333333333333334
交点值,0,0,0,0,2,0,0,2,0.48333333333333334
虚线,0,0,0,0,2,0,0,2,0.48333333333333334
实线,0,0,0,0,2,0,0,2,0.48333333333333334
调光精度,0,0,0,0,1,0,0,1,0.24166666666666667
aad-,0,0,0,0,1,0,0,1,0.24166666666666667
ld,0,0,0,0,1,0,0,1,0.24166666666666667
res,0,0,0,0,1,0,0,1,0.24166666666666667
switching,0,0,0,0,1,0,0,1,0.24166666666666667
qmouspe,0,0,0,0,1,0,0,1,0.24166666666666667
aho-ofdm调制,0,0,0,0,1,0,0,1,0.24166666666666667
约束,0,0,0,0,1,0,0,1,0.24166666666666667
联合调光技术,0,0,0,0,0,2,1,3,0.725
光ofdm),0,0,0,0,0,1,0,1,0.24166666666666667
分离发送,0,0,0,0,0,1,0,1,0.24166666666666667
transmittedopticalofdm,0,0,0,0,0,1,0,1,0.24166666666666667
特性,0,0,0,0,0,1,0,1,0.24166666666666667
peaktoavera,0,0,0,0,0,1,0,1,0.24166666666666667
高峰均比,0,0,0,0,0,1,0,1,0.24166666666666667
性能衰减,0,0,0,0,0,1,0,1,0.24166666666666667
高频谱效率特性,0,0,0,0,0,1,0,1,0.24166666666666667
发送端信号,0,0,0,0,0,3,0,3,0.725
分集增益,0,0,0,0,0,3,0,3,0.725
间距,0,0,0,0,0,2,0,2,0.48333333333333334
ofdm解调制,0,0,0,0,0,1,0,1,0.24166666666666667
ntnr,0,0,0,0,0,1,0,1,0.24166666666666667
等增益,0,0,0,0,0,2,0,2,0.48333333333333334
bin,0,0,0,0,0,1,0,1,0.24166666666666667
selection,0,0,0,0,0,1,0,1,0.24166666666666667
egc,0,0,0,0,0,1,0,1,0.24166666666666667
equalgaincombin,0,0,0,0,0,1,0,1,0.24166666666666667
等增益合并,0,0,0,0,0,1,0,1,0.24166666666666667
mrc,0,0,0,0,0,1,0,1,0.24166666666666667
atio,0,0,0,0,0,1,0,1,0.24166666666666667
inw,0,0,0,0,0,1,0,1,0.24166666666666667
信道增益表达式,0,0,0,0,0,1,0,1,0.24166666666666667
量化噪声,0,0,0,0,0,1,0,1,0.24166666666666667
随机awgn,0,0,0,0,0,1,0,1,0.24166666666666667
城学,0,0,0,0,0,1,0,1,0.24166666666666667
awgn矩阵,0,0,0,0,0,1,0,1,0.24166666666666667
信道增益矩阵,0,0,0,0,0,1,0,1,0.24166666666666667
awgn信道,0,0,0,0,0,1,0,1,0.24166666666666667
repetitioncoding,0,0,0,0,0,1,0,1,0.24166666666666667
spatialmulti-plex,0,0,0,0,0,1,0,1,0.24166666666666667
空分复用,0,0,0,0,0,1,0,1,0.24166666666666667
转置操作,0,0,0,0,0,1,0,1,0.24166666666666667
列向量,0,0,0,0,0,1,0,1,0.24166666666666667
光电接收器,0,0,0,0,0,1,0,1,0.24166666666666667
qam解调,0,0,0,0,0,2,0,2,0.48333333333333334
光无线信道,0,0,0,0,0,2,0,2,0.48333333333333334
发送比,0,0,0,0,0,1,0,1,0.24166666666666667
合并信号,0,0,0,0,0,2,0,2,0.48333333333333334
st-ofdm系统,0,0,0,0,0,1,0,1,0.24166666666666667
比例因子环,0,0,0,0,0,1,0,1,0.24166666666666667
qam解调制模块,0,0,0,0,0,1,0,1,0.24166666666666667
帧解映射模块,0,0,0,0,0,1,0,1,0.24166666666666667
fft模块,0,0,0,0,0,1,0,1,0.24166666666666667
xtpfa,0,0,0,0,0,1,0,1,0.24166666666666667
fft变换,0,0,0,0,0,1,0,1,0.24166666666666667
才力,0,0,0,0,0,1,0,1,0.24166666666666667
mp,0,0,0,0,0,3,0,3,0.725
混合调光,0,0,0,0,0,2,0,2,0.48333333333333334
双因子模拟调光法,0,0,0,0,0,1,0,1,0.24166666666666667
调光时,0,0,0,0,0,1,0,1,0.24166666666666667
编号,0,0,0,0,0,1,0,1,0.24166666666666667
led亮度,0,0,0,0,0,1,0,1,0.24166666666666667
变换,0,0,0,0,0,1,0,1,0.24166666666666667
方差表达式,0,0,0,0,0,1,0,1,0.24166666666666667
均值操,0,0,0,0,0,1,0,1,0.24166666666666667
表达,0,0,0,0,0,1,0,1,0.24166666666666667
单位阶跃函数,0,0,0,0,0,1,0,1,0.24166666666666667
skofdm系统,0,0,0,0,0,1,0,1,0.24166666666666667
变微,0,0,0,0,0,1,0,1,0.24166666666666667
swfdm调制,0,0,0,0,0,1,0,1,0.24166666666666667
sfofdm调制,0,0,0,0,0,1,0,1,0.24166666666666667
loodb,0,0,0,0,0,1,0,1,0.24166666666666667
探测面面积,0,0,0,0,0,1,0,1,0.24166666666666667
光滤波器,0,0,0,0,0,1,0,1,0.24166666666666667
pd数目,0,0,0,0,0,1,0,1,0.24166666666666667
led数,0,0,0,0,0,1,0,1,0.24166666666666667
sd-ofdm调制,0,0,0,0,0,7,0,7,1.6916666666666667
swfdm,0,0,0,0,0,1,0,1,0.24166666666666667
噪声,0,0,0,0,0,2,0,2,0.48333333333333334
改进调制,0,0,0,0,0,1,0,1,0.24166666666666667
lamp亮度,0,0,0,0,0,4,0,4,0.9666666666666667
频谱效率曲线,0,0,0,0,0,2,0,2,0.48333333333333334
发端led,0,0,0,0,0,2,0,2,0.48333333333333334
仿真曲线,0,0,0,0,0,2,0,2,0.48333333333333334
亮度水平门限,0,0,0,0,0,1,0,1,0.24166666666666667
横坐标,0,0,0,0,0,1,0,1,0.24166666666666667
坐标,0,0,0,0,0,1,0,1,0.24166666666666667
模拟,0,0,0,0,0,1,0,1,0.24166666666666667
参数配置,0,0,0,0,0,1,0,1,0.24166666666666667
可靠传输门限,0,0,0,0,0,1,0,1,0.24166666666666667
联合调光,0,0,0,0,0,1,0,1,0.24166666666666667
fofdm,0,0,0,0,0,1,0,1,0.24166666666666667
n-sd-ofdm,0,0,0,0,0,1,0,1,0.24166666666666667
sd,0,0,0,0,0,1,0,1,0.24166666666666667
wst,0,0,0,0,0,1,0,1,0.24166666666666667
st,0,0,0,0,0,1,0,1,0.24166666666666667
qst,0,0,0,0,0,1,0,1,0.24166666666666667
16qam,0,0,0,0,0,1,0,1,0.24166666666666667
理论曲线,0,0,0,0,0,1,0,1,0.24166666666666667
sfofdm,0,0,0,0,0,1,0,1,0.24166666666666667
蒙特卡洛,0,0,0,0,0,1,0,1,0.24166666666666667
数据,0,0,0,0,0,1,0,1,0.24166666666666667
数值求解,0,0,0,0,0,1,0,1,0.24166666666666667
finincon函数,0,0,0,0,0,1,0,1,0.24166666666666667
直流偏置4,0,0,0,0,0,1,0,1,0.24166666666666667
qamo,0,0,0,0,0,1,0,1,0.24166666666666667
调光控制参数,0,0,0,0,0,1,0,1,0.24166666666666667
模型,0,0,0,0,0,1,0,1,0.24166666666666667
发送,0,0,0,0,0,1,0,1,0.24166666666666667
分离发送调制,0,0,0,0,0,1,0,1,0.24166666666666667
多链路场,0,0,0,0,0,0,1,1,0.24166666666666667
调光调制,0,0,0,0,0,0,1,1,0.24166666666666667
仿真证明,1,0,0,0,0,0,1,2,1.2416666666666667
光亮度,0,0,0,0,0,0,1,1,0.24166666666666667
切换机制,0,0,0,0,0,0,1,1,0.24166666666666667
o-ofdm调制技,0,0,0,0,0,0,1,1,0.24166666666666667
能量,0,0,0,0,0,0,1,1,0.24166666666666667
环境气氛,0,0,0,0,0,0,1,1,0.24166666666666667
信息社会,0,0,0,0,0,0,1,1,0.24166666666666667
无线接入,0,0,0,0,0,0,1,1,0.24166666666666667
安全特性,0,0,0,0,0,0,1,1,0.24166666666666667
信息传输速率,0,0,0,0,0,0,1,1,0.24166666666666667
OFDM,0,1,0,0,0,0,0,1,2.0
多链路vlc系统,1,0,0,0,0,0,0,1,1.0
维度,1,0,0,0,0,0,0,1,1.0
separatelytransmitted,1,0,0,0,0,0,0,1,1.0
spatialdimmingopticalofdm,1,0,0,0,0,0,0,1,1.0
切换,1,0,0,0,0,0,0,1,1.0
自适应亮度,1,0,0,0,0,0,0,1,1.0
sedoptical,1,0,0,0,0,0,0,1,1.0
asymmetricallyclippedoptical,1,0,0,0,0,0,0,1,1.0
symmetricala,1,0,0,0,0,0,0,1,1.0
rect,1,0,0,0,0,0,0,1,1.0
pt,1,0,0,0,0,0,0,1,1.0
led调制带宽,1,0,0,0,0,0,0,1,1.0
intersymbolinterferend,1,0,0,0,0,0,0,1,1.0
