,摘要,关键词,第一章,第二章,第三章,第四章,第五章,总词频,加权得分
物联网,3,1,6,5,3,0,1,19,7.341666666666667
低功耗,2,1,7,3,8,14,1,36,10.808333333333334
终端设备,0,0,2,5,3,0,0,10,1.6
性能,3,0,3,7,11,3,0,27,7.633333333333333
处理器,0,0,2,4,6,3,0,15,2.925
动态功耗管理技术,0,0,2,2,0,0,1,5,0.7416666666666667
静态功耗管理技术,0,0,2,2,0,0,0,4,0.5
功耗管理技术,0,0,2,2,0,0,0,4,0.5
广域物联网,0,0,3,1,6,3,1,14,2.9166666666666665
物联网设备,0,0,2,8,4,0,0,14,2.216666666666667
nb-iot协议,0,0,3,2,4,4,0,13,2.5583333333333336
nb-iot,2,0,6,7,17,7,1,40,9.666666666666668
lpwan,3,0,2,0,0,0,0,5,3.25
zigbee,0,0,2,0,0,0,0,2,0.25
bluetooth,0,0,2,0,0,0,0,2,0.25
互联网技术,0,0,2,0,0,0,0,2,0.25
互联网,0,0,2,1,0,0,0,3,0.375
things,0,0,2,0,0,0,0,2,0.25
工作性能,0,0,1,0,0,0,0,1,0.125
终端,0,0,1,4,4,0,0,9,1.5916666666666668
作时间,0,0,1,0,0,0,0,1,0.125
物联网终端设备,0,0,1,2,6,4,1,14,3.033333333333333
低功耗技术,2,0,4,2,0,0,0,8,2.75
使用寿命口,0,0,1,0,0,0,0,1,0.125
电池,0,0,1,1,0,0,0,2,0.25
电池供电系统,0,0,1,0,0,0,0,1,0.125
电池供电,0,0,1,0,1,0,0,2,0.3666666666666667
低功耗状态,0,0,1,1,1,0,0,3,0.4916666666666667
睡眠状态,0,0,1,0,0,0,0,1,0.125
系统组件,0,0,1,1,0,0,0,2,0.25
dpm技术,0,0,1,0,0,0,0,1,0.125
频率,0,0,1,2,2,0,0,5,0.8583333333333334
电源电压,0,0,1,1,0,0,0,2,0.25
dvs技术,0,0,1,2,0,0,0,3,0.375
动态电源管理,0,0,5,0,6,3,0,14,2.8
dpm,0,0,1,0,1,2,0,4,0.85
动态电压调节,1,0,2,0,0,0,1,4,1.4916666666666667
dvs,0,0,1,1,0,0,0,2,0.25
能源,0,0,1,1,0,0,0,2,0.25
低功耗技,1,0,2,1,0,0,0,4,1.375
软件,0,0,1,1,0,0,0,2,0.25
功耗,0,0,6,20,27,7,0,60,11.466666666666667
通信模组,0,0,1,2,0,0,0,3,0.375
定制nb-iot产,0,0,1,0,0,0,0,1,0.125
电信,0,0,1,0,0,0,0,1,0.125
移远公司,0,0,1,0,0,0,0,1,0.125
nb-iot通信技术,0,0,3,7,1,0,1,12,1.7333333333333334
通信,0,0,1,5,6,3,0,15,2.925
蜂窝网络,0,0,1,1,0,0,0,2,0.25
wifi,0,0,1,0,0,0,0,1,0.125
待机时间,0,0,1,0,0,0,0,1,0.125
行时间,0,0,1,0,0,0,0,1,0.125
设备,0,0,1,4,5,4,0,14,2.8
网络连接,0,0,1,0,0,0,0,1,0.125
单芯片设备,0,0,1,0,0,0,0,1,0.125
传感器设备,0,0,1,0,1,0,0,2,0.3666666666666667
广域物联网系统,0,0,1,0,3,0,0,4,0.85
延迟,0,0,1,3,1,0,0,5,0.7416666666666667
m2m连接,0,0,1,0,0,0,0,1,0.125
连接,0,0,1,3,1,0,0,5,0.7416666666666667
蜂窝物联网,0,0,1,0,0,0,0,1,0.125
nb-iot物联网技术,0,0,1,0,0,0,0,1,0.125
lte,0,0,1,0,0,0,0,1,0.125
连接技术,0,0,1,0,0,0,0,1,0.125
移动性,0,0,1,3,1,0,0,5,0.7416666666666667
移动蜂窝网络,0,0,1,0,0,0,0,1,0.125
短距离通信技术,0,0,1,0,0,0,0,1,0.125
万物互联,0,0,1,0,1,0,0,2,0.3666666666666667
广覆盖,0,0,1,0,0,0,0,1,0.125
带宽,0,0,1,0,0,0,0,1,0.125
数据交互,0,0,1,0,1,0,0,2,0.3666666666666667
物联网通信,0,0,1,0,0,0,0,1,0.125
narrowband-internet,0,0,1,0,0,0,0,1,0.125
环境监控,0,0,1,1,0,0,0,2,0.25
智能抄表,0,0,1,1,1,0,0,3,0.4916666666666667
短距离无线通信,0,0,1,0,1,0,0,2,0.3666666666666667
低功耗广域网无线通信技术,0,0,1,0,0,0,0,1,0.125
智能家居,0,0,1,0,0,0,0,1,0.125
智慧城市,0,0,1,0,0,0,0,1,0.125
智能医疗,0,0,1,0,0,0,0,1,0.125
wi-fi,0,0,1,0,0,0,0,1,0.125
z-wave,0,0,1,0,0,0,0,1,0.125
短距离无线通信技术,0,0,1,1,0,0,0,2,0.25
传输距离,0,0,1,0,0,0,0,1,0.125
物联网通信技术,0,0,1,0,0,0,0,1,0.125
物联网产业,0,0,1,0,0,0,0,1,0.125
物联网技术,1,0,2,2,0,0,2,7,1.9833333333333334
有效信息,0,0,1,0,0,0,0,1,0.125
红外感应器,0,0,1,0,0,0,0,1,0.125
激光扫描设备,0,0,1,0,0,0,0,1,0.125
智能传感器,0,0,1,0,2,0,0,3,0.6083333333333334
射频识别装置,0,0,1,0,0,0,0,1,0.125
信息传感设备,0,0,1,0,0,0,0,1,0.125
internet,2,0,1,0,0,0,0,3,2.125
物联网国,0,0,1,0,0,0,0,1,0.125
设备端,0,0,4,0,0,4,0,8,1.4666666666666668
nb-iot技术,0,0,2,7,1,0,2,12,1.85
硬件系统,1,0,2,0,8,3,2,16,4.391666666666667
功能测试,0,0,2,0,0,1,0,3,0.4916666666666667
资源,0,0,2,4,3,2,0,11,1.9583333333333333
消息处理,1,0,3,0,8,5,3,20,5.241666666666667
并发,0,0,2,0,1,1,0,4,0.7333333333333334
nb-iot数据,0,0,2,0,1,1,0,4,0.7333333333333334
服务端,0,0,2,0,13,21,0,36,8.466666666666667
消息重传机制,1,0,2,0,9,8,1,21,5.6
系统,1,0,1,12,24,4,0,42,9.391666666666666
程序,0,0,1,0,1,0,0,2,0.3666666666666667
嵌入式实时操作系统,1,0,1,1,2,0,0,5,1.7333333333333334
时效性,1,0,1,0,0,1,1,4,1.6083333333333334
信息传输,0,0,1,1,0,0,1,3,0.4916666666666667
广域网,1,0,1,0,0,0,1,3,1.3666666666666667
工作状态,1,0,1,0,2,0,1,5,1.85
mcu,1,0,1,0,6,2,1,11,3.3
nb-iot模组,0,0,1,1,15,6,1,24,5.566666666666666
系统性能,0,0,1,1,1,0,0,3,0.4916666666666667
通信链路,0,0,1,0,0,0,1,2,0.3666666666666667
热力领,1,0,1,0,0,2,1,5,1.85
热力监测系统,0,0,5,0,6,8,0,19,4.008333333333333
cnki,0,0,1,0,0,1,0,2,0.3666666666666667
动态电源管理技,0,0,1,1,1,1,0,4,0.7333333333333334
后台,0,0,1,0,0,1,0,2,0.3666666666666667
电信cdpserver,0,0,1,0,0,2,0,3,0.6083333333333334
nb-iot客户端设备,0,0,1,0,6,3,0,10,2.3
数据重传,0,0,1,1,1,0,0,3,0.4916666666666667
硬件,0,0,1,3,8,1,0,13,2.675
程序优化,0,0,1,0,0,0,0,1,0.125
实时操作系统,0,0,1,22,6,0,1,30,4.566666666666666
硬件设备,1,0,1,0,4,0,0,6,2.091666666666667
实时操作系统技,0,0,1,1,0,0,0,2,0.25
嵌入式动态电源管理技术,0,0,1,1,0,0,0,2,0.25
coap通信协议,0,0,1,1,0,0,0,2,0.25
coap协议,0,0,1,14,2,2,0,19,2.841666666666667
通信协议,0,0,1,1,0,0,0,2,0.25
低功耗窄带广域物联网,0,0,1,0,0,0,0,1,0.125
低功耗物联网,0,0,1,2,0,0,0,3,0.375
物联网协议,0,0,0,2,1,0,0,3,0.4916666666666667
带内部署模式,0,0,0,2,0,0,0,2,0.25
gsm通信,0,0,0,2,0,0,0,2,0.25
协议,0,0,0,1,1,0,0,2,0.3666666666666667
lorazigbee,0,0,0,1,0,0,0,1,0.125
udptcp,0,0,0,1,0,0,0,1,0.125
coapmqtt,0,0,0,1,0,0,0,1,0.125
部署模式,0,0,0,1,0,0,0,1,0.125
保护带,0,0,0,1,0,0,0,1,0.125
部署模,0,0,0,1,0,0,0,1,0.125
udp协议,0,0,0,2,0,0,0,2,0.25
数据,0,0,0,6,36,23,0,65,15.008333333333333
coap网协议,0,0,0,1,0,0,0,1,0.125
数据链路层协议,0,0,0,1,0,0,0,1,0.125
物理层,0,0,0,2,0,0,0,2,0.25
数据传输,0,0,0,1,2,0,0,3,0.6083333333333334
onem2m网,0,0,0,1,0,0,0,1,0.125
应用层协议,0,0,0,1,1,0,0,2,0.3666666666666667
模组,0,0,0,1,17,1,0,19,4.475
广域物联网环境,0,0,0,1,0,0,0,1,0.125
通信次数,0,0,0,1,0,0,0,1,0.125
信息量,0,0,0,1,0,0,0,1,0.125
edrx技,0,0,0,1,0,0,0,1,0.125
psm,0,0,0,7,5,0,0,12,2.083333333333333
电池寿命,0,0,0,1,0,0,0,1,0.125
连接量,0,0,0,1,0,0,0,1,0.125
时延,0,0,0,1,0,0,0,1,0.125
数据包,0,0,0,1,5,4,0,10,2.3
nb-iot终端,0,0,0,1,2,1,0,4,0.85
数据连接,0,0,0,1,0,1,0,2,0.3666666666666667
口叫,0,0,0,1,1,0,0,2,0.3666666666666667
保护带部署模式,0,0,0,1,0,0,0,1,0.125
独立部署模式,0,0,0,1,0,0,0,1,0.125
部署,0,0,0,1,1,2,0,4,0.85
增益,0,0,0,1,0,0,0,1,0.125
网络,0,0,0,2,0,0,0,2,0.25
信号,0,0,0,1,1,0,1,3,0.6083333333333334
fdd-lte技术,0,0,0,1,0,0,0,1,0.125
底层通信技术,0,0,0,1,0,0,0,1,0.125
数据量,0,0,0,3,0,0,0,3,0.375
节能,0,0,0,3,0,0,0,3,0.375
edrx,0,0,0,3,2,0,0,5,0.8583333333333334
下行命令,0,0,0,2,1,0,0,3,0.4916666666666667
nb-iot设备,0,0,0,2,4,10,0,16,3.6333333333333333
周期,0,0,0,4,1,3,0,8,1.4666666666666668
edrx技术,0,0,0,2,0,0,0,2,0.25
射频,0,0,0,2,0,0,0,2,0.25
低移动性,0,0,0,1,0,0,0,1,0.125
小数据量,0,0,0,1,0,0,0,1,0.125
智能抄表设备,0,0,0,1,0,0,0,1,0.125
海量设备,0,0,0,1,0,0,0,1,0.125
监控摄像头设备,0,0,0,1,0,0,0,1,0.125
频带,0,0,0,1,0,0,0,1,0.125
无移动性,0,0,0,1,0,0,0,1,0.125
车队跟踪管理设备,0,0,0,1,0,0,0,1,0.125
切换,0,0,0,1,0,0,0,1,0.125
psm模式,0,0,0,1,1,0,0,2,0.3666666666666667
接收模块,0,0,0,1,0,0,0,1,0.125
睡眠周期,0,0,0,1,0,0,0,1,0.125
空闲模,0,0,0,1,0,0,0,1,0.125
省电技术,0,0,0,1,0,0,0,1,0.125
电量,0,0,0,1,1,1,0,3,0.6083333333333334
深度睡眠,0,0,0,1,1,0,0,2,0.3666666666666667
寻呼信息,0,0,0,1,0,0,0,1,0.125
psm状态,0,0,0,1,1,1,0,3,0.6083333333333334
在线,0,0,0,1,0,0,0,1,0.125
连接状态,0,0,0,1,0,0,0,1,0.125
速率,0,0,0,1,0,0,0,1,0.125
能量,0,0,0,1,0,0,0,1,0.125
节电,0,0,0,1,0,0,0,1,0.125
短时间寻呼间隔,0,0,0,1,0,0,0,1,0.125
edrx周期,0,0,0,1,0,0,0,1,0.125
寻呼监听过程,0,0,0,1,0,0,0,1,0.125
物联网终端,0,0,0,1,3,0,0,4,0.85
核心网,0,0,0,1,6,0,0,7,1.575
寻呼监听,0,0,0,1,0,0,0,1,0.125
非连续接收技术,0,0,0,1,0,0,0,1,0.125
上行数据,0,0,0,1,0,0,0,1,0.125
网络层,0,0,0,1,1,0,0,2,0.3666666666666667
nb-iot设备终端,0,0,0,1,0,0,0,1,0.125
注册,0,0,0,1,0,0,0,1,0.125
功耗浪费,0,0,0,1,1,0,0,2,0.3666666666666667
信令处理,0,0,0,1,0,0,0,1,0.125
接入层,0,0,0,1,0,0,0,1,0.125
下行数据,0,0,0,1,0,1,0,2,0.3666666666666667
网络寻呼,0,0,0,1,0,0,0,1,0.125
物联网设备终端,0,0,0,1,0,0,0,1,0.125
低功耗功能,0,0,0,1,1,0,0,2,0.3666666666666667
状态,0,0,0,3,2,2,0,7,1.3416666666666668
3gppr12协议,0,0,0,1,0,0,0,1,0.125
功耗模式,0,0,0,1,0,0,0,1,0.125
extendeddrx,0,0,0,1,0,0,0,1,0.125
powersavingmode,0,0,0,1,0,0,0,1,0.125
通信方式,0,0,0,1,0,0,0,1,0.125
封装通信模组,0,0,0,1,0,0,0,1,0.125
低功耗性能,0,0,0,2,0,0,0,2,0.25
测量对象,0,0,0,1,0,0,0,1,0.125
测量,0,0,0,1,0,0,0,1,0.125
连接态,0,0,0,1,0,0,0,1,0.125
复杂度,0,0,0,1,0,0,0,1,0.125
异常震动报警,0,0,0,1,0,0,0,1,0.125
海量连接,0,0,0,1,0,0,0,1,0.125
窄带物联网,0,0,0,1,2,0,0,3,0.6083333333333334
iot通信技术,0,0,0,1,0,0,0,1,0.125
消息,0,0,0,7,19,10,0,36,7.883333333333334
请求,0,0,0,6,2,2,0,10,1.7166666666666668
长度,0,0,0,7,0,0,0,7,0.875
token,0,0,0,4,0,0,0,4,0.5
响应,0,0,0,5,3,0,0,8,1.35
coap,0,0,0,6,2,0,0,8,1.2333333333333334
http协议,0,0,0,5,1,2,0,8,1.35
服务器,0,0,0,4,6,3,0,13,2.675
payload标识符,0,0,0,2,0,0,0,2,0.25
消息格式,0,0,0,2,0,0,0,2,0.25
rst,0,0,0,2,0,0,0,2,0.25
消息类型,0,0,0,2,1,0,0,3,0.4916666666666667
可靠传输,0,0,0,2,0,0,0,2,0.25
客户端,0,0,0,2,2,0,0,4,0.7333333333333334
payload长度,0,0,0,1,0,0,0,1,0.125
payload,0,0,0,1,0,0,0,1,0.125
端口,0,0,0,1,0,0,0,1,0.125
目标主机,0,0,0,1,0,0,0,1,0.125
代理服务器,0,0,0,1,0,0,0,1,0.125
特性,0,0,0,1,0,0,0,1,0.125
参数,0,0,0,1,1,2,0,4,0.85
属性,0,0,0,1,0,0,0,1,0.125
option,0,0,0,1,0,0,0,1,0.125
回应消息,0,0,0,1,0,0,0,1,0.125
请求消息,0,0,0,1,1,0,0,2,0.3666666666666667
报文,0,0,0,1,0,0,0,1,0.125
随机数,0,0,0,1,0,0,0,1,0.125
消息安全性,0,0,0,1,0,0,0,1,0.125
标记,0,0,0,1,0,0,0,1,0.125
序列,0,0,0,1,0,0,0,1,0.125
响应码,0,0,0,1,0,0,0,1,0.125
请求码,0,0,0,1,0,0,0,1,0.125
空消息,0,0,0,1,0,0,0,1,0.125
token长度,0,0,0,1,0,0,0,1,0.125
tkl,0,0,0,1,0,0,0,1,0.125
3coap报文,0,0,0,1,0,0,0,1,0.125
tkl字节,0,0,0,1,0,0,0,1,0.125
titk,0,0,0,1,0,0,0,1,0.125
rst消息,0,0,0,1,0,0,0,1,0.125
ack消息,0,0,0,1,0,0,0,1,0.125
一复位消息,0,0,0,1,0,0,0,1,0.125
con消息,0,0,0,1,0,0,0,1,0.125
应答消息,0,0,0,1,0,0,0,1,0.125
可靠消息传输,0,0,0,1,0,0,0,1,0.125
丢包,0,0,0,1,1,1,0,3,0.6083333333333334
接收方,0,0,0,3,2,0,0,5,0.8583333333333334
消息传输,0,0,0,1,0,0,0,1,0.125
tcp协议,0,0,0,2,0,0,0,2,0.25
con请求,0,0,0,1,2,0,0,3,0.6083333333333334
kj,0,0,0,1,0,0,0,1,0.125
非长连接通信,0,0,0,1,0,0,0,1,0.125
传输,0,0,0,1,1,0,1,3,0.6083333333333334
块传输,0,0,0,1,0,0,0,1,0.125
轻量化,0,0,0,1,0,0,0,1,0.125
http,0,0,0,1,0,0,0,1,0.125
二进制格式,0,0,0,1,0,0,0,1,0.125
文本格式,0,0,0,1,0,0,0,1,0.125
url,0,0,0,1,0,0,0,1,0.125
资源地,0,0,0,1,0,0,0,1,0.125
rest架构网,0,0,0,1,0,0,0,1,0.125
udp,0,0,0,1,1,0,0,2,0.3666666666666667
传输层,0,0,0,1,0,0,0,1,0.125
coap协议网络,0,0,0,1,0,0,0,1,0.125
解析复杂性,0,0,0,1,0,0,0,1,0.125
头部开销,0,0,0,1,0,0,0,1,0.125
rom,0,0,0,1,0,0,0,1,0.125
ram,0,0,0,1,1,0,0,2,0.3666666666666667
物联网平台,0,0,0,1,1,0,0,2,0.3666666666666667
耦合度,0,0,0,1,0,0,0,1,0.125
层次资源,0,0,0,1,0,0,0,1,0.125
tcp长连接,0,0,0,1,0,0,0,1,0.125
低功耗设备,0,0,0,1,0,0,0,1,0.125
性质,0,0,0,1,0,0,0,1,0.125
受限应用协议,0,0,0,1,0,0,0,1,0.125
在物联,0,0,0,1,0,0,0,1,0.125
constrainedapplic,0,0,0,1,0,0,0,1,0.125
cpu,0,0,0,5,1,1,0,7,1.1083333333333334
进程,0,0,0,5,2,4,0,11,2.075
进程集,0,0,0,4,0,0,0,4,0.5
执行频率,0,0,0,3,0,0,0,3,0.375
cpu利用率,0,0,0,3,0,1,0,4,0.6166666666666667
状态信息,0,0,0,3,1,0,0,4,0.6166666666666667
离线dvs算法,0,0,0,3,0,0,0,3,0.375
窗口,0,0,0,2,0,0,0,2,0.25
在线dvs算法,0,0,0,2,0,0,0,2,0.25
调度,0,0,0,4,1,2,0,7,1.225
任务调度,1,1,0,4,7,2,0,15,5.675
动态电压调节技术,0,0,0,3,0,0,0,3,0.375
动态调节,0,0,0,1,0,0,0,1,0.125
利用率,0,0,0,1,0,0,0,1,0.125
实时性能,0,0,0,1,0,0,0,1,0.125
统计窗口,0,0,0,1,0,0,0,1,0.125
时间,0,0,0,2,4,1,0,7,1.4583333333333333
weiser算法网,0,0,0,1,0,0,0,1,0.125
进程状态,0,0,0,1,0,0,0,1,0.125
任务进程集,0,0,0,1,0,0,0,1,0.125
进程数量,0,0,0,1,0,0,0,1,0.125
依赖性,0,0,0,1,0,0,0,1,0.125
离线调度,0,0,0,1,0,0,0,1,0.125
低功耗调度,0,0,0,1,0,0,0,1,0.125
在线dvs任务调度,0,0,0,1,0,0,0,1,0.125
离线dvs任务调度,0,0,0,1,0,0,0,1,0.125
dynamicvoltagescaling,0,0,0,1,0,0,0,1,0.125
平衡功耗,0,0,0,1,0,0,0,1,0.125
电压,0,0,0,1,0,0,1,2,0.3666666666666667
动态电压调节技,0,0,0,1,0,0,0,1,0.125
故障,0,0,0,5,0,0,0,5,0.625
瞬态故障,0,0,0,3,0,0,0,3,0.375
临时性故障,0,0,0,3,0,0,0,3,0.375
永久性故障,0,0,0,3,0,0,0,3,0.375
备用支持技术,0,0,0,3,0,0,0,3,0.375
备用进程,0,0,0,1,0,0,0,1,0.125
工作进程,0,0,0,1,0,10,0,11,2.5416666666666665
进程调度,0,0,0,1,0,0,0,1,0.125
概率,0,0,0,1,0,0,0,1,0.125
工作频率,0,0,0,1,1,0,0,2,0.3666666666666667
辐射干扰,0,0,0,1,0,0,0,1,0.125
硬件冗余,0,0,0,1,0,0,0,1,0.125
机器,0,0,0,1,0,0,0,1,0.125
计算机系统,0,0,0,1,0,0,0,1,0.125
可靠性,0,0,0,2,0,0,0,2,0.25
嵌入式系统,0,0,0,6,6,0,0,12,2.2
动态电源管理技术,2,0,0,5,7,1,3,18,5.283333333333333
随机策略,0,0,0,2,1,0,0,3,0.4916666666666667
预测策略,0,0,0,2,1,0,0,3,0.4916666666666667
超时策略,0,0,0,2,5,0,0,7,1.4583333333333333
空闲时间,0,0,0,2,1,0,0,3,0.4916666666666667
时钟信息,0,0,0,1,0,0,0,1,0.125
数学建模,0,0,0,1,0,0,0,1,0.125
马尔科夫,0,0,0,1,1,0,0,2,0.3666666666666667
随机模型,0,0,0,1,0,0,0,1,0.125
系统模型,0,0,0,1,0,0,0,1,0.125
统计学,0,0,0,1,0,0,0,1,0.125
动态电源管理策,0,0,0,1,0,0,0,1,0.125
动态电源,0,0,0,1,0,3,0,4,0.85
操作系统,0,0,0,8,12,1,0,21,4.141666666666667
节能机制,0,0,0,1,0,0,0,1,0.125
硬件技术,0,0,0,1,0,0,0,1,0.125
按键照明,0,0,0,1,0,0,0,1,0.125
背景灯,0,0,0,1,0,0,0,1,0.125
拨号,0,0,0,1,0,0,0,1,0.125
智能手机,0,0,0,1,0,0,0,1,0.125
睡眠,0,0,0,1,1,0,0,2,0.3666666666666667
待机,0,0,0,1,1,0,0,2,0.3666666666666667
时钟,0,0,0,1,9,1,0,11,2.5416666666666665
显示屏,0,0,0,1,0,0,0,1,0.125
交流主电源,0,0,0,1,0,0,0,1,0.125
便携式设备,0,0,0,1,0,0,0,1,0.125
笔记本计算机,0,0,0,1,0,0,0,1,0.125
节电操作,0,0,0,1,0,0,0,1,0.125
外设,0,0,0,1,4,0,0,5,1.0916666666666668
内核,0,0,0,1,1,0,0,2,0.3666666666666667
模块,0,0,0,2,9,1,0,12,2.6666666666666665
控制,0,0,0,1,1,0,0,2,0.3666666666666667
调用频率,0,0,0,1,0,0,0,1,0.125
外围设备,0,0,0,1,0,0,0,1,0.125
总数,0,0,0,1,0,0,0,1,0.125
任务,0,0,0,1,3,2,1,7,1.575
电源,0,0,0,1,3,0,0,4,0.85
系统电源管理,0,0,0,1,2,0,0,3,0.6083333333333334
工作模式,0,0,0,1,2,0,0,3,0.6083333333333334
工作,0,0,0,1,5,1,0,7,1.575
工作状态模,0,0,0,1,0,0,0,1,0.125
编译,0,0,0,1,0,0,0,1,0.125
功耗婢技,0,0,0,1,0,0,0,1,0.125
实时性,0,0,0,9,7,0,0,16,2.8166666666666664
中断,0,0,0,5,5,1,0,11,2.075
优先级,0,0,0,5,2,0,0,7,1.1083333333333334
文件系统,0,0,0,3,0,0,0,3,0.375
实时调度器,0,0,0,3,0,0,0,3,0.375
嵌入式设备,0,0,0,2,2,0,0,4,0.7333333333333334
虚拟内存,0,0,0,2,0,0,0,2,0.25
实时系统,0,0,0,2,0,0,0,2,0.25
系统级服务,0,0,0,2,0,0,0,2,0.25
中断处理器,0,0,0,2,0,0,0,2,0.25
信号量,0,0,0,2,1,0,0,3,0.4916666666666667
fifo,0,0,0,2,0,0,0,2,0.25
cpu时间,0,0,0,2,0,0,0,2,0.25
实时任务调度器,0,0,0,2,0,0,0,2,0.25
工程工业自动化,0,0,0,1,0,0,0,1,0.125
军事,0,0,0,1,0,0,0,1,0.125
航空航天,0,0,0,1,0,0,0,1,0.125
硬件性能,0,0,0,1,0,1,0,2,0.3666666666666667
linux操作系统,0,0,0,1,0,0,0,1,0.125
干扰,0,0,0,1,0,0,0,1,0.125
动态任务,0,0,0,1,0,0,0,1,0.125
动态内存分配,0,0,0,1,0,0,0,1,0.125
用户程序,0,0,0,1,0,0,0,1,0.125
代码,0,0,0,1,1,0,0,2,0.3666666666666667
毫秒,0,0,0,1,0,0,0,1,0.125
延时,0,0,0,1,2,0,0,3,0.6083333333333334
页面故障,0,0,0,1,0,0,0,1,0.125
分页,0,0,0,1,0,0,0,1,0.125
页面错误,0,0,0,1,0,0,0,1,0.125
高性能驱动程序,0,0,0,1,0,0,0,1,0.125
实时驱动程序,0,0,0,1,0,0,0,1,0.125
应用程序,0,0,0,1,0,3,0,4,0.85
系统服务,0,0,0,1,0,0,0,1,0.125
高优先级策略,0,0,0,1,0,0,0,1,0.125
高优先级请求,0,0,0,1,0,0,0,1,0.125
优先级数据,0,0,0,1,0,0,0,1,0.125
线程池,0,0,0,1,1,6,0,8,1.8166666666666667
用户请求,0,0,0,1,0,0,0,1,0.125
缓存,0,0,0,1,1,0,0,2,0.3666666666666667
非实时系统,0,0,0,1,0,0,0,1,0.125
低优先级任务,0,0,0,1,0,0,0,1,0.125
先级,0,0,0,1,0,0,0,1,0.125
关键数据,0,0,0,1,1,0,0,2,0.3666666666666667
事件,0,0,0,1,1,2,0,4,0.85
非实时操作系统,0,0,0,1,0,0,0,1,0.125
同步,0,0,0,1,0,0,0,1,0.125
驱动程序,0,0,0,1,0,0,0,1,0.125
粗粒度,0,0,0,1,0,0,0,1,0.125
死锁,0,0,0,1,0,0,0,1,0.125
apl实时操作系统,0,0,0,1,0,0,0,1,0.125
优先级翻转,0,0,0,1,0,0,0,1,0.125
调度器,0,0,0,1,0,1,0,2,0.3666666666666667
翻转处理,0,0,0,1,0,0,0,1,0.125
内核级,0,0,0,1,0,0,0,1,0.125
优先,0,0,0,1,0,0,0,1,0.125
等待信号量,0,0,0,1,0,0,0,1,0.125
先进,0,0,0,1,0,0,0,1,0.125
消息队列,0,0,0,1,7,6,1,15,3.5083333333333333
常规操作系统,0,0,0,1,0,0,0,1,0.125
事件处理机制,0,0,0,1,0,0,0,1,0.125
rc/os,0,0,0,1,0,0,0,1,0.125
rt-thread,0,0,0,1,0,0,0,1,0.125
vxworks,0,0,0,1,0,0,0,1,0.125
cpu任务切换,0,0,0,1,0,0,0,1,0.125
触发中断,0,0,0,1,0,0,0,1,0.125
时间片轮转,0,0,0,1,0,0,0,1,0.125
任务调度器,0,0,0,1,0,0,0,1,0.125
高科技,0,0,0,1,0,0,0,1,0.125
军事测量,0,0,0,1,0,0,0,1,0.125
稳定性,0,0,0,1,2,0,0,3,0.6083333333333334
嵌入式应用,0,0,0,1,0,0,0,1,0.125
抢占式调度,0,0,0,1,0,0,0,1,0.125
处理速度,0,0,0,1,0,2,0,3,0.6083333333333334
外部中断,0,0,0,1,1,0,0,2,0.3666666666666667
操作,0,0,0,1,0,0,0,1,0.125
rtos,0,0,0,2,0,0,0,2,0.25
real-timeoperatingsystem,0,0,0,1,0,0,0,1,0.125
iot平台,0,0,0,0,6,0,0,6,1.45
基站,0,0,0,0,8,0,0,8,1.9333333333333333
nb-iot系统,0,0,0,0,3,0,0,3,0.725
nb-iot终端设备,0,0,0,0,7,0,0,7,1.6916666666666667
nb-iot网络,0,0,0,0,6,0,0,6,1.45
接口,0,0,0,0,5,0,0,5,1.2083333333333333
nb-iot模块,0,0,0,0,6,0,0,6,1.45
iot云平台,0,0,0,0,3,0,0,3,0.725
服务端模型,0,0,0,0,2,0,0,2,0.48333333333333334
通信模型,0,0,0,0,2,0,0,2,0.48333333333333334
智能物联网设备,0,0,0,0,3,0,0,3,0.725
事件订阅管理机,0,0,0,0,1,0,0,1,0.24166666666666667
流量调度机制,0,0,0,0,1,0,0,1,0.24166666666666667
拥塞控制,0,0,0,0,1,0,0,1,0.24166666666666667
时延不敏感终端,0,0,0,0,1,0,0,1,0.24166666666666667
终端安全接入,0,0,0,0,1,0,0,1,0.24166666666666667
基础设施,0,0,0,0,1,0,0,1,0.24166666666666667
站点,0,0,0,0,1,0,0,1,0.24166666666666667
行业终端,0,0,0,0,1,0,0,1,0.24166666666666667
nb-iot网络架构,0,0,0,0,1,0,0,1,0.24166666666666667
功能,0,0,0,0,2,0,0,2,0.48333333333333334
底层传感设备,0,0,0,0,1,0,0,1,0.24166666666666667
nbtot网络,0,0,0,0,1,0,0,1,0.24166666666666667
运营商,0,0,0,0,1,0,0,1,0.24166666666666667
触发,0,0,0,0,1,0,0,1,0.24166666666666667
定义事件,0,0,0,0,1,0,0,1,0.24166666666666667
下行接口,0,0,0,0,1,0,0,1,0.24166666666666667
通知机制,0,0,0,0,1,0,0,1,0.24166666666666667
应用服务器,0,0,0,0,1,0,0,1,0.24166666666666667
信令控制设备,0,0,0,0,1,0,0,1,0.24166666666666667
运营商iot平台,0,0,0,0,1,0,0,1,0.24166666666666667
核心网设备,0,0,0,0,1,0,0,1,0.24166666666666667
基础通信,0,0,0,0,1,0,0,1,0.24166666666666667
epc,0,0,0,0,1,0,0,1,0.24166666666666667
分组核心网,0,0,0,0,1,0,0,1,0.24166666666666667
无线通信,0,0,0,0,1,0,0,1,0.24166666666666667
编码,0,0,0,0,1,0,0,1,0.24166666666666667
数据信息,0,0,0,0,1,0,0,1,0.24166666666666667
底层通信协议,0,0,0,0,1,0,0,1,0.24166666666666667
底层硬件设备,0,0,0,0,2,0,0,2,0.48333333333333334
设备终端,0,0,0,0,1,0,0,1,0.24166666666666667
第三方应用服务器,0,0,0,0,1,0,0,1,0.24166666666666667
客户端设备,0,0,0,0,4,4,0,8,1.9333333333333333
通信角色,0,0,0,0,1,0,0,1,0.24166666666666667
客户,0,0,0,0,1,0,0,1,0.24166666666666667
发布模型,0,0,0,0,1,0,0,1,0.24166666666666667
订阅,0,0,0,0,1,0,0,1,0.24166666666666667
mqtt协议,0,0,0,0,1,0,0,1,0.24166666666666667
客户/,0,0,0,0,1,0,0,1,0.24166666666666667
物联网生态体系,0,0,0,0,1,0,0,1,0.24166666666666667
nb模组,0,0,0,0,4,0,0,4,0.9666666666666667
利尔达,0,0,0,0,4,0,0,4,0.9666666666666667
通信模块,0,0,0,0,7,4,0,11,2.658333333333333
热力管网,0,0,0,0,21,12,0,33,7.975
引脚,0,0,0,0,1,0,0,1,0.24166666666666667
nb-iot模组引脚,0,0,0,0,1,0,0,1,0.24166666666666667
覆盖,0,0,0,0,1,0,1,2,0.48333333333333334
网络基站,0,0,0,0,1,0,0,1,0.24166666666666667
内置协议栈,0,0,0,0,1,0,0,1,0.24166666666666667
运行商,0,0,0,0,1,0,0,1,0.24166666666666667
任务集,0,0,0,0,1,0,0,1,0.24166666666666667
热力领域系统,0,0,0,0,1,0,0,1,0.24166666666666667
网络协议,0,0,0,0,1,0,0,1,0.24166666666666667
ip,0,0,0,0,1,0,0,1,0.24166666666666667
at拓展指令,0,0,0,0,1,0,0,1,0.24166666666666667
pp,0,0,0,0,1,0,0,1,0.24166666666666667
卡通信接口,0,0,0,0,1,0,0,1,0.24166666666666667
sim/usim,0,0,0,0,1,0,0,1,0.24166666666666667
adc接口,0,0,0,0,4,1,0,5,1.2083333333333333
uart接口,0,0,0,0,1,0,0,1,0.24166666666666667
nb-1ot模组,0,0,0,0,1,0,0,1,0.24166666666666667
利尔达nb-iot模组,0,0,0,0,1,0,0,1,0.24166666666666667
实验,0,0,0,0,2,0,0,2,0.48333333333333334
物联网产品,0,0,0,0,2,0,0,2,0.48333333333333334
抗干扰能力,0,0,0,0,1,0,0,1,0.24166666666666667
体积,0,0,0,0,1,0,0,1,0.24166666666666667
海思芯片组,0,0,0,0,1,0,0,1,0.24166666666666667
nb-iot物联网模组,0,0,0,0,1,0,0,1,0.24166666666666667
at控制指令,0,0,0,0,1,0,0,1,0.24166666666666667
高新兴物联,0,0,0,0,1,0,0,1,0.24166666666666667
电信云平台,0,0,0,0,1,0,0,1,0.24166666666666667
环境感知层,0,0,0,0,3,0,0,3,0.725
热力管网环,0,0,0,0,1,0,0,1,0.24166666666666667
地下穿透能力,0,0,0,0,1,0,0,1,0.24166666666666667
信号强度,0,0,0,0,1,0,0,1,0.24166666666666667
中国电信,0,0,0,0,1,2,0,3,0.725
井盖数字化状态监控,0,0,0,0,3,0,0,3,0.725
测温,0,0,0,0,3,0,0,3,0.725
流量监测,0,0,0,0,3,0,0,3,0.725
压力监测,0,0,0,0,3,0,0,3,0.725
热力行业,1,0,0,0,3,0,0,4,1.725
模组选型,0,0,0,0,1,0,0,1,0.24166666666666667
stm32l,0,0,0,0,10,0,0,10,2.4166666666666665
控制模块,0,0,0,0,3,3,0,6,1.45
stm32l系列,0,0,0,0,3,0,0,3,0.725
硬件验证,0,0,0,0,1,0,0,1,0.24166666666666667
功能冗余,0,0,0,0,1,0,0,1,0.24166666666666667
stm32f系列,0,0,0,0,1,0,0,1,0.24166666666666667
外设传感器,0,0,0,0,1,0,0,1,0.24166666666666667
adc转换接口,0,0,0,0,1,0,0,1,0.24166666666666667
iic通信接口,0,0,0,0,1,0,0,1,0.24166666666666667
rs485接口,0,0,0,0,4,1,0,5,1.2083333333333333
spi通信接口,0,0,0,0,1,0,0,1,0.24166666666666667
gpio外设接口,0,0,0,0,1,0,0,1,0.24166666666666667
传感器,0,0,0,0,9,3,0,12,2.9
i/o,0,0,0,0,2,5,0,7,1.6916666666666667
增强型,0,0,0,0,1,0,0,1,0.24166666666666667
apb总线,0,0,0,0,1,0,0,1,0.24166666666666667
闪存,0,0,0,0,1,0,0,1,0.24166666666666667
高速嵌入式存储器,0,0,0,0,1,0,0,1,0.24166666666666667
mpu,0,0,0,0,1,0,0,1,0.24166666666666667
存储器保护单元,0,0,0,0,1,0,0,1,0.24166666666666667
32位risc内核频率,0,0,0,0,1,0,0,1,0.24166666666666667
armcortex-m3,0,0,0,0,1,0,0,1,0.24166666666666667
usb,0,0,0,0,1,0,0,1,0.24166666666666667
通用串行总线,0,0,0,0,1,0,0,1,0.24166666666666667
器件,0,0,0,0,1,0,0,1,0.24166666666666667
意法半导体,0,0,0,0,1,0,0,1,0.24166666666666667
低功耗系列,0,0,0,0,1,0,0,1,0.24166666666666667
lis3dh传感器,0,0,0,0,7,0,0,7,1.6916666666666667
低功耗模式,0,0,0,0,13,2,0,15,3.625
lis3dh,0,0,0,0,2,0,0,2,0.48333333333333334
三轴加速度传感器,0,0,0,0,2,0,0,2,0.48333333333333334
智能设备,0,0,0,0,1,0,0,1,0.24166666666666667
测量精度,0,0,0,0,1,0,0,1,0.24166666666666667
采样频率,0,0,0,0,1,0,0,1,0.24166666666666667
分辨率,0,0,0,0,1,0,0,1,0.24166666666666667
传感器系统,0,0,0,0,1,0,0,1,0.24166666666666667
数据精确,0,0,0,0,1,0,0,1,0.24166666666666667
元器件,0,0,0,0,1,0,0,1,0.24166666666666667
正常模式,0,0,0,0,1,0,0,1,0.24166666666666667
数字通信接口,0,0,0,0,1,0,0,1,0.24166666666666667
spi,0,0,0,0,4,1,0,5,1.2083333333333333
内部模块,0,0,0,0,1,0,0,1,0.24166666666666667
掉电模式,0,0,0,0,1,0,0,1,0.24166666666666667
温度,0,0,0,0,2,3,0,5,1.2083333333333333
设备封装,0,0,0,0,1,0,0,1,0.24166666666666667
主处理器,0,0,0,0,1,0,0,1,0.24166666666666667
fifo缓存,0,0,0,0,1,0,0,1,0.24166666666666667
时间跨度,0,0,0,0,2,0,0,2,0.48333333333333334
阈值,0,0,0,0,1,0,0,1,0.24166666666666667
中断信号,0,0,0,0,2,0,0,2,0.48333333333333334
处理器通信,0,0,0,0,1,0,0,1,0.24166666666666667
自由落体,0,0,0,0,1,0,0,1,0.24166666666666667
加速度,0,0,0,0,1,0,0,1,0.24166666666666667
数据速率,0,0,0,0,1,0,0,1,0.24166666666666667
动态,0,0,0,0,1,0,0,1,0.24166666666666667
智能嵌入式功能,0,0,0,0,1,0,0,1,0.24166666666666667
高性能节能,0,0,0,0,1,0,0,1,0.24166666666666667
低功耗操作模,0,0,0,0,1,0,0,1,0.24166666666666667
低功率,0,0,0,0,1,0,0,1,0.24166666666666667
异常震动,0,0,0,0,1,0,0,1,0.24166666666666667
丹弗斯流量表,0,0,0,0,1,0,0,1,0.24166666666666667
流量数据,0,0,0,0,1,0,0,1,0.24166666666666667
温度变送器,0,0,0,0,2,0,0,2,0.48333333333333334
压力变送器,0,0,0,0,2,1,0,3,0.725
控制主板,0,0,0,0,12,1,0,13,3.1416666666666666
模块化,0,0,0,0,11,0,0,11,2.658333333333333
串口,0,0,0,0,10,2,0,12,2.9
感知识别层,0,0,0,0,9,0,0,9,2.175
外设模块,0,0,0,0,5,0,0,5,1.2083333333333333
nb-iot通信模块,0,0,0,0,7,1,0,8,1.9333333333333333
标志位,0,0,0,0,3,0,0,3,0.725
con,0,0,0,0,3,0,0,3,0.725
主板,0,0,0,0,3,0,0,3,0.725
gpio,0,0,0,0,2,0,0,2,0.48333333333333334
ag,0,0,0,0,2,0,0,2,0.48333333333333334
tion,0,0,0,0,2,2,0,4,0.9666666666666667
fig,0,0,0,0,2,1,0,3,0.725
getflago,0,0,0,0,2,0,0,2,0.48333333333333334
ura,1,0,0,0,2,0,0,3,1.4833333333333334
rs485,0,0,0,0,2,1,0,3,0.725
串口中断,0,0,0,0,2,0,0,2,0.48333333333333334
初始化,0,0,0,0,4,1,0,5,1.2083333333333333
数据接口,0,0,0,0,2,0,0,2,0.48333333333333334
环境信息,0,0,0,0,3,0,0,3,0.725
接入电源,0,0,0,0,2,0,0,2,0.48333333333333334
子程序,0,0,0,0,2,0,0,2,0.48333333333333334
spi接口,0,0,0,0,2,1,0,3,0.725
测温模块,0,0,0,0,2,0,0,2,0.48333333333333334
压力测量模块,0,0,0,0,2,0,0,2,0.48333333333333334
流量监控模块,0,0,0,0,2,0,0,2,0.48333333333333334
井盖数字化状态监控模块,0,0,0,0,2,1,0,3,0.725
内置mcu,0,0,0,0,2,0,0,2,0.48333333333333334
前端,0,0,0,0,1,0,0,1,0.24166666666666667
到达,0,0,0,0,1,0,0,1,0.24166666666666667
iot核心网,0,0,0,0,1,0,0,1,0.24166666666666667
nb-iot基站,0,0,0,0,2,0,0,2,0.48333333333333334
数据接收,0,0,0,0,1,0,0,1,0.24166666666666667
云平台,0,0,0,0,2,0,0,2,0.48333333333333334
丢弃,0,0,0,0,1,0,0,1,0.24166666666666667
发送数据,0,0,0,0,1,1,0,2,0.48333333333333334
睡眠模式,0,0,0,0,4,0,0,4,0.9666666666666667
深度睡眠模式,0,0,0,0,3,0,0,3,0.725
供暖,0,0,0,0,1,3,0,4,0.9666666666666667
系统功耗,0,0,0,0,1,0,0,1,0.24166666666666667
误报次数,0,0,0,0,1,0,0,1,0.24166666666666667
上传数据,0,0,0,0,1,0,0,1,0.24166666666666667
数据监测,0,0,0,0,1,0,0,1,0.24166666666666667
回传数据,0,0,0,0,1,0,0,1,0.24166666666666667
浮空输入,0,0,0,0,1,0,0,1,0.24166666666666667
接口接触,0,0,0,0,1,0,0,1,0.24166666666666667
温度测量,0,0,0,0,1,0,0,1,0.24166666666666667
delay,0,0,0,0,1,0,0,1,0.24166666666666667
jiesetbits,0,0,0,0,1,0,0,1,0.24166666666666667
ff,0,0,0,0,1,0,0,1,0.24166666666666667
ffer,0,0,0,0,1,0,0,1,0.24166666666666667
reclenl,0,0,0,0,1,0,0,1,0.24166666666666667
hi,0,0,0,0,1,0,0,1,0.24166666666666667
ved,0,0,0,0,1,0,0,1,0.24166666666666667
rxbufferl,0,0,0,0,1,0,0,1,0.24166666666666667
getflagstatus,0,0,0,0,1,0,0,1,0.24166666666666667
rt,0,0,0,0,1,0,0,1,0.24166666666666667
shtll,0,0,0,0,1,0,0,1,0.24166666666666667
ra485,0,0,0,0,1,0,0,1,0.24166666666666667
configuration,0,0,0,0,1,3,0,4,0.9666666666666667
nbjidc,0,0,0,0,1,0,0,1,0.24166666666666667
外设类别,0,0,0,0,1,0,0,1,0.24166666666666667
flag,0,0,0,0,1,0,0,1,0.24166666666666667
configura,0,0,0,0,1,0,0,1,0.24166666666666667
gura,0,0,0,0,1,0,0,1,0.24166666666666667
环境,0,0,0,0,1,0,0,1,0.24166666666666667
感知层外设,0,0,0,0,1,0,0,1,0.24166666666666667
硬件控制主板,0,0,0,0,1,0,0,1,0.24166666666666667
目标环境信息,0,0,0,0,1,0,0,1,0.24166666666666667
应用场景,0,0,0,0,1,0,0,1,0.24166666666666667
映射式,0,0,0,0,1,0,0,1,0.24166666666666667
接收,0,0,0,0,1,1,0,2,0.48333333333333334
单片机程序,0,0,0,0,1,0,0,1,0.24166666666666667
hc接口,0,0,0,0,1,0,0,1,0.24166666666666667
类型单片机,0,0,0,0,1,0,0,1,0.24166666666666667
stm32l15,0,0,0,0,2,0,0,2,0.48333333333333334
类别,0,0,0,0,1,0,0,1,0.24166666666666667
感知识别层模块,0,0,0,0,1,0,0,1,0.24166666666666667
烧录控制程序,0,0,0,0,1,0,0,1,0.24166666666666667
物理层控制,0,0,0,0,1,0,0,1,0.24166666666666667
低功耗任务调度算法,0,0,0,0,1,0,0,1,0.24166666666666667
nb-iot终端产品,0,0,0,0,1,0,0,1,0.24166666666666667
功能模块,0,0,0,0,2,0,0,2,0.48333333333333334
模块化终端产品,0,0,0,0,1,0,0,1,0.24166666666666667
控制芯片,0,0,0,0,4,0,0,4,0.9666666666666667
电池组,0,0,0,0,2,1,0,3,0.725
感知识别层外设,0,0,0,0,2,0,0,2,0.48333333333333334
智能传感器设备,0,0,0,0,1,0,0,1,0.24166666666666667
热力,0,0,0,0,2,1,0,3,0.725
热力系统,0,0,0,0,1,0,0,1,0.24166666666666667
供电,0,0,0,0,1,0,0,1,0.24166666666666667
环境信息数据,0,0,0,0,1,0,0,1,0.24166666666666667
热力监控管理系统,0,0,0,0,1,0,0,1,0.24166666666666667
gc/os-iii系统,0,0,0,0,4,0,0,4,0.9666666666666667
系统时钟,0,0,0,0,4,0,0,4,0.9666666666666667
clock,0,0,0,0,2,0,0,2,0.48333333333333334
rcc,0,0,0,0,2,0,0,2,0.48333333333333334
定时器,0,0,0,0,2,0,0,2,0.48333333333333334
cortex-m3内核,0,0,0,0,2,0,0,2,0.48333333333333334
stm32,0,0,0,0,2,1,0,3,0.725
c语言,0,0,0,0,2,0,0,2,0.48333333333333334
systick,0,0,0,0,1,1,0,2,0.48333333333333334
32utemp,0,0,0,0,1,0,0,1,0.24166666666666667
clockstypede,0,0,0,0,1,0,0,1,0.24166666666666667
systicklnit,0,0,0,0,1,0,0,1,0.24166666666666667
函数,0,0,0,0,1,1,0,2,0.48333333333333334
rc/os-in操作系统,0,0,0,0,1,0,0,1,0.24166666666666667
systick时钟函数接口,0,0,0,0,1,0,0,1,0.24166666666666667
tic/os-ni系统,0,0,0,0,1,0,0,1,0.24166666666666667
软件定时器时钟,0,0,0,0,1,0,0,1,0.24166666666666667
任务调度时钟,0,0,0,0,1,0,0,1,0.24166666666666667
中断响应,0,0,0,0,3,0,0,3,0.725
滴答定时器,0,0,0,0,1,0,0,1,0.24166666666666667
系统终端,0,0,0,0,1,0,0,1,0.24166666666666667
开发,0,0,0,0,1,0,0,1,0.24166666666666667
^c/os-iii系统,0,0,0,0,1,0,0,1,0.24166666666666667
移植,0,0,0,0,1,0,0,1,0.24166666666666667
开发板,0,0,0,0,1,0,0,1,0.24166666666666667
中断配置函数,0,0,0,0,2,0,0,2,0.48333333333333334
systick时钟,0,0,0,0,1,0,0,1,0.24166666666666667
fic/os-ni系统,0,0,0,0,1,0,0,1,0.24166666666666667
单片机,0,0,0,0,4,0,0,4,0.9666666666666667
pc/os-iii,0,0,0,0,1,0,0,1,0.24166666666666667
内核支持,0,0,0,0,1,0,0,1,0.24166666666666667
开源,0,0,0,0,1,0,0,1,0.24166666666666667
gc/os-in系统,0,0,0,0,1,0,0,1,0.24166666666666667
移植性能,0,0,0,0,1,0,0,1,0.24166666666666667
嵌入式程序,0,0,0,0,1,0,0,1,0.24166666666666667
gc/os-iii操作系统,0,0,0,0,2,0,0,2,0.48333333333333334
系统移,0,0,0,0,1,0,0,1,0.24166666666666667
arm系统,0,0,0,0,1,0,0,1,0.24166666666666667
gc/os-ni系统,0,0,0,0,1,0,0,1,0.24166666666666667
功耗管理,0,0,0,0,1,0,0,1,0.24166666666666667
任务进程,0,0,0,0,1,1,0,2,0.48333333333333334
动态功耗管理,1,0,0,0,1,0,0,2,1.2416666666666667
任务程序,0,0,0,0,4,0,0,4,0.9666666666666667
任务切换,0,0,0,0,3,0,0,3,0.725
休眠状态,0,0,0,0,4,0,0,4,0.9666666666666667
报警任务,0,0,0,0,2,0,0,2,0.48333333333333334
中断服务程序,0,0,0,0,2,0,0,2,0.48333333333333334
运行状态,0,0,0,0,2,0,0,2,0.48333333333333334
库函数,0,0,0,0,2,0,0,2,0.48333333333333334
控制权,0,0,0,0,1,0,0,1,0.24166666666666667
工作任务,0,0,0,0,1,0,0,1,0.24166666666666667
就绪状态,0,0,0,0,1,0,0,1,0.24166666666666667
抢占,0,0,0,0,1,0,0,1,0.24166666666666667
抢占式内核,0,0,0,0,1,0,0,1,0.24166666666666667
gc/os-iii,0,0,0,0,2,0,0,2,0.48333333333333334
调度程序,0,0,0,0,1,0,0,1,0.24166666666666667
nc/os-ni操作系统,0,0,0,0,1,0,0,1,0.24166666666666667
-lii,0,0,0,0,1,0,0,1,0.24166666666666667
fic/os-iii,0,0,0,0,1,0,0,1,0.24166666666666667
就绪,0,0,0,0,1,0,0,1,0.24166666666666667
中断事件,0,0,0,0,1,0,0,1,0.24166666666666667
中断状态,0,0,0,0,1,0,0,1,0.24166666666666667
eate,0,0,0,0,1,0,0,1,0.24166666666666667
ostask,0,0,0,0,1,0,0,1,0.24166666666666667
ostaskdelo函数,0,0,0,0,1,0,0,1,0.24166666666666667
休眠,0,0,0,0,1,3,0,4,0.9666666666666667
挂起,0,0,0,0,1,0,0,1,0.24166666666666667
os-in,0,0,0,0,1,0,0,1,0.24166666666666667
pc,0,0,0,0,1,0,0,1,0.24166666666666667
状态转换,0,0,0,0,1,0,0,1,0.24166666666666667
进程状态转移过程,0,0,0,0,1,0,0,1,0.24166666666666667
任务状态转移过程,0,0,0,0,1,0,0,1,0.24166666666666667
kvos-in操作系统,0,0,0,0,1,0,0,1,0.24166666666666667
os-iii,0,0,0,0,1,0,0,1,0.24166666666666667
nc/os-hi操作系统,0,0,0,0,1,0,0,1,0.24166666666666667
任务状态转移,0,0,0,0,1,0,0,1,0.24166666666666667
状态转移,0,0,0,0,1,0,0,1,0.24166666666666667
中断服务态,0,0,0,0,1,0,0,1,0.24166666666666667
挂起态,0,0,0,0,1,0,0,1,0.24166666666666667
运行态,0,0,0,0,1,0,0,1,0.24166666666666667
就绪态,0,0,0,0,1,0,0,1,0.24166666666666667
休眠态,0,0,0,0,1,0,0,1,0.24166666666666667
任务进度,0,0,0,0,1,0,0,1,0.24166666666666667
标准函数接口,0,0,0,0,1,0,0,1,0.24166666666666667
pc/os-iii操作系统,0,0,0,0,1,0,0,1,0.24166666666666667
stm32l系,0,0,0,0,1,0,0,1,0.24166666666666667
终端响应,0,0,0,0,1,0,0,1,0.24166666666666667
rc/os-hi操作系统,0,0,0,0,1,0,0,1,0.24166666666666667
内容,0,0,0,0,1,0,0,1,0.24166666666666667
stm3211,0,0,0,0,1,0,0,1,0.24166666666666667
中断配置,0,0,0,0,1,0,0,1,0.24166666666666667
st标准库,0,0,0,0,1,0,0,1,0.24166666666666667
任务管理,0,0,0,0,2,0,0,2,0.48333333333333334
多任务模型,0,0,0,0,1,0,0,1,0.24166666666666667
时钟控制,0,0,0,0,2,0,0,2,0.48333333333333334
控制器,0,0,0,0,1,0,0,1,0.24166666666666667
嵌入式操作系统,0,0,0,0,1,0,0,1,0.24166666666666667
非守护进程,0,0,0,0,5,0,0,5,1.2083333333333333
微控制单元,0,0,0,0,3,0,0,3,0.725
流量数据采集进程,0,0,0,0,2,2,0,4,0.9666666666666667
压力数据采集,0,0,0,0,2,1,0,3,0.725
温差,0,0,0,0,2,0,0,2,0.48333333333333334
本地数据,0,0,0,0,2,0,0,2,0.48333333333333334
守护进程,0,0,0,0,1,5,0,6,1.45
后台进程,0,0,0,0,1,0,0,1,0.24166666666666667
通信进程,0,0,0,0,1,3,0,4,0.9666666666666667
异常震动检测进程,0,0,0,0,1,0,0,1,0.24166666666666667
压力采集进程,0,0,0,0,1,0,0,1,0.24166666666666667
pl120,0,0,0,0,1,0,0,1,0.24166666666666667
温度采集进程,0,0,0,0,1,0,0,1,0.24166666666666667
进程性质,0,0,0,0,1,0,0,1,0.24166666666666667
进程周期,0,0,0,0,1,0,0,1,0.24166666666666667
后台调控进程,0,0,0,0,1,0,0,1,0.24166666666666667
nb-iot模组进程,0,0,0,0,1,0,0,1,0.24166666666666667
adc,0,0,0,0,1,0,0,1,0.24166666666666667
异常震动采集进程,0,0,0,0,1,0,0,1,0.24166666666666667
低功耗解,0,0,0,0,2,1,0,3,0.725
广域物联网环,0,0,0,0,1,0,0,1,0.24166666666666667
后台程序,0,0,0,0,1,0,0,1,0.24166666666666667
报警信息,0,0,0,0,1,0,0,1,0.24166666666666667
工作模,0,0,0,0,1,0,0,1,0.24166666666666667
发送,0,0,0,0,1,0,0,1,0.24166666666666667
lpwan通信,0,0,0,0,1,0,0,1,0.24166666666666667
流量表,0,0,0,0,1,0,0,1,0.24166666666666667
唤醒流量表,0,0,0,0,1,0,0,1,0.24166666666666667
控制单元,0,0,0,0,1,0,0,1,0.24166666666666667
多功能流量表,0,0,0,0,1,1,0,2,0.48333333333333334
出口温度,0,0,0,0,1,0,0,1,0.24166666666666667
入口温度,0,0,0,0,1,0,0,1,0.24166666666666667
累计热计量值,0,0,0,0,1,0,0,1,0.24166666666666667
瞬时流量数据,0,0,0,0,1,0,0,1,0.24166666666666667
流量数据采集,0,0,0,0,1,1,0,2,0.48333333333333334
高电平中断信号,0,0,0,0,1,0,0,1,0.24166666666666667
震动,0,0,0,0,1,1,0,2,0.48333333333333334
周期采样,0,0,0,0,1,0,0,1,0.24166666666666667
数据传递,0,0,0,0,1,3,0,4,0.9666666666666667
数据采集,0,0,0,0,1,1,0,2,0.48333333333333334
震动异常数据采集,0,0,0,0,1,0,0,1,0.24166666666666667
压力差阈,0,0,0,0,1,0,0,1,0.24166666666666667
通信任务,0,0,0,0,1,0,0,1,0.24166666666666667
物理环境数据,0,0,0,0,1,0,0,1,0.24166666666666667
温度信息,0,0,0,0,1,0,0,1,0.24166666666666667
温度数据采集,0,0,0,0,1,1,0,2,0.48333333333333334
命令,0,0,0,0,10,3,1,14,3.3833333333333333
数据上报,0,0,0,0,4,0,0,4,0.9666666666666667
nb-iot通信模组,0,0,0,0,3,1,0,4,0.9666666666666667
双向通信,0,0,0,0,2,2,0,4,0.9666666666666667
异常震动数据,0,0,0,0,1,1,0,2,0.48333333333333334
井盖,0,0,0,0,1,2,0,3,0.725
流量,0,0,0,0,1,1,0,2,0.48333333333333334
压力数据,0,0,0,0,1,0,0,1,0.24166666666666667
温度数据,0,0,0,0,1,0,0,1,0.24166666666666667
监测,0,0,0,0,1,0,0,1,0.24166666666666667
任务集合,0,0,0,0,2,0,0,2,0.48333333333333334
待机模式,0,0,0,0,3,2,0,5,1.2083333333333333
外设时钟,0,0,0,0,2,0,0,2,0.48333333333333334
lpsdsr,0,0,0,0,2,0,0,2,0.48333333333333334
te,2,0,0,0,2,1,0,5,2.725
hse振荡器,0,0,0,0,2,0,0,2,0.48333333333333334
hsi,0,0,0,0,2,0,0,2,0.48333333333333334
低功耗模,0,0,0,0,2,1,0,3,0.725
微控制器,0,0,0,0,2,0,0,2,0.48333333333333334
active-timer,0,0,0,0,2,0,0,2,0.48333333333333334
超时,0,0,0,0,3,0,0,3,0.725
不活动计时器,0,0,0,0,2,0,0,2,0.48333333333333334
rtc,0,0,0,0,2,0,0,2,0.48333333333333334
等待中断指令,0,0,0,0,2,0,0,2,0.48333333333333334
wfe指令,0,0,0,0,1,0,0,1,0.24166666666666667
wfi,0,0,0,0,1,0,0,1,0.24166666666666667
pclkx,0,0,0,0,1,0,0,1,0.24166666666666667
hclk,0,0,0,0,1,0,0,1,0.24166666666666667
存储器,0,0,0,0,1,0,0,1,0.24166666666666667
ahb总线,0,0,0,0,1,0,0,1,0.24166666666666667
apb,0,0,0,0,1,0,0,1,0.24166666666666667
外围时钟,0,0,0,0,1,0,0,1,0.24166666666666667
预分频器,0,0,0,0,1,0,0,1,0.24166666666666667
运行速度,0,0,0,0,1,0,0,1,0.24166666666666667
预分频器寄存器,0,0,0,0,1,0,0,1,0.24166666666666667
ru,0,0,0,0,1,0,0,1,0.24166666666666667
newstate,0,0,0,0,1,0,0,1,0.24166666666666667
param,0,0,0,0,1,0,0,1,0.24166666666666667
assert,0,0,0,0,1,0,0,1,0.24166666666666667
checktheparameters,0,0,0,0,1,0,0,1,0.24166666666666667
ten,0,0,0,0,1,0,0,1,0.24166666666666667
pwr,0,0,0,0,1,1,0,2,0.48333333333333334
iwdg复位,0,0,0,0,1,0,0,1,0.24166666666666667
外部复位,0,0,0,0,1,0,0,1,0.24166666666666667
nrst引脚,0,0,0,0,1,0,0,1,0.24166666666666667
rtc闹钟事件,0,0,0,0,1,0,0,1,0.24166666666666667
上升沿,0,0,0,0,1,0,0,1,0.24166666666666667
待机wkup引脚,0,0,0,0,1,0,0,1,0.24166666666666667
外部中断寄存器,0,0,0,0,1,0,0,1,0.24166666666666667
唤醒事件,0,0,0,0,1,0,0,1,0.24166666666666667
电压调机器,0,0,0,0,1,0,0,1,0.24166666666666667
内核电源,0,0,0,0,1,0,0,1,0.24166666666666667
停止模式,0,0,0,0,1,1,0,2,0.48333333333333334
系统处理器,0,0,0,0,1,0,0,1,0.24166666666666667
hclk总线,0,0,0,0,1,0,0,1,0.24166666666666667
电源复位,0,0,0,0,1,0,0,1,0.24166666666666667
tau周期,0,0,0,0,1,0,0,1,0.24166666666666667
connected态,0,0,0,0,1,0,0,1,0.24166666666666667
1au周期,0,0,0,0,1,0,0,1,0.24166666666666667
超时时间,0,0,0,0,1,0,0,1,0.24166666666666667
启动定时器,0,0,0,0,1,0,0,1,0.24166666666666667
idle,0,0,0,0,1,2,0,3,0.725
计时器,0,0,0,0,1,0,0,1,0.24166666666666667
connected,0,0,0,0,1,0,0,1,0.24166666666666667
外部事件,0,0,0,0,1,0,0,1,0.24166666666666667
rtc中断,0,0,0,0,1,0,0,1,0.24166666666666667
khz,0,0,0,0,1,0,0,1,0.24166666666666667
电源控制,0,0,0,0,1,0,0,1,0.24166666666666667
外围设备接口,0,0,0,0,1,0,0,1,0.24166666666666667
主动,0,0,0,0,1,1,0,2,0.48333333333333334
命令下达,0,0,0,0,3,0,0,3,0.725
网络侧,0,0,0,0,1,0,0,1,0.24166666666666667
主动模式,0,0,0,0,1,1,0,2,0.48333333333333334
环境采集模块,0,0,0,0,1,0,0,1,0.24166666666666667
传感器模块,0,0,0,0,1,6,0,7,1.6916666666666667
指示模块,0,0,0,0,1,0,0,1,0.24166666666666667
供电模块,0,0,0,0,1,0,0,1,0.24166666666666667
电源参数,0,0,0,0,1,0,0,1,0.24166666666666667
低功耗状态调节,0,0,0,0,1,0,0,1,0.24166666666666667
timeout超时策略,0,0,0,0,3,0,0,3,0.725
超时门限时间,0,0,0,0,3,0,0,3,0.725
物理网硬件,0,0,0,0,1,0,0,1,0.24166666666666667
响应延时,0,0,0,0,1,0,0,1,0.24166666666666667
低功耗设计,0,0,0,0,1,0,0,1,0.24166666666666667
timeout,0,0,0,0,1,0,0,1,0.24166666666666667
空闲状态计时器,0,0,0,0,1,0,0,1,0.24166666666666667
量断系统,0,0,0,0,1,0,0,1,0.24166666666666667
任务调度过程,0,0,0,0,1,0,0,1,0.24166666666666667
实时性操作系统,0,0,0,0,1,0,0,1,0.24166666666666667
timeout超时算法,0,0,0,0,1,0,0,1,0.24166666666666667
门限时间,0,0,0,0,1,0,0,1,0.24166666666666667
timeout算法,0,0,0,0,1,0,0,1,0.24166666666666667
低功耗效果,0,0,0,0,1,0,0,1,0.24166666666666667
补偿,0,0,0,0,1,0,0,1,0.24166666666666667
空闲时间分布,0,0,0,0,1,0,0,1,0.24166666666666667
coap服务器,0,0,0,0,3,0,0,3,0.725
手机终端,0,0,0,0,2,0,0,2,0.48333333333333334
nb模块,0,0,0,0,2,0,0,2,0.48333333333333334
nb设备,0,0,0,0,2,0,0,2,0.48333333333333334
nb-iot业务,0,0,0,0,2,0,0,2,0.48333333333333334
后台应用程序,0,0,0,0,1,0,0,1,0.24166666666666667
通用接口,0,0,0,0,1,0,0,1,0.24166666666666667
数据转换,0,0,0,0,1,0,0,1,0.24166666666666667
网络数据包,0,0,0,0,1,0,0,1,0.24166666666666667
请求数据,0,0,0,0,1,0,0,1,0.24166666666666667
嵌入式通信设备,0,0,0,0,1,0,0,1,0.24166666666666667
物联网环境,0,0,0,0,1,0,0,1,0.24166666666666667
udp效劳器,0,0,0,0,1,0,0,1,0.24166666666666667
ue,0,0,0,0,1,1,0,2,0.48333333333333334
udp协议通信链路,0,0,0,0,1,0,0,1,0.24166666666666667
app效劳器,0,0,0,0,1,0,0,1,0.24166666666666667
iot渠道,0,0,0,0,1,0,0,1,0.24166666666666667
uexnode,0,0,0,0,1,0,0,1,0.24166666666666667
coap协议通信链路,0,0,0,0,1,0,0,1,0.24166666666666667
idle状态,0,0,0,0,1,1,0,2,0.48333333333333334
参数定时器,0,0,0,0,1,0,0,1,0.24166666666666667
综合,0,0,0,0,1,0,0,1,0.24166666666666667
下发命令,0,0,0,0,1,0,0,1,0.24166666666666667
控制命令,0,0,0,0,1,0,0,1,0.24166666666666667
上报,0,0,0,0,2,0,0,2,0.48333333333333334
3gpp,0,0,0,0,1,0,0,1,0.24166666666666667
psm技术,0,0,0,0,3,0,0,3,0.725
缓存下发,0,0,0,0,2,0,0,2,0.48333333333333334
平台,0,0,0,0,2,2,0,4,0.9666666666666667
缓存下,0,0,0,0,1,0,0,1,0.24166666666666667
低功耗策略,0,0,0,0,1,0,0,1,0.24166666666666667
命令队列,0,0,0,0,1,0,0,1,0.24166666666666667
上线,0,0,0,0,1,0,0,1,0.24166666666666667
队列,0,0,0,0,1,0,0,1,0.24166666666666667
监控器开关,0,0,0,0,1,0,0,1,0.24166666666666667
天然气开关阀,0,0,0,0,1,0,0,1,0.24166666666666667
实时,0,0,0,0,1,0,0,1,0.24166666666666667
离线,0,0,0,0,1,0,0,1,0.24166666666666667
2g网络,0,0,0,0,1,0,0,1,0.24166666666666667
双向数据透传,0,0,0,0,1,0,0,1,0.24166666666666667
nb-iot客户端,0,0,0,0,12,4,0,16,3.8666666666666667
嵌入式端,0,0,0,0,5,5,1,11,2.658333333333333
重传,0,0,0,0,3,4,0,7,1.6916666666666667
重传次数,0,0,0,0,3,4,0,7,1.6916666666666667
ack,0,0,0,0,3,0,0,3,0.725
重传机制,0,0,0,0,3,0,0,3,0.725
系统服务端,0,0,0,0,9,9,1,19,4.591666666666667
计数器,0,0,0,0,2,4,0,6,1.45
上游服务器,0,0,0,0,2,0,0,2,0.48333333333333334
重传消息,0,0,0,0,2,3,1,6,1.45
nb-iot客户端设,0,0,0,0,2,3,1,6,1.45
缓存数据,0,0,0,0,1,1,0,2,0.48333333333333334
应用接口,0,0,0,0,1,1,0,2,0.48333333333333334
cdpserver,0,0,0,0,1,4,0,5,1.2083333333333333
落库,0,0,0,0,1,0,0,1,0.24166666666666667
nb-iot客户端设备数据,0,0,0,0,1,0,0,1,0.24166666666666667
服务端数据库,0,0,0,0,1,0,0,1,0.24166666666666667
timer定时器,0,0,0,0,1,1,0,2,0.48333333333333334
间隔,0,0,0,0,1,1,0,2,0.48333333333333334
重传时间,0,0,0,0,1,1,0,2,0.48333333333333334
初始重传间隔时间,0,0,0,0,1,1,0,2,0.48333333333333334
数据重传机制,0,0,0,0,1,0,2,3,0.725
机制,0,0,0,0,1,0,0,1,0.24166666666666667
failed,0,0,0,0,1,1,0,2,0.48333333333333334
串口打印error,0,0,0,0,1,1,0,2,0.48333333333333334
rst信号,0,0,0,0,1,1,0,2,0.48333333333333334
succeed,0,0,0,0,1,1,0,2,0.48333333333333334
ack信号,0,0,0,0,1,1,0,2,0.48333333333333334
串口监视器,0,0,0,0,1,1,0,2,0.48333333333333334
网络信号,0,0,0,0,1,0,0,1,0.24166666666666667
con请求信息,0,0,0,0,1,0,0,1,0.24166666666666667
通信过,0,0,0,0,1,0,0,1,0.24166666666666667
通信过程,0,0,0,0,1,0,0,1,0.24166666666666667
coap协议数据包,0,0,0,0,1,0,0,1,0.24166666666666667
命令下,0,0,0,0,1,1,0,2,0.48333333333333334
消息重传设计,0,0,0,0,1,0,0,1,0.24166666666666667
网络拥塞,0,0,0,0,2,0,0,2,0.48333333333333334
监控,0,0,0,0,1,0,0,1,0.24166666666666667
数据重传设,0,0,0,0,1,0,0,1,0.24166666666666667
吞吐量,0,0,0,0,4,8,0,12,2.9
rocketmq,0,0,0,0,3,17,0,20,4.833333333333333
消息处理能力,0,0,0,0,3,2,1,6,1.45
业务线程,0,0,0,0,2,1,0,3,0.725
线程,0,0,0,0,2,3,0,5,1.2083333333333333
数据库,0,0,0,0,2,5,0,7,1.6916666666666667
状态数据,0,0,0,0,2,0,0,2,0.48333333333333334
响应时间,0,0,0,0,2,0,0,2,0.48333333333333334
消费者,0,0,0,0,2,3,0,5,1.2083333333333333
生产者,0,0,0,0,2,3,0,5,1.2083333333333333
物联网系统,0,0,0,0,2,0,0,2,0.48333333333333334
单位时间,0,0,0,0,1,0,0,1,0.24166666666666667
资源利用率,0,0,0,0,1,0,0,1,0.24166666666666667
耦合性,0,0,0,0,1,0,0,1,0.24166666666666667
消息收发,0,0,0,0,1,0,0,1,0.24166666666666667
i/o等待时间,0,0,0,0,1,1,0,2,0.48333333333333334
多线程,0,0,0,0,1,1,0,2,0.48333333333333334
业务,0,0,0,0,1,1,0,2,0.48333333333333334
数据堆积,0,0,0,0,1,0,0,1,0.24166666666666667
上报数据,0,0,0,0,1,1,0,2,0.48333333333333334
i/o处,0,0,0,0,1,1,0,2,0.48333333333333334
解耦,0,0,0,0,1,1,0,2,0.48333333333333334
数据处理,0,0,0,0,1,1,0,2,0.48333333333333334
数据解析,0,0,0,0,1,1,0,2,0.48333333333333334
缓冲,0,0,0,0,1,1,0,2,0.48333333333333334
数据流量,0,0,0,0,1,1,0,2,0.48333333333333334
中间件模块,0,0,0,0,1,0,0,1,0.24166666666666667
处理效率,0,0,0,0,1,0,0,1,0.24166666666666667
响应时长,0,0,0,0,1,0,0,1,0.24166666666666667
效率,0,0,0,0,1,0,0,1,0.24166666666666667
异常震动报警事件,0,0,0,0,1,0,0,1,0.24166666666666667
环境监测项,0,0,0,0,1,0,0,1,0.24166666666666667
消息数,0,0,0,0,1,0,0,1,0.24166666666666667
发件,0,0,0,0,1,0,0,1,0.24166666666666667
效率性,0,0,0,0,1,0,0,1,0.24166666666666667
设备交互,0,0,0,0,1,0,0,1,0.24166666666666667
可靠投递,0,0,0,0,1,0,0,1,0.24166666666666667
顺序性,0,0,0,0,1,0,0,1,0.24166666666666667
流量削峰,0,0,0,0,1,0,0,1,0.24166666666666667
中间件,0,0,0,0,1,6,0,7,1.6916666666666667
费者,0,0,0,0,1,0,0,1,0.24166666666666667
定义格式,0,0,0,0,1,0,0,1,0.24166666666666667
对象,0,0,0,0,1,0,0,1,0.24166666666666667
文本,0,0,0,0,1,0,0,1,0.24166666666666667
消息堆积,0,0,0,0,1,3,0,4,0.9666666666666667
处理,0,0,0,0,1,0,0,1,0.24166666666666667
通信系统,1,0,0,0,1,0,0,2,1.2416666666666667
消息处理机制,0,0,0,0,1,0,0,1,0.24166666666666667
业务线程池,0,0,0,0,1,7,0,8,1.9333333333333333
服务端系统,0,0,0,0,1,0,0,1,0.24166666666666667
服务器瘫痪,0,0,0,0,1,0,0,1,0.24166666666666667
请求堆积,0,0,0,0,1,0,0,1,0.24166666666666667
并发数据,0,0,0,0,1,0,0,1,0.24166666666666667
响应能力,0,0,0,0,1,0,0,1,0.24166666666666667
物联网服务器系统,0,0,0,0,1,0,0,1,0.24166666666666667
通讯信息,0,0,0,0,1,0,0,1,0.24166666666666667
5g时代,0,0,0,0,1,0,0,1,0.24166666666666667
消息处理设计,0,0,0,0,1,0,0,1,0.24166666666666667
高并发请求,0,0,0,0,1,0,0,1,0.24166666666666667
数据丢包,0,0,0,0,1,0,0,1,0.24166666666666667
上报类任务,0,0,0,0,1,0,0,1,0.24166666666666667
长周期,0,0,0,0,1,0,0,1,0.24166666666666667
程序改造,0,0,0,0,1,0,1,2,0.48333333333333334
热力管网环境,0,0,0,0,0,4,0,4,0.9666666666666667
平均响应时间,0,0,0,0,0,7,0,7,1.6916666666666667
仿真模拟服务端,0,0,0,0,0,2,0,2,0.48333333333333334
服务端消息处理,0,0,0,0,0,1,0,1,0.24166666666666667
热力管网检测系统,0,0,0,0,0,1,0,1,0.24166666666666667
报警监控,0,0,0,0,0,1,0,1,0.24166666666666667
环境感知层设备,0,0,0,0,0,1,0,1,0.24166666666666667
长距离设备通信,0,0,0,0,0,1,0,1,0.24166666666666667
nb-iot标准协议,0,0,0,0,1,1,0,2,0.48333333333333334
温度监测设备,0,0,0,0,0,3,0,3,0.725
深度睡眠模,0,0,0,0,0,3,0,3,0.725
供暖期,0,0,0,0,0,5,0,5,1.2083333333333333
数据处理接口,0,0,0,0,0,4,0,4,0.9666666666666667
电信lot平台,0,0,0,0,0,1,0,1,0.24166666666666667
信息传递,0,0,0,0,0,2,0,2,0.48333333333333334
后台应用服务,0,0,0,0,0,2,0,2,0.48333333333333334
有效状态传送,0,0,0,0,0,1,0,1,0.24166666666666667
对应接口,0,0,0,0,0,1,0,1,0.24166666666666667
温度传感器,0,0,0,0,0,1,0,1,0.24166666666666667
热力领域管道,0,0,0,0,0,1,0,1,0.24166666666666667
温度计量模块,0,0,0,0,0,1,0,1,0.24166666666666667
压力监测设备,0,0,0,0,0,3,0,3,0.725
电信iot平台,0,0,0,0,0,3,0,3,0.725
报警事件,0,0,0,0,0,4,0,4,0.9666666666666667
启动设备,0,0,0,0,0,3,0,3,0.725
即时数据连接传递,0,0,0,0,0,1,0,1,0.24166666666666667
阀值,0,0,0,0,0,2,0,2,0.48333333333333334
数值,0,0,0,0,0,2,0,2,0.48333333333333334
压力参数,0,0,0,0,0,1,0,1,0.24166666666666667
压力数据测量模块,0,0,0,0,0,1,0,1,0.24166666666666667
流量监测设备,0,0,0,0,0,2,0,2,0.48333333333333334
流量数据监测设备,0,0,0,0,0,1,0,1,0.24166666666666667
流量参数,0,0,0,0,0,1,0,1,0.24166666666666667
流量监测模块,0,0,0,0,0,1,0,1,0.24166666666666667
异常震动监测设备,0,0,0,0,0,2,0,2,0.48333333333333334
井盖异常震动监测设备,0,0,0,0,0,1,0,1,0.24166666666666667
井盖异常震动数据,0,0,0,0,0,1,0,1,0.24166666666666667
睡眠模,0,0,0,0,0,1,0,1,0.24166666666666667
三轴传感器,0,0,0,0,0,1,0,1,0.24166666666666667
嵌入式编程,0,0,0,0,0,1,0,1,0.24166666666666667
低功耗模块,0,0,0,0,0,3,0,3,0.725
精度,0,0,0,0,0,3,0,3,0.725
伪代码,0,0,0,0,0,2,0,2,0.48333333333333334
管脚,0,0,0,0,0,2,0,2,0.48333333333333334
配置函数,0,0,0,0,0,2,0,2,0.48333333333333334
休眠模,0,0,0,0,0,2,0,2,0.48333333333333334
低频,0,0,0,0,0,2,0,2,0.48333333333333334
counter,0,0,0,0,0,1,0,1,0.24166666666666667
高频,0,0,0,0,0,1,0,1,0.24166666666666667
工作进程数,0,0,0,0,0,1,0,1,0.24166666666666667
for系统,0,0,0,0,0,1,0,1,0.24166666666666667
config,0,0,0,0,0,1,0,1,0.24166666666666667
nbiot,0,0,0,0,0,1,0,1,0.24166666666666667
intcounter,0,0,0,0,0,1,0,1,0.24166666666666667
调度函数,0,0,0,0,0,1,0,1,0.24166666666666667
配置,0,0,0,0,0,1,0,1,0.24166666666666667
pb组,0,0,0,0,0,1,0,1,0.24166666666666667
pa组,0,0,0,0,0,1,0,1,0.24166666666666667
pb分组,0,0,0,0,0,1,0,1,0.24166666666666667
pa分组,0,0,0,0,0,1,0,1,0.24166666666666667
相关管脚,0,0,0,0,0,1,0,1,0.24166666666666667
stop,0,0,0,0,0,1,0,1,0.24166666666666667
初始化配置,0,0,0,0,0,1,0,1,0.24166666666666667
唤醒,0,0,0,0,0,1,0,1,0.24166666666666667
控前模块,0,0,0,0,0,1,0,1,0.24166666666666667
enterstopmode,0,0,0,0,0,1,0,1,0.24166666666666667
外部中断唤醒,0,0,0,0,0,1,0,1,0.24166666666666667
rtc时钟,0,0,0,0,0,1,0,1,0.24166666666666667
配置控制模块,0,0,0,0,0,1,0,1,0.24166666666666667
动态功耗调节,0,0,0,0,0,1,0,1,0.24166666666666667
醒通信模块,0,0,0,0,0,1,0,1,0.24166666666666667
进f程,0,0,0,0,0,1,0,1,0.24166666666666667
区模式,0,0,0,0,0,1,0,1,0.24166666666666667
震动数据采集进程,0,0,0,0,0,1,0,1,0.24166666666666667
传感器槿块,0,0,0,0,0,1,0,1,0.24166666666666667
流量传感器模块,0,0,0,0,0,1,0,1,0.24166666666666667
ye感器,0,0,0,0,0,1,0,1,0.24166666666666667
专感器模块,0,0,0,0,0,1,0,1,0.24166666666666667
匿眼模,0,0,0,0,0,1,0,1,0.24166666666666667
拄制模块,0,0,0,0,0,1,0,1,0.24166666666666667
始化流程,0,0,0,0,0,1,0,1,0.24166666666666667
任务模块,0,0,0,0,0,1,0,1,0.24166666666666667
休眠状,0,0,0,0,0,1,0,1,0.24166666666666667
守护迸程,0,0,0,0,0,1,0,1,0.24166666666666667
温度传感器模块,0,0,0,0,0,1,0,1,0.24166666666666667
实时监测系,0,0,0,0,0,1,0,1,0.24166666666666667
进程间,0,0,0,0,0,1,0,1,0.24166666666666667
i/o引脚,0,0,0,0,0,1,0,1,0.24166666666666667
监控管理,0,0,0,0,0,1,0,1,0.24166666666666667
psm低功耗模式,0,0,0,0,0,1,0,1,0.24166666666666667
idle模式,0,0,0,0,0,1,0,1,0.24166666666666667
连接模式,0,0,0,0,0,1,0,1,0.24166666666666667
时限,0,0,0,0,0,1,0,1,0.24166666666666667
超时策,0,0,0,0,0,1,0,1,0.24166666666666667
异常震动监测进程,0,0,0,0,0,1,0,1,0.24166666666666667
压力数据采集进程,0,0,0,0,0,1,0,1,0.24166666666666667
温度数据采集进程,0,0,0,0,0,1,0,1,0.24166666666666667
数据推送,0,0,0,0,0,3,0,3,0.725
订阅通知,0,0,0,0,0,2,0,2,0.48333333333333334
网关,0,0,0,0,0,2,0,2,0.48333333333333334
服务端应用,0,0,0,0,0,3,0,3,0.725
应用,0,0,0,0,0,1,0,1,0.24166666666666667
接入,0,0,0,0,0,1,0,1,0.24166666666666667
协议转换,0,0,0,0,0,1,0,1,0.24166666666666667
消息协议,0,0,0,0,0,1,0,1,0.24166666666666667
等待平台,0,0,0,0,0,1,0,1,0.24166666666666667
设备数据,0,0,0,0,0,1,0,1,0.24166666666666667
主动去电信平台,0,0,0,0,0,1,0,1,0.24166666666666667
负载能力,0,0,0,0,0,1,0,1,0.24166666666666667
通知,0,0,0,0,0,1,0,1,0.24166666666666667
暂存,0,0,0,0,0,1,0,1,0.24166666666666667
时间戳,0,0,0,0,0,1,0,1,0.24166666666666667
cdp平台,0,0,0,0,0,1,0,1,0.24166666666666667
转发,0,0,0,0,0,1,0,1,0.24166666666666667
端口号,0,0,0,0,0,1,0,1,0.24166666666666667
目标ip,0,0,0,0,0,1,0,1,0.24166666666666667
线程数,0,0,0,0,0,6,0,6,1.45
自定义线程池,0,0,0,0,0,3,0,3,0.725
producer,0,0,0,0,0,3,0,3,0.725
consumer,0,0,0,0,0,4,0,4,0.9666666666666667
消息服务器,0,0,0,0,0,3,0,3,0.725
handler,0,0,0,0,0,2,0,2,0.48333333333333334
it,0,0,0,0,0,2,0,2,0.48333333333333334
ze,0,0,0,0,0,2,0,2,0.48333333333333334
ic,0,0,0,0,0,2,0,2,0.48333333333333334
消息中间件模块,0,0,0,0,0,2,0,2,0.48333333333333334
broker,0,0,0,0,0,2,0,2,0.48333333333333334
核心组件,0,0,0,0,0,2,0,2,0.48333333333333334
计算时间,0,0,0,0,0,1,0,1,0.24166666666666667
等待时间,0,0,0,0,0,1,0,1,0.24166666666666667
cpu使用率,0,0,0,0,0,1,0,1,0.24166666666666667
核心数,0,0,0,0,0,1,0,1,0.24166666666666667
ncpu,0,0,0,0,0,1,0,1,0.24166666666666667
nthread,0,0,0,0,0,1,0,1,0.24166666666666667
核心线程数,0,0,0,0,0,1,0,1,0.24166666666666667
内存使用量,0,0,0,0,0,1,0,1,0.24166666666666667
rejectedexecution,0,0,0,0,0,1,0,1,0.24166666666666667
threadfactoryz,0,0,0,0,0,1,0,1,0.24166666666666667
threadfactory,0,0,0,0,0,1,0,1,0.24166666666666667
wordqueue,0,0,0,0,0,1,0,1,0.24166666666666667
blockingqueue,0,0,0,0,0,1,0,1,0.24166666666666667
time,0,0,0,0,0,1,0,1,0.24166666666666667
keepalivetime,0,0,0,0,0,1,0,1,0.24166666666666667
ol,0,0,0,0,0,1,0,1,0.24166666666666667
intmaximum,0,0,0,0,0,1,0,1,0.24166666666666667
pool,0,0,0,0,0,1,0,1,0.24166666666666667
fintcore,0,0,0,0,0,1,0,1,0.24166666666666667
executor,0,0,0,0,0,1,0,1,0.24166666666666667
threadpool,0,0,0,0,0,1,0,1,0.24166666666666667
构造函数,0,0,0,0,0,1,0,1,0.24166666666666667
stackoverflow异常,0,0,0,0,0,1,0,1,0.24166666666666667
oom异常,0,0,0,0,0,1,0,1,0.24166666666666667
静态工厂,0,0,0,0,0,1,0,1,0.24166666666666667
executors,0,0,0,0,0,1,0,1,0.24166666666666667
并发编程,0,0,0,0,0,1,0,1,0.24166666666666667
executor框架,0,0,0,0,0,1,0,1,0.24166666666666667
java语言,0,0,0,0,0,1,0,1,0.24166666666666667
语言,0,0,0,0,0,1,0,1,0.24166666666666667
数据回滚操,0,0,0,0,0,1,0,1,0.24166666666666667
数据库操作,0,0,0,0,0,1,0,1,0.24166666666666667
服务端业务,0,0,0,0,0,1,0,1,0.24166666666666667
服务器系统,0,0,0,0,0,1,0,1,0.24166666666666667
缓存消息,0,0,0,0,0,1,0,1,0.24166666666666667
业务逻辑,0,0,0,0,0,1,0,1,0.24166666666666667
数据对,0,0,0,0,0,1,0,1,0.24166666666666667
consumergroup,0,0,0,0,0,1,0,1,0.24166666666666667
业务处理模块,0,0,0,0,0,1,0,1,0.24166666666666667
数据对象,0,0,0,0,0,1,0,1,0.24166666666666667
数据处理模块,0,0,0,0,0,1,0,1,0.24166666666666667
worker线程,0,0,0,0,0,1,0,1,0.24166666666666667
nb-iot设备端,0,0,0,0,0,1,0,1,0.24166666666666667
路由信息,0,0,0,0,0,1,0,1,0.24166666666666667
元信息,0,0,0,0,0,1,0,1,0.24166666666666667
nameserver,0,0,0,0,0,1,0,1,0.24166666666666667
名称服务器,0,0,0,0,0,1,0,1,0.24166666666666667
存储,0,0,0,0,0,1,0,1,0.24166666666666667
消息存储中心,0,0,0,0,0,1,0,1,0.24166666666666667
消费消息,0,0,0,0,0,1,0,1,0.24166666666666667
proucer,0,0,0,0,0,1,0,1,0.24166666666666667
水平拓展,0,0,0,0,0,1,0,1,0.24166666666666667
服务端消息,0,0,0,0,0,2,0,2,0.48333333333333334
sk,0,0,0,0,0,3,0,3,0.725
taskfired,0,0,0,0,0,2,0,2,0.48333333333333334
executiontime,0,0,0,0,0,2,0,2,0.48333333333333334
synchronized,0,0,0,0,0,2,0,2,0.48333333333333334
关键函数代码,0,0,0,0,0,1,0,1,0.24166666666666667
t7timer,0,0,0,0,0,1,0,1,0.24166666666666667
nterruptedexception,0,0,0,0,0,1,0,1,0.24166666666666667
nolock,0,0,0,0,0,1,0,1,0.24166666666666667
currenttime,0,0,0,0,0,1,0,1,0.24166666666666667
taskhasn,0,0,0,0,0,1,0,1,0.24166666666666667
itaskfired,0,0,0,0,0,1,0,1,0.24166666666666667
pollqueueagain,0,0,0,0,0,1,0,1,0.24166666666666667
cancelled,0,0,0,0,0,1,0,1,0.24166666666666667
timertask,0,0,0,0,0,1,0,1,0.24166666666666667
queue,0,0,0,0,0,1,0,1,0.24166666666666667
longcurrenttime,0,0,0,0,0,1,0,1,0.24166666666666667
任务队列,0,0,0,0,0,1,0,1,0.24166666666666667
booleantaskfired,0,0,0,0,0,1,0,1,0.24166666666666667
timertasktask,0,0,0,0,0,1,0,1,0.24166666666666667
op,0,0,0,0,0,1,0,1,0.24166666666666667
voidmain,0,0,0,0,0,1,0,1,0.24166666666666667
关键函数,0,0,0,0,0,1,0,1,0.24166666666666667
timer,0,0,0,0,0,1,0,1,0.24166666666666667
p4ra,0,0,0,0,0,1,0,1,0.24166666666666667
pars!,0,0,0,0,0,1,0,1,0.24166666666666667
ser-i,0,0,0,0,0,1,0,1,0.24166666666666667
fap,0,0,0,0,0,1,0,1,0.24166666666666667
zcnutl,0,0,0,0,0,1,0,1,0.24166666666666667
stringtwt,0,0,0,0,0,1,0,1,0.24166666666666667
inoeit,0,0,0,0,0,1,0,1,0.24166666666666667
vpi,0,0,0,0,0,1,0,1,0.24166666666666667
ccns,0,0,0,0,0,1,0,1,0.24166666666666667
ccnsrsn,0,0,0,0,0,1,0,1,0.24166666666666667
ns,0,0,0,0,0,1,0,1,0.24166666666666667
rtiutri,0,0,0,0,0,1,0,1,0.24166666666666667
ti,0,0,0,0,0,1,0,1,0.24166666666666667
xceptic,0,0,0,0,0,1,0,1,0.24166666666666667
ticv,0,0,0,0,0,1,0,1,0.24166666666666667
ua,0,0,0,0,0,1,0,1,0.24166666666666667
ccm,0,0,0,0,0,1,0,1,0.24166666666666667
cffme,0,0,0,0,0,1,0,1,0.24166666666666667
ccmjx,0,0,0,0,0,1,0,1,0.24166666666666667
fc,0,0,0,0,0,1,0,1,0.24166666666666667
casacs,0,0,0,0,0,1,0,1,0.24166666666666667
iav,0,0,0,0,0,1,0,1,0.24166666666666667
cd,0,0,0,0,0,1,0,1,0.24166666666666667
cs,0,0,0,0,0,1,0,1,0.24166666666666667
is,0,0,0,0,0,1,0,1,0.24166666666666667
lt,0,0,0,0,0,1,0,1,0.24166666666666667
模拟命令,0,0,0,0,0,1,0,1,0.24166666666666667
模拟仿真命,0,0,0,0,0,1,0,1,0.24166666666666667
cdpserver平台,0,0,0,0,0,1,0,1,0.24166666666666667
死循环,0,0,0,0,0,1,0,1,0.24166666666666667
消息重传机,0,0,0,0,0,1,0,1,0.24166666666666667
数据重传验证,0,0,0,0,0,1,0,1,0.24166666666666667
并发量,0,0,0,0,0,12,0,12,2.9
压测机器,0,0,0,0,0,2,0,2,0.48333333333333334
jmeter,0,0,0,0,0,2,0,2,0.48333333333333334
配置信息,0,0,0,0,0,2,0,2,0.48333333333333334
极限,0,0,0,0,0,1,0,1,0.24166666666666667
压力测试,0,0,0,0,0,1,0,1,0.24166666666666667
平均,0,0,0,0,0,1,0,1,0.24166666666666667
请求量,0,0,0,0,0,1,0,1,0.24166666666666667
测试工,0,0,0,0,0,1,0,1,0.24166666666666667
winlo系统,0,0,0,0,0,1,0,1,0.24166666666666667
512g固态硬盘,0,0,0,0,0,1,0,1,0.24166666666666667
8g内存,0,0,0,0,0,1,0,1,0.24166666666666667
i5处理器,0,0,0,0,0,1,0,1,0.24166666666666667
计算机,0,0,0,0,0,1,0,1,0.24166666666666667
性能测试,0,0,0,0,0,1,0,1,0.24166666666666667
局域网,0,0,0,0,0,1,0,1,0.24166666666666667
开源压力测试工具,0,0,0,0,0,1,0,1,0.24166666666666667
it硬盘,0,0,0,0,0,1,0,1,0.24166666666666667
内存,0,0,0,0,0,1,0,1,0.24166666666666667
16g,0,0,0,0,0,1,0,1,0.24166666666666667
主频,0,0,0,0,0,1,0,1,0.24166666666666667
高性能服务器,0,0,0,0,0,1,0,1,0.24166666666666667
八核,0,0,0,0,0,1,0,1,0.24166666666666667
i验证,0,0,0,0,0,1,0,1,0.24166666666666667
非供暖期,0,0,0,0,0,2,0,2,0.48333333333333334
低功耗算法,0,0,0,0,0,2,1,3,0.725
电流,0,0,0,0,0,2,0,2,0.48333333333333334
耗电量,0,0,0,0,0,1,0,1,0.24166666666666667
发送数据周期,0,0,0,0,0,1,0,1,0.24166666666666667
常态,0,0,0,0,0,1,0,1,0.24166666666666667
设备功耗,0,0,0,0,0,1,0,1,0.24166666666666667
震动报警信息,0,0,0,0,0,1,0,1,0.24166666666666667
停止模,0,0,0,0,0,1,0,1,0.24166666666666667
调用,0,0,0,0,0,1,0,1,0.24166666666666667
唤醒mcu,0,0,0,0,0,1,0,1,0.24166666666666667
通电,0,0,0,0,0,1,0,1,0.24166666666666667
持续时间,0,0,0,0,0,1,0,1,0.24166666666666667
i/ma,0,0,0,0,0,1,0,1,0.24166666666666667
工作状态电流,0,0,0,0,0,1,0,1,0.24166666666666667
动态电源调节技,0,0,0,0,0,1,0,1,0.24166666666666667
动态电源调节技术,0,0,0,0,0,1,0,1,0.24166666666666667
低功耗解决,0,0,0,0,0,1,0,1,0.24166666666666667
nb-iot监测系统,0,0,0,0,0,0,6,6,1.45
硬件降功耗,0,0,0,0,0,0,2,2,0.48333333333333334
降功耗,0,0,0,0,0,0,2,2,0.48333333333333334
消息响应时间,0,0,0,0,0,0,1,1,0.24166666666666667
应用线程池,0,0,0,0,0,0,1,1,0.24166666666666667
消息吞吐量,0,0,0,0,0,0,1,1,0.24166666666666667
低功耗验证,0,0,0,0,0,0,1,1,0.24166666666666667
调度集合,0,0,0,0,0,0,1,1,0.24166666666666667
窄带物联网环境,0,0,0,0,0,0,1,1,0.24166666666666667
频率调节算法,0,0,0,0,0,0,1,1,0.24166666666666667
低功耗通信技术,0,0,0,0,0,0,1,1,0.24166666666666667
多连接,0,0,0,0,0,0,1,1,0.24166666666666667
大数据时代,0,0,0,0,0,0,1,1,0.24166666666666667
强度衰减,0,0,0,0,0,0,1,1,0.24166666666666667
接入量,0,0,0,0,0,0,1,1,0.24166666666666667
物联网数据,0,0,0,0,0,0,1,1,0.24166666666666667
广域网环境,0,0,0,0,0,0,1,1,0.24166666666666667
数据远传应用,0,0,0,0,0,0,1,1,0.24166666666666667
nb.iot,0,0,0,0,1,1,0,2,0.48333333333333334
嵌入式功耗管理技术,0,0,0,1,0,0,0,1,0.125
窄带广域物联网,0,0,0,1,0,0,0,1,0.125
NB-IoT,0,1,0,0,0,0,0,1,2.0
LPWAN,0,1,0,0,0,0,0,1,2.0
form,3,0,0,0,0,0,0,3,3.0
technology,2,0,0,0,0,0,0,2,2.0
solutions,1,0,0,0,0,0,0,1,1.0
fordynamic,1,0,0,0,0,0,0,1,1.0
powermanagementtech,1,0,0,0,0,0,0,1,1.0
propose,1,0,0,0,0,0,0,1,1.0
sager,1,0,0,0,0,0,0,1,1.0
etransmission,1,0,0,0,0,0,0,1,1.0
mechanis,1,0,0,0,0,0,0,1,1.0
forlothardwaredevice,1,0,0,0,0,0,0,1,1.0
message,1,0,0,0,0,0,0,1,1.0
si,1,0,0,0,0,0,0,1,1.0
method,1,0,0,0,0,0,0,1,1.0
forhardwaredevice,1,0,0,0,0,0,0,1,1.0
performsystemfunction,1,0,0,0,0,0,0,1,1.0
passinginactualengineering,1,0,0,0,0,0,0,1,1.0
hardwaredevice,1,0,0,0,0,0,0,1,1.0
simplement,1,0,0,0,0,0,0,1,1.0
artic,1,0,0,0,0,0,0,1,1.0
aly,1,0,0,0,0,0,0,1,1.0
powertechnolog,1,0,0,0,0,0,0,1,1.0
suchasdynamic,1,0,0,0,0,0,0,1,1.0
powermanagement,1,0,0,0,0,0,0,1,1.0
dynamicvoltager,1,0,0,0,0,0,0,1,1.0
ula,1,0,0,0,0,0,0,1,1.0
compares,1,0,0,0,0,0,0,1,1.0
powertechnologies,1,0,0,0,0,0,0,1,1.0
rious,1,0,0,0,0,0,0,1,1.0
ations,1,0,0,0,0,0,0,1,1.0
ordertoenhance,1,0,0,0,0,0,0,1,1.0
syste,1,0,0,0,0,0,0,1,1.0
dynamicpowermanagement,1,0,0,0,0,0,0,1,1.0
optimize,1,0,0,0,0,0,0,1,1.0
timeoper,1,0,0,0,0,0,0,1,1.0
ings,1,0,0,0,0,0,0,1,1.0
systemproces,1,0,0,0,0,0,0,1,1.0
timize,1,0,0,0,0,0,0,1,1.0
heactual,1,0,0,0,0,0,0,1,1.0
ena,1,0,0,0,0,0,0,1,1.0
powersystemis,1,0,0,0,0,0,0,1,1.0
actualhardware,1,0,0,0,0,0,0,1,1.0
aluatest,1,0,0,0,0,0,0,1,1.0
communications,1,0,0,0,0,0,0,1,1.0
yste,1,0,0,0,0,0,0,1,1.0
iottechnology,1,0,0,0,0,0,0,1,1.0
theact,1,0,0,0,0,0,0,1,1.0
ba,1,0,0,0,0,0,0,1,1.0
ing,1,0,0,0,0,0,0,1,1.0
wan,1,0,0,0,0,0,0,1,1.0
vironment,1,0,0,0,0,0,0,1,1.0
information,1,0,0,0,0,0,0,1,1.0
athermalpowerindustry,1,0,0,0,0,0,0,1,1.0
monitorings,1,0,0,0,0,0,0,1,1.0
ystembasedonnb-iottechnology,1,0,0,0,0,0,0,1,1.0
thing,1,0,0,0,0,0,0,1,1.0
narrow,1,0,0,0,0,0,0,1,1.0
ndi,1,0,0,0,0,0,0,1,1.0
net,1,0,0,0,0,0,0,1,1.0
depthapplication,1,0,0,0,0,0,0,1,1.0
stechnology,1,0,0,0,0,0,0,1,1.0
nthe,1,0,0,0,0,0,0,1,1.0
malen,1,0,0,0,0,0,0,1,1.0
basedonthelow,1,0,0,0,0,0,0,1,1.0
powertechnology,1,0,0,0,0,0,0,1,1.0
hardwaresystem,1,0,0,0,0,0,0,1,1.0
eh,1,0,0,0,0,0,0,1,1.0
ive,1,0,0,0,0,0,0,1,1.0
nb,1,0,0,0,0,0,0,1,1.0
iot,1,0,0,0,0,0,0,1,1.0
et,1,0,0,0,0,0,0,1,1.0
mainwork,1,0,0,0,0,0,0,1,1.0
text,1,0,0,0,0,0,0,1,1.0
malmonitor,1,0,0,0,0,0,0,1,1.0
ystembase,1,0,0,0,0,0,0,1,1.0
消息传递,1,0,0,0,0,0,0,1,1.0
物联网硬件设备,1,0,0,0,0,0,0,1,1.0
硬件设备数据,1,0,0,0,0,0,0,1,1.0
功能测,1,0,0,0,0,0,0,1,1.0
增强系统,1,0,0,0,0,0,0,1,1.0
低功耗系统,1,0,0,0,0,0,0,1,1.0
nb-tot技,1,0,0,0,0,0,0,1,1.0
nbtot模组,1,0,0,0,0,0,0,1,1.0
环境信息传输,1,0,0,0,0,0,0,1,1.0
nbtot技,1,0,0,0,0,0,0,1,1.0
物联网监测系统,1,0,0,0,0,0,0,1,1.0
低功耗窄带物联网,1,0,0,0,0,0,0,1,1.0
nb-iot物联网系统,1,0,0,0,0,0,0,1,1.0
