,摘要,关键词,第一章,第二章,第三章,第四章,第五章,总词频,加权得分
信号,14,0,61,82,70,41,20,288,63.53333333333333
特征参数,3,0,16,26,12,3,3,63,12.6
lte,17,0,41,18,41,46,16,179,49.266666666666666
wi-fi,12,0,36,15,28,44,17,152,39.88333333333333
通信,0,0,9,3,0,1,0,13,1.7416666666666667
认知用户,2,0,10,8,1,0,4,25,5.458333333333333
异构认知网络,6,1,29,20,5,7,11,79,19.683333333333334
主用户,1,0,7,6,0,0,0,14,2.625
异构网络,3,0,7,17,0,0,1,28,6.241666666666667
混叠信号,5,0,34,33,0,66,12,150,32.225
频率,0,0,6,6,5,1,1,19,3.1916666666666664
幅度,0,0,5,6,0,0,1,12,1.6166666666666667
主用户通信,1,0,5,4,0,0,1,11,2.3666666666666667
覆盖式,1,0,6,0,0,0,2,9,2.2333333333333334
相位,0,0,4,2,0,0,1,7,0.9916666666666667
制式信号,0,0,4,3,0,3,0,10,1.6
干扰,3,0,5,14,5,3,0,30,7.308333333333334
频谱共享,3,0,5,7,0,0,2,17,4.983333333333333
频谱利用率,1,0,5,2,0,0,2,10,2.3583333333333334
频谱资源,0,0,4,4,0,0,1,9,1.2416666666666667
无线通信网络,1,0,4,0,0,0,0,5,1.5
多载波信号,0,0,3,7,2,1,2,15,2.458333333333333
wi-fi信号,7,0,13,6,15,4,6,51,15.416666666666668
非授权频段,3,0,6,2,0,0,4,15,4.966666666666667
lte-u,3,0,7,4,8,3,3,28,7.758333333333333
先验信息,2,0,3,6,5,2,2,20,5.3
用户,0,0,3,1,0,0,0,4,0.5
频谱共享技术,0,0,4,0,0,0,1,5,0.7416666666666667
网络,0,0,3,2,0,1,0,6,0.8666666666666667
频谱,0,0,3,6,2,0,0,11,1.6083333333333334
无线通信技术,1,0,3,1,0,0,0,5,1.5
导频特征参数,0,0,2,0,0,0,2,4,0.7333333333333334
识别,0,0,4,10,2,3,1,20,3.2
高阶累积量,0,0,5,6,1,2,0,14,2.1
计算量,0,0,2,0,0,1,0,3,0.4916666666666667
高阶统计量,0,0,2,8,3,0,0,13,1.975
频域,2,0,6,8,6,5,1,28,6.65
时域,0,0,4,6,3,5,0,18,3.1833333333333336
盲识别,1,0,13,36,10,13,2,75,13.166666666666668
工作参数,1,0,2,2,0,0,0,5,1.5
主用户信号,0,0,2,2,3,0,0,7,1.225
调制,1,0,8,15,10,1,3,38,7.258333333333333
发射功率,1,0,2,3,0,0,0,6,1.625
覆盖式频谱共享,0,0,2,1,0,0,0,3,0.375
机会式频谱共享,0,0,2,0,0,0,0,2,0.25
认知无线电,1,0,2,1,0,0,1,5,1.6166666666666667
授权频段,1,0,2,2,0,0,0,5,1.5
模拟,0,0,2,0,0,0,0,2,0.25
容量,0,0,2,6,1,0,0,9,1.2416666666666667
差异性,0,0,1,1,0,0,1,3,0.4916666666666667
单信号,5,0,14,17,23,11,8,78,19.025
周期参数,0,0,1,0,0,0,1,2,0.3666666666666667
信号周期,0,0,1,1,0,0,1,3,0.4916666666666667
带宽,0,0,7,5,20,3,4,39,8.025
导频子载波信息,0,0,1,0,0,0,1,2,0.3666666666666667
周期特征参数,0,0,1,0,0,0,1,2,0.3666666666666667
ofdm调制特性,0,0,1,1,0,0,0,2,0.25
ofdm调制,0,0,3,11,6,3,1,24,4.166666666666666
共信道多信号,0,0,1,0,0,0,0,1,0.125
independentcomponent,0,0,1,0,0,0,0,1,0.125
识别复杂度,0,0,1,0,0,0,0,1,0.125
分离算法,0,0,1,0,0,1,0,2,0.3666666666666667
多信号调制,0,0,1,0,0,0,0,1,0.125
性能,2,0,7,5,4,9,3,30,7.366666666666667
识别算法,0,0,1,0,0,0,0,1,0.125
识别精度,0,0,1,0,0,0,0,1,0.125
瞬态参数信息,0,0,1,0,0,0,0,1,0.125
时频分析,0,0,1,1,0,0,0,2,0.25
wigner-ville分布,0,0,1,0,0,0,0,1,0.125
小波变换,0,0,1,1,0,0,0,2,0.25
变换域特征,0,0,1,0,0,0,0,1,0.125
awgn,0,0,2,0,1,1,0,4,0.7333333333333334
累积量,0,0,1,7,0,0,1,9,1.2416666666666667
additivewhitegaus,0,0,1,0,0,0,0,1,0.125
加性高斯白噪声,1,0,1,1,0,0,0,3,1.25
参数,2,0,7,14,10,6,6,45,9.941666666666666
低信噪比,0,0,1,1,0,1,0,3,0.4916666666666667
噪声,0,0,1,2,0,0,0,3,0.375
相位特征参数,0,0,1,0,0,0,0,1,0.125
变换域,0,0,1,0,0,0,0,1,0.125
信号识别,0,0,1,1,0,1,1,4,0.7333333333333334
时频联合域,0,0,1,0,0,0,0,1,0.125
单一信号,0,0,1,0,0,0,0,1,0.125
接收信号,0,0,1,4,0,1,0,6,0.8666666666666667
干扰口,0,0,1,0,0,0,0,1,0.125
认知用户通信,0,0,1,1,0,0,0,2,0.25
hz,1,0,2,1,0,0,1,5,1.6166666666666667
wi-fi主用户,1,0,2,0,0,0,1,4,1.4916666666666667
lte-u主用户,1,0,2,0,0,0,1,4,1.4916666666666667
干扰控制,0,0,1,0,0,0,0,1,0.125
部署机制,0,0,1,0,0,0,0,1,0.125
wirelessfidelity,1,0,1,0,0,0,0,2,1.125
inunlicensedbands,1,0,1,0,0,0,0,2,1.125
longtermevolution,1,0,2,0,0,0,0,3,1.25
授权频谱,0,0,1,0,0,0,0,1,0.125
信号盲识别技术,2,0,2,0,0,0,1,5,2.4916666666666667
基本信息,0,0,1,0,0,0,0,1,0.125
认知无线电技术,0,0,1,5,0,0,0,6,0.75
扰阳口,0,0,1,0,0,0,0,1,0.125
功率,0,0,2,1,1,0,0,4,0.6166666666666667
无线电特性参数,0,0,1,0,0,0,0,1,0.125
通信状,0,0,1,0,0,0,0,1,0.125
电磁环境,0,0,1,1,0,0,0,2,0.25
感知能力,0,0,1,0,0,0,0,1,0.125
认知用户设备,0,0,1,0,0,0,0,1,0.125
次用户,0,0,1,1,0,0,0,2,0.25
无通信,0,0,1,0,0,0,0,1,0.125
主从用户设备,0,0,1,0,0,0,0,1,0.125
频段,1,0,1,3,0,0,0,5,1.5
信道,0,0,2,3,2,1,0,8,1.35
通信信道,0,0,1,0,0,0,0,1,0.125
spectrumunderlay,0,0,1,0,0,0,0,1,0.125
spectrumoverlay,0,0,1,0,0,0,0,1,0.125
时间,0,0,1,1,0,0,0,2,0.25
无线电,0,0,2,2,0,0,0,4,0.5
iti,0,0,1,1,0,0,0,2,0.25
co,0,0,1,0,0,0,0,1,0.125
资源,0,0,1,0,0,0,0,1,0.125
传输速率,0,0,1,0,0,0,0,1,0.125
效率,0,0,1,1,0,0,0,2,0.25
接入,1,0,1,0,0,0,0,2,1.125
蓝牙,0,0,1,0,0,0,0,1,0.125
五代,0,0,1,0,0,0,0,1,0.125
低时延,0,0,1,0,0,0,0,1,0.125
高网速,0,0,1,0,0,0,0,1,0.125
数字,0,0,1,0,0,0,0,1,0.125
蜂窝通信,0,0,1,0,0,0,0,1,0.125
军事无线通信,0,0,1,0,0,0,0,1,0.125
电磁感应模型,0,0,1,0,0,0,0,1,0.125
麦克斯韦,0,0,1,0,0,0,0,1,0.125
速率,0,0,1,0,1,0,0,2,0.3666666666666667
无线通线网络,0,0,1,0,0,0,0,1,0.125
信息化社会,0,0,1,0,0,0,0,1,0.125
移动互联网,0,0,1,0,0,0,0,1,0.125
盲识别算法,7,0,13,0,19,25,6,70,20.708333333333336
仿真,0,0,7,0,1,3,4,15,2.8083333333333336
高阶谱,2,1,9,1,13,15,4,45,12.983333333333334
盲源,1,0,3,1,0,10,2,17,4.4
盲识别性能,0,0,3,0,0,3,2,8,1.5833333333333333
信号模型,0,0,4,2,3,2,1,12,2.2
长度,0,0,3,2,2,9,1,17,3.525
ofdm符号,0,0,3,10,0,8,1,22,3.8
特征矩阵,0,0,2,1,0,12,2,17,3.7583333333333333
造信号,0,0,2,0,0,0,0,2,0.25
复杂度,0,0,2,4,9,8,2,25,5.341666666666667
信道环境,0,0,2,0,2,1,2,7,1.4583333333333333
有效子载波数,1,0,4,0,15,5,1,26,6.575
过采样信号,0,0,4,0,4,0,2,10,1.95
盲源分离算法,0,0,4,1,0,15,1,21,4.491666666666667
联合对角化,0,0,2,2,0,0,0,4,0.5
信号盲识别,3,1,3,16,6,1,4,34,10.033333333333333
3gpp,1,0,3,1,5,3,0,13,3.4333333333333336
盲识别系统,0,0,2,0,2,2,0,6,1.2166666666666668
盲识别技术,1,0,4,3,0,0,0,8,1.875
gnitivenetwork,0,0,1,0,0,0,0,1,0.125
wi-fiheterogeneous,0,0,1,0,0,0,0,1,0.125
aliasingsign,0,0,1,0,0,0,0,1,0.125
iblindrecognition,0,0,1,0,0,0,0,1,0.125
算法性能,0,0,1,0,0,0,1,2,0.3666666666666667
准确率,0,0,1,0,6,2,0,9,2.0583333333333336
盲源分离混叠信号,0,0,1,0,0,1,0,2,0.3666666666666667
jade,0,0,5,0,0,15,2,22,4.733333333333333
信号带宽,0,0,1,1,2,2,1,7,1.4583333333333333
单信号盲识别,0,0,2,4,0,0,0,6,0.75
分离性能,0,0,2,0,0,3,1,6,1.2166666666666668
抗高斯白噪声干扰,0,0,1,0,0,0,0,1,0.125
频域高阶谱,0,0,1,0,0,0,0,1,0.125
eigenmatrice,0,0,1,0,0,1,0,2,0.3666666666666667
za,0,0,1,1,0,1,0,3,0.4916666666666667
na,0,0,1,0,0,1,0,2,0.3666666666666667
approximation,0,0,1,1,0,1,0,3,0.4916666666666667
int,0,0,1,0,0,0,0,1,0.125
cognitivenetwork,0,0,1,0,0,0,0,1,0.125
fiheterogeneous,0,0,1,0,0,0,0,1,0.125
wi,0,0,1,0,0,0,0,1,0.125
signals,0,0,1,0,0,0,0,1,0.125
blindrecognition,0,0,1,0,0,0,0,1,0.125
理论,0,0,1,0,1,0,0,2,0.3666666666666667
门限,0,0,2,1,4,1,0,8,1.5833333333333333
降采样后信号,0,0,2,0,2,0,1,5,0.975
高斯白噪声,1,0,2,3,14,15,1,36,8.875
有效子载波,0,0,2,1,12,1,1,17,3.7583333333333333
空子载波,0,0,2,2,9,1,1,15,3.158333333333333
过采样率,1,0,2,0,8,0,1,12,3.425
谱峰,0,0,1,0,2,0,0,3,0.6083333333333334
功率谱图,0,0,1,0,0,0,0,1,0.125
周期延拓,0,0,2,0,4,0,1,7,1.4583333333333333
fft点数,0,0,2,0,3,0,1,6,1.2166666666666668
自相关函数,0,0,1,1,8,0,0,10,2.1833333333333336
采样信号,0,0,2,0,2,0,1,5,0.975
自相关特性,0,0,2,2,2,0,1,7,1.225
感知信号,0,0,2,0,2,2,1,7,1.4583333333333333
抗干扰特性,0,0,2,0,1,0,1,4,0.7333333333333334
传输,0,0,1,1,0,0,0,2,0.25
系统模型,0,0,2,0,0,0,0,2,0.25
分离,0,0,1,1,0,5,0,7,1.4583333333333333
信号时域,0,0,1,0,1,1,0,3,0.6083333333333334
高阶谱特性,1,0,1,0,2,1,0,5,1.85
有效子载波参数,0,0,1,0,5,1,0,7,1.575
高阶谱理论,0,0,1,0,1,4,0,6,1.3333333333333333
electricalandelectronics,0,0,1,0,0,0,0,1,0.125
generation,0,0,1,0,0,0,0,1,0.125
提取信号,0,0,1,2,0,0,0,3,0.375
极化资源感知,1,0,1,0,0,0,0,2,1.125
密集异构无线环境,1,0,1,0,0,0,0,2,1.125
然科学,0,0,1,0,0,0,0,1,0.125
盲源分离,1,0,2,13,0,8,1,25,5.05
环境参数,0,0,1,0,0,0,0,1,0.125
线性瞬时混叠信号模型,0,0,1,0,0,0,0,1,0.125
盲识别系统模,0,0,1,0,0,0,0,1,0.125
算法,1,0,1,1,3,4,1,11,3.1833333333333336
仿真参数,0,0,1,0,1,1,0,3,0.6083333333333334
仿真分析,0,0,1,0,0,0,0,1,0.125
m-fi,0,0,1,0,0,0,0,1,0.125
w-fi信号,0,0,1,0,0,0,0,1,0.125
盲源分离技术,0,0,1,0,0,0,0,1,0.125
ofdm技术,0,0,1,1,0,0,0,2,0.25
特性,1,0,1,7,1,2,0,12,2.725
ofdm,1,0,1,2,3,1,1,9,2.583333333333333
特征,0,0,1,1,0,0,0,2,0.25
信号盲,0,0,1,1,0,0,0,2,0.25
单信号盲识别技术,0,0,1,0,0,0,0,1,0.125
信号盲识别技,0,0,1,1,0,0,0,2,0.25
同步,0,0,0,3,0,0,0,3,0.375
垂直切换算法,0,0,0,2,0,0,0,2,0.25
混合回程线路,0,0,0,2,0,0,0,2,0.25
干扰抑制,0,0,0,2,0,0,0,2,0.25
移动性管理,0,0,0,2,0,0,0,2,0.25
回程线路,0,0,0,2,0,0,0,2,0.25
接收端信号,0,0,0,1,0,0,0,1,0.125
广义异构网络,0,0,0,1,0,0,0,1,0.125
空域波束赋形,0,0,0,1,0,0,0,1,0.125
时域空白子帧,0,0,0,1,0,0,0,1,0.125
功率控制,0,0,0,1,0,0,0,1,0.125
干扰协调,0,0,0,1,0,0,0,1,0.125
干扰消除,0,0,0,1,0,0,0,1,0.125
干扰处理,0,0,0,1,0,0,0,1,0.125
同频干扰,0,0,0,1,0,0,0,1,0.125
共道,0,0,0,1,0,0,0,1,0.125
强度,0,0,0,1,0,0,0,1,0.125
联合接收信号,0,0,0,1,0,0,0,1,0.125
水平切换算法,0,0,0,1,0,0,0,1,0.125
强度准则,0,0,0,1,0,0,0,1,0.125
同构网络,0,0,0,1,0,0,0,1,0.125
移动管理,0,0,0,1,0,0,0,1,0.125
异构特性,0,0,0,1,0,0,0,1,0.125
协作干扰抑制,0,0,0,1,0,0,0,1,0.125
多点,0,0,0,1,0,0,0,1,0.125
能耗约束,0,0,0,1,0,0,0,1,0.125
时延,0,0,0,1,1,0,0,2,0.3666666666666667
全网同步修正算法,0,0,0,1,0,0,0,1,0.125
同步协议,0,0,0,1,0,0,0,1,0.125
广播同步信号,0,0,0,1,0,0,0,1,0.125
无基础架构,0,0,0,1,0,0,0,1,0.125
网络同步,0,0,0,1,0,0,0,1,0.125
制式设备,0,0,0,1,0,0,0,1,0.125
家庭基站,0,0,0,1,0,0,0,1,0.125
中继节点,0,0,0,1,0,0,0,1,0.125
微小区,0,0,0,1,0,0,0,1,0.125
低功率节点,0,0,0,1,0,0,0,1,0.125
宏基站,0,0,0,2,0,0,0,2,0.25
网元节点,0,0,0,1,0,0,0,1,0.125
发送功率,0,0,0,1,0,0,0,1,0.125
无线接入技术,0,0,0,1,0,0,0,1,0.125
制式网络,0,0,0,1,0,0,0,1,0.125
连续性,0,0,0,1,0,0,0,1,0.125
站址资源,0,0,0,1,0,0,0,1,0.125
移动宽带业务,0,0,0,1,0,0,0,1,0.125
频谱分配,0,0,0,3,0,0,0,3,0.375
频谱感知,0,0,0,6,0,0,0,6,0.75
频谱切换,0,0,0,2,0,0,0,2,0.25
频谱感知无线电,0,0,0,2,0,0,0,2,0.25
认知网络,0,0,0,11,0,0,0,11,1.375
切换执行,0,0,0,1,0,0,0,1,0.125
判决,0,0,0,1,0,0,0,1,0.125
触发,0,0,0,1,0,0,0,1,0.125
移动性,0,0,0,1,0,0,0,1,0.125
根基频谱,0,0,0,1,0,0,0,1,0.125
合作式,0,0,0,1,0,0,0,1,0.125
分布式,0,0,0,1,0,0,0,1,0.125
集中,0,0,0,1,0,0,0,1,0.125
极化域,0,0,0,1,0,0,0,1,0.125
码域,0,0,0,1,0,0,0,1,0.125
距离域,0,0,0,1,0,0,0,1,0.125
功率域,0,0,0,1,0,0,0,1,0.125
空域,0,0,0,1,0,0,0,1,0.125
极化域感知,0,0,0,1,0,0,0,1,0.125
极化度频谱感知,0,0,0,1,0,0,0,1,0.125
空域感知,0,0,0,1,0,0,0,1,0.125
来波角度检测,0,0,0,1,0,0,0,1,0.125
波束,0,0,0,1,0,0,0,1,0.125
频域感知,0,0,0,1,0,0,0,1,0.125
时频分析检测,0,0,0,1,0,0,0,1,0.125
时域感知,0,0,0,1,0,0,0,1,0.125
特征值检测,0,0,0,1,0,0,0,1,0.125
能量检测,0,0,0,1,0,0,0,1,0.125
空域信息,0,0,0,1,0,0,0,1,0.125
智能通信模型,0,0,0,1,0,0,0,1,0.125
智能通信系统架构,0,0,0,1,0,0,0,1,0.125
智能推理,0,0,0,1,0,0,0,1,0.125
信道状态估,0,0,0,1,0,0,0,1,0.125
无线环境感知,0,0,0,1,0,0,0,1,0.125
智能无线通信系统,0,0,0,1,0,0,0,1,0.125
广义认知无线电,0,0,0,1,0,0,0,1,0.125
频谱共享图,0,0,0,1,0,0,0,1,0.125
无线环境,0,0,0,2,1,1,0,4,0.7333333333333334
工作,0,0,0,1,0,0,0,1,0.125
周围网络,0,0,0,1,0,0,0,1,0.125
认知能,0,0,0,2,0,0,0,2,0.25
授权网络,0,0,0,3,0,0,0,3,0.375
授权用户,0,0,0,2,0,0,0,2,0.25
认知,0,0,0,2,1,0,0,3,0.4916666666666667
无线电技术,0,0,0,2,0,0,0,2,0.25
频谱效率,0,0,0,2,0,0,0,2,0.25
5ghz频段通信,0,0,0,1,0,0,0,1,0.125
d2d,0,0,0,1,0,0,0,1,0.125
认知无线电基站,0,0,0,1,0,0,0,1,0.125
ad,0,0,0,1,0,0,0,1,0.125
覆盖,1,0,0,1,0,0,0,2,1.125
accesspoint,0,0,0,1,0,0,0,1,0.125
wi-fi接入点,0,0,0,1,0,0,0,1,0.125
basestation,0,0,0,1,0,0,0,1,0.125
接收lte-u基站,0,0,0,1,0,0,0,1,0.125
wi-fi用户,0,0,0,1,1,0,0,2,0.3666666666666667
lte-u用户,0,0,0,1,0,0,0,1,0.125
userequipment,0,0,0,1,0,0,0,1,0.125
主用户终端,0,0,0,1,0,0,0,1,0.125
认知网络系统,0,0,0,1,0,0,0,1,0.125
wi-fi网络系统,0,0,0,1,0,0,0,1,0.125
通信协作,0,0,0,1,0,0,0,1,0.125
主从用户,0,0,0,1,0,0,0,1,0.125
覆盖式频谱,0,0,0,1,0,0,0,1,0.125
干扰强度,0,0,0,1,0,0,0,1,0.125
扩频,0,0,0,1,0,0,0,1,0.125
智能感知,0,0,0,1,0,0,0,1,0.125
认知无线电功能,0,0,0,1,0,0,0,1,0.125
通信质量,0,0,0,1,0,0,0,1,0.125
覆盖式频谱接,0,0,0,1,0,0,0,1,0.125
无干扰共存研究,0,0,0,1,0,0,0,1,0.125
多源性,0,0,0,1,0,0,0,1,0.125
来源干扰,0,0,0,1,0,0,0,1,0.125
同频部署,0,0,0,1,0,0,0,1,0.125
增强覆盖网络,0,0,0,1,0,0,0,1,0.125
异构站点,0,0,0,1,0,0,0,1,0.125
跨层干扰,0,0,0,1,0,0,0,1,0.125
强覆盖网络,0,0,0,1,0,0,0,1,0.125
宏网络,0,0,0,1,0,0,0,1,0.125
无干扰共存技术,0,0,0,1,0,0,0,1,0.125
复杂干扰,0,0,0,1,0,0,0,1,0.125
自由度,0,0,0,1,0,1,0,2,0.3666666666666667
可用频谱机,0,0,0,1,0,0,0,1,0.125
可用频谱,0,0,0,1,0,0,0,1,0.125
授权网,0,0,0,1,0,0,0,1,0.125
频谱机,0,0,0,1,0,0,0,1,0.125
高效频谱共享技术,0,0,0,1,0,0,0,1,0.125
深度分析,0,0,0,1,0,0,0,1,0.125
高动态性,0,0,0,1,0,0,0,1,0.125
异构,0,0,0,1,0,0,0,1,0.125
传输参数,0,0,0,1,0,0,0,1,0.125
信号盲识,0,0,0,1,0,0,0,1,0.125
识别技术,0,0,0,1,0,0,0,1,0.125
信号感知,0,0,0,1,0,0,0,1,0.125
认知无线电技,0,0,0,1,0,0,0,1,0.125
异构无线环,0,0,0,1,0,0,0,1,0.125
感知,0,0,0,1,0,0,0,1,0.125
物理层,0,0,0,1,0,0,0,1,0.125
节点,0,0,0,1,0,0,0,1,0.125
认知无线电系统,0,0,0,1,0,0,0,1,0.125
频率利用率,0,0,0,1,0,0,0,1,0.125
oo,0,0,0,1,0,0,0,1,0.125
高通公司,0,0,0,1,0,0,0,1,0.125
载频,0,0,0,13,0,0,0,13,1.625
码速,0,0,0,11,0,0,0,11,1.375
调制信号,0,0,0,8,0,0,0,8,1.0
分类器,0,0,0,9,0,0,0,9,1.125
单载波信号,0,0,0,9,0,0,0,9,1.125
极化状态参数,0,0,0,6,0,0,0,6,0.75
特征函数,0,0,0,5,0,0,0,5,0.625
星座图,0,0,0,5,0,0,0,5,0.625
数字调制,0,0,0,5,0,0,0,5,0.625
时频特征,0,0,0,4,0,0,0,4,0.5
信噪比,0,0,0,6,3,3,0,12,2.2
调制指数,0,0,0,4,0,0,0,4,0.5
瞬时频率,0,0,0,4,0,0,0,4,0.5
基带信号,0,0,0,7,2,0,0,9,1.3583333333333334
高阶矩,0,0,0,3,0,0,0,3,0.375
高斯噪声,0,0,0,3,0,0,0,3,0.375
标准偏差,0,0,0,3,0,0,0,3,0.375
瞬时幅度,0,0,0,4,0,0,0,4,0.5
码元速率,0,0,0,3,0,0,0,3,0.375
有效特征参数,0,0,0,3,0,0,0,3,0.375
qpsk,0,0,0,4,3,2,0,9,1.7083333333333333
高阶,0,0,0,2,0,0,0,2,0.25
紧致性,0,0,0,2,0,0,0,2,0.25
绝对值,0,0,0,2,1,0,0,3,0.4916666666666667
非弱信号,0,0,0,2,0,0,0,2,0.25
时频特征参数,0,0,0,2,0,0,0,2,0.25
特征值,0,0,0,3,0,3,0,6,1.1
调相指数,0,0,0,2,0,0,0,2,0.25
调频指数,0,0,0,2,0,0,0,2,0.25
瞬时相位,0,0,0,2,0,0,0,2,0.25
精度,0,0,0,2,0,0,0,2,0.25
原始信号,0,0,0,2,0,0,0,2,0.25
循环谱包络,0,0,0,2,0,0,0,2,0.25
循环谱包络法,0,0,0,2,0,0,0,2,0.25
高阶循环累积量,0,0,0,2,0,0,0,2,0.25
待识别信号,0,0,0,2,0,0,0,2,0.25
信号调制,0,0,0,4,1,0,0,5,0.7416666666666667
mqam调制,0,0,0,2,0,0,0,2,0.25
bpsk,0,0,0,2,1,1,0,4,0.7333333333333334
am,0,0,0,2,0,0,0,2,0.25
自适性差,0,0,0,1,0,0,0,1,0.125
结构,0,0,0,1,0,0,0,1,0.125
梯形结构,0,0,0,1,0,0,0,1,0.125
泛化性,0,0,0,1,0,0,0,1,0.125
样本,0,0,0,1,0,0,0,1,0.125
高维分类,0,0,0,1,0,0,0,1,0.125
核函数,0,0,0,1,0,0,0,1,0.125
向量机,0,0,0,1,0,0,0,1,0.125
支持,0,0,0,1,0,0,0,1,0.125
样本数据,0,0,0,1,0,0,0,1,0.125
神经网络,0,0,0,2,6,0,0,8,1.7
决策树,0,0,0,1,0,0,0,1,0.125
子空间,0,0,0,1,0,0,0,1,0.125
调制制式,0,0,0,1,0,0,0,1,0.125
信号空间,0,0,0,1,0,0,0,1,0.125
切面,0,0,0,1,0,0,0,1,0.125
m-qam调制,0,0,0,1,0,0,0,1,0.125
16qam,0,0,0,2,2,1,0,5,0.975
4fsk,0,0,0,1,0,0,0,1,0.125
fsk,0,0,0,1,0,0,0,1,0.125
导数,0,0,0,1,0,0,0,1,0.125
方差,0,0,0,2,0,0,0,2,0.25
均值,0,0,0,2,0,0,0,2,0.25
高斯信号,0,0,0,1,0,2,0,3,0.6083333333333334
高斯随机过程,0,0,0,1,0,0,0,1,0.125
rni,0,0,0,1,0,0,0,1,0.125
共朝操作,0,0,0,1,0,0,0,1,0.125
阶数,0,0,0,1,0,0,0,1,0.125
高阶矩加凶,0,0,0,1,0,0,0,1,0.125
左阶导数,0,0,0,1,0,0,0,1,0.125
函数,0,0,0,3,0,0,0,3,0.375
随机变量,0,0,0,2,0,0,0,2,0.25
第二特征函数,0,0,0,1,0,0,0,1,0.125
生成函数,0,0,0,1,0,0,0,1,0.125
矩生成函数,0,0,0,1,0,0,0,1,0.125
左阶矩,0,0,0,1,0,0,0,1,0.125
上阶导数,0,0,0,1,0,0,0,1,0.125
期望运算,0,0,0,1,0,0,0,1,0.125
laplace算子,0,0,0,1,0,0,0,1,0.125
积分,0,0,0,1,0,0,0,1,0.125
概率密度,0,0,0,1,0,0,0,1,0.125
随机变量工具,0,0,0,1,0,0,0,1,0.125
高阶统计量特征,0,0,0,2,0,0,0,2,0.25
时频域变换,0,0,0,1,0,0,0,1,0.125
谱对称性,0,0,0,1,0,0,0,1,0.125
非线性分量,0,0,0,1,0,0,0,1,0.125
功率谱密度,0,0,0,1,3,0,0,4,0.85
已调信号,0,0,0,1,0,0,0,1,0.125
信息荷载,0,0,0,1,0,0,0,1,0.125
相位参数,0,0,0,1,0,0,0,1,0.125
高频载波信号,0,0,0,1,0,0,0,1,0.125
时空doa矩阵,0,0,0,1,0,0,0,1,0.125
时域空域,0,0,0,1,0,0,0,1,0.125
参数估计,0,0,0,1,0,0,0,1,0.125
空时处理,0,0,0,1,0,0,0,1,0.125
运算量,0,0,0,1,0,0,0,1,0.125
天线阵列,0,0,0,1,0,0,0,1,0.125
极化状态,0,0,0,1,0,0,0,1,0.125
空间谱估计,0,0,0,1,0,0,0,1,0.125
空间谱估计法,0,0,0,1,0,0,0,1,0.125
稳定性,0,0,0,1,0,0,0,1,0.125
波束宽度,0,0,0,1,0,0,0,1,0.125
空间极化变化率,0,0,0,1,0,0,0,1,0.125
最小二乘法,0,0,0,1,0,0,0,1,0.125
系统,0,0,0,2,0,0,0,2,0.25
单极化信道,0,0,0,1,0,0,0,1,0.125
正交极化信道,0,0,0,1,0,0,0,1,0.125
空间扫描过,0,0,0,1,0,0,0,1,0.125
极化特性,0,0,0,1,0,0,0,1,0.125
雷达接收天线,0,0,0,1,0,0,0,1,0.125
空域极化特性,0,0,0,1,0,0,0,1,0.125
极化,0,0,0,1,0,0,0,1,0.125
天线,0,0,0,1,0,1,0,2,0.3666666666666667
跟踪能力,0,0,0,1,0,0,0,1,0.125
学习,0,0,0,1,0,0,0,1,0.125
自适应算法,0,0,0,2,0,0,0,2,0.25
方差估计器,0,0,0,1,0,0,0,1,0.125
线性,0,0,0,1,0,0,0,1,0.125
状态空间模型,0,0,0,1,0,0,0,1,0.125
卡尔曼滤波技术,0,0,0,1,0,0,0,1,0.125
鲁棒性,0,0,0,1,0,0,0,1,0.125
跟踪性能,0,0,0,1,0,0,0,1,0.125
步长,0,0,0,1,0,0,0,1,0.125
均方误差算法,0,0,0,1,0,0,0,1,0.125
变步长,0,0,0,1,0,0,0,1,0.125
空间极化特性,0,0,0,1,0,0,0,1,0.125
极化相位描述子,0,0,0,1,0,0,0,1,0.125
极化角,0,0,0,1,0,0,0,1,0.125
辐射源,0,0,0,1,0,0,0,1,0.125
抗干扰极化滤波技术,0,0,0,1,0,0,0,1,0.125
雷达信号,0,0,0,1,0,0,0,1,0.125
cmp,0,0,0,1,0,0,0,1,0.125
连续相位调制,0,0,0,1,0,0,0,1,0.125
fm信号,0,0,0,1,0,0,0,1,0.125
循环平稳性,0,0,0,3,0,0,0,3,0.375
pm调制,0,0,0,1,0,0,0,1,0.125
fm调制,0,0,0,1,0,0,0,1,0.125
时频重叠多信号,0,0,0,1,0,0,0,1,0.125
相位跳变点,0,0,0,1,0,0,0,1,0.125
差分,0,0,0,1,0,0,0,1,0.125
相位差分法,0,0,0,1,0,0,0,1,0.125
偏差,0,0,0,1,0,0,0,1,0.125
载频值,0,0,0,1,0,0,0,1,0.125
小波尺度,0,0,0,1,0,0,0,1,0.125
离散傅里叶变换,0,0,0,1,0,0,0,1,0.125
小波幅度,0,0,0,1,0,0,0,1,0.125
相位跳变,0,0,0,1,0,0,0,1,0.125
haar小波检测信号,0,0,0,1,0,0,0,1,0.125
小波变换法,0,0,0,2,0,0,0,2,0.25
先验条件,0,0,0,1,0,0,0,1,0.125
间隔,0,0,0,1,0,1,0,2,0.3666666666666667
幅度值,0,0,0,1,0,0,0,1,0.125
循环累积量谱图,0,0,0,1,0,0,0,1,0.125
循环频率估计法,0,0,0,1,0,0,0,1,0.125
谱峰搜索,0,0,0,1,1,0,0,2,0.3666666666666667
无偏性,0,0,0,1,0,0,0,1,0.125
渐进性,0,0,0,1,0,0,0,1,0.125
估计器,0,0,0,1,0,0,0,1,0.125
码速率,0,0,0,1,0,0,0,1,0.125
循环自相关,0,0,0,1,0,0,0,1,0.125
循环自相关法,0,0,0,1,0,0,0,1,0.125
码速估计,0,0,0,1,0,0,0,1,0.125
频谱特征,0,0,0,1,0,0,0,1,0.125
占用频率带宽,0,0,0,1,0,0,0,1,0.125
频偏粗估,0,0,0,1,0,0,0,1,0.125
频域谱,0,0,0,1,0,0,0,1,0.125
频偏估计算,0,0,0,1,0,0,0,1,0.125
合时频载波,0,0,0,1,0,0,0,1,0.125
相位信息,0,0,0,1,0,0,0,1,0.125
自相关参数,0,0,0,1,0,0,0,1,0.125
时域估计算法,0,0,0,1,0,0,0,1,0.125
峰值,0,0,0,1,3,0,0,4,0.85
周期图谱,0,0,0,1,0,0,0,1,0.125
数据,0,0,0,2,1,0,0,3,0.4916666666666667
二乘频偏估计算法,0,0,0,1,0,0,0,1,0.125
似然估计算法,0,0,0,1,0,0,0,1,0.125
前馈,0,0,0,1,0,0,0,1,0.125
最大似然估计准则,0,0,0,1,0,0,0,1,0.125
最大似然估计准则法,0,0,0,1,0,0,0,1,0.125
非合作共信道信号,0,0,0,1,0,0,0,1,0.125
非零循环频率,0,0,0,1,0,0,0,1,0.125
/256q,0,0,0,1,0,0,0,1,0.125
16q,0,0,0,1,0,0,0,1,0.125
载频抗干扰性,0,0,0,1,0,0,0,1,0.125
高阶循环累积量法,0,0,0,1,0,0,0,1,0.125
mpsk信号,0,0,0,1,0,0,0,1,0.125
时频,0,0,0,2,0,0,0,2,0.25
相位突变,0,0,0,1,0,0,0,1,0.125
信号非线性变换,0,0,0,1,0,0,0,1,0.125
高次方非线性变换法,0,0,0,1,0,0,0,1,0.125
多重叠信号,0,0,0,1,0,0,0,1,0.125
mask,0,0,0,1,0,0,0,1,0.125
估计速度,0,0,0,1,0,0,0,1,0.125
功率分布函数,0,0,0,1,0,0,0,1,0.125
域谱线,0,0,0,1,0,0,0,1,0.125
累计法,0,0,0,1,0,0,0,1,0.125
谱分析,0,0,0,1,0,0,0,1,0.125
mfsk调制信号,0,0,0,1,0,0,0,1,0.125
始信号,0,0,0,1,0,0,0,1,0.125
截止频率,0,0,0,1,0,0,0,1,0.125
高频载波,0,0,0,1,0,0,0,1,0.125
滤波器,0,0,0,2,0,0,0,2,0.25
码速估,0,0,0,1,0,0,0,1,0.125
载频估,0,0,0,1,0,0,0,1,0.125
盲识别过,0,0,0,1,0,0,0,1,0.125
信号序列,0,0,0,1,0,0,0,1,0.125
信号参数,0,0,0,1,3,0,0,4,0.85
q路调制,0,0,0,1,0,0,0,1,0.125
i路调制,0,0,0,1,0,0,0,1,0.125
调制相位,0,0,0,1,0,0,0,1,0.125
mpsk调制,0,0,0,1,0,0,0,1,0.125
频偏值,0,0,0,1,0,0,0,1,0.125
mfsk调制,0,0,0,1,0,0,0,1,0.125
载波频率,1,0,0,1,0,0,0,2,1.125
周期,0,0,0,2,4,0,0,6,1.2166666666666668
概率,0,0,0,1,0,0,0,1,0.125
mask调制,0,0,0,1,0,0,0,1,0.125
mqam信号,0,0,0,1,0,0,0,1,0.125
载波,0,0,0,2,0,0,0,2,0.25
mask信号,0,0,0,1,0,0,0,1,0.125
离散线谱分量,0,0,0,1,0,0,0,1,0.125
binaryphaseshiftkeying,0,0,0,1,0,0,0,1,0.125
非恒包络信号,0,0,0,1,0,0,0,1,0.125
响应,0,0,0,1,0,0,0,1,0.125
高斯滤波,0,0,0,1,0,0,0,1,0.125
二元集合,0,0,0,1,0,0,0,1,0.125
minimumshiftkey,0,0,0,1,0,0,0,1,0.125
filtered,0,0,0,1,0,0,0,1,0.125
gmsk,0,0,0,1,0,0,0,1,0.125
m元集合,0,0,0,1,0,0,0,1,0.125
mfsk信号,0,0,0,1,0,0,0,1,0.125
恒包络信号,0,0,0,1,0,0,0,1,0.125
无线通信信号,0,0,0,1,0,0,0,1,0.125
长距离无线通信,0,0,0,1,0,0,0,1,0.125
抗干扰能力,0,0,0,1,0,0,0,1,0.125
quadratureamplitudemodulation,0,0,0,1,0,0,0,1,0.125
qam,0,0,0,1,0,0,0,1,0.125
phaseshiftkeying,0,0,0,1,0,0,0,1,0.125
psk,0,0,0,1,0,0,0,1,0.125
frequencyshiftkeying,0,0,0,1,0,0,0,1,0.125
amplitudeshiftkeying,0,0,0,1,0,0,0,1,0.125
ask,0,0,0,1,0,0,0,1,0.125
数字信号,0,0,0,2,0,0,0,2,0.25
phasemodulation,0,0,0,1,0,0,0,1,0.125
frequencymodulation,0,0,0,1,0,0,0,1,0.125
fm,0,0,0,1,0,0,0,1,0.125
amplitudemodulation,0,0,0,1,0,0,0,1,0.125
模拟调制,0,0,0,1,0,0,0,1,0.125
模拟信号,0,0,0,1,0,0,0,1,0.125
调制特性,0,0,0,1,0,0,1,2,0.3666666666666667
子载波,0,0,0,11,2,0,0,13,1.8583333333333334
ofdm信号,1,0,0,10,15,2,1,29,6.6
保护间隔,0,0,0,6,0,0,0,6,0.75
符号,0,0,0,5,1,1,0,7,1.1083333333333334
isi,0,0,0,4,0,0,0,4,0.5
子信道,0,0,0,4,2,0,0,6,0.9833333333333334
多径信道,0,0,0,3,1,0,0,4,0.6166666666666667
循环前缀,0,0,0,3,4,1,0,8,1.5833333333333333
导频子载波,0,0,0,3,1,0,0,4,0.6166666666666667
ifft,0,0,0,3,0,0,0,3,0.375
星座图映射,0,0,0,3,0,0,0,3,0.375
ofdm调制技术,0,0,0,5,0,0,0,5,0.625
ici,0,0,0,2,0,0,0,2,0.25
子载波积分,0,0,0,2,0,0,0,2,0.25
无保护间隔,0,0,0,2,0,0,0,2,0.25
调制过,0,0,0,2,0,0,0,2,0.25
信号传输信道,0,0,0,2,0,0,0,2,0.25
总子载波数,0,0,0,2,2,0,0,4,0.7333333333333334
传输信号,0,0,0,2,0,0,0,2,0.25
信息,0,0,0,2,0,0,0,2,0.25
导频子载波数据,0,0,0,1,0,0,0,1,0.125
ofdm多载波信号,0,0,0,1,0,0,0,1,0.125
循环前缀结构,0,0,0,1,0,0,0,1,0.125
信号时延,0,0,0,1,0,0,0,1,0.125
循环,0,0,0,1,0,0,0,1,0.125
子载波间,0,0,0,1,0,0,0,1,0.125
正弦波,0,0,0,1,0,0,0,1,0.125
波形,0,0,0,2,2,0,0,4,0.7333333333333334
空数据,0,0,0,1,0,0,0,1,0.125
cyclicprefix,0,0,0,1,0,0,0,1,0.125
多径信号,0,0,0,1,0,0,0,1,0.125
icl,0,0,0,1,0,0,0,1,0.125
接收,0,0,0,1,0,0,0,1,0.125
实线,0,0,0,1,0,0,0,1,0.125
虚线,0,0,0,1,0,0,0,1,0.125
多径延时信号,0,0,0,1,0,0,0,1,0.125
接收端,0,0,0,2,0,0,0,2,0.25
inter-carrierinterface,0,0,0,1,0,0,0,1,0.125
载频间干扰,0,0,0,1,0,0,0,1,0.125
inter-symbolinterfer,0,0,0,1,0,0,0,1,0.125
符号间干扰,0,0,0,1,0,0,0,1,0.125
传输数据,0,0,0,1,1,0,0,2,0.3666666666666667
信号子载波,0,0,0,1,1,0,0,2,0.3666666666666667
d/a转换,0,0,0,1,0,0,0,1,0.125
信道质量,0,0,0,1,1,0,0,2,0.3666666666666667
质量,0,0,0,1,0,0,0,1,0.125
传输信道,0,0,0,1,0,1,0,2,0.3666666666666667
64qam,0,0,0,1,2,1,0,4,0.85
ofdm调制过程,0,0,0,1,0,0,0,1,0.125
解调,0,0,0,1,0,0,0,1,0.125
快速傅里叶反变,0,0,0,1,0,0,0,1,0.125
快速傅里叶变换,0,0,0,1,0,0,0,1,0.125
ofdm体制,0,0,0,1,0,0,0,1,0.125
bandwidth,0,0,0,1,0,0,0,1,0.125
周期符号特性,0,0,0,1,0,0,0,1,0.125
guardintervals,0,0,0,1,0,0,0,1,0.125
sub-carriers,0,0,0,1,0,0,0,1,0.125
数据符号,0,0,0,1,1,0,0,2,0.3666666666666667
低速数据流,0,0,0,1,0,0,0,1,0.125
数据流,0,0,0,1,0,0,0,1,0.125
ofdm符号周期,0,0,0,1,1,0,0,2,0.3666666666666667
总带宽,0,0,0,1,1,0,0,2,0.3666666666666667
子载波间隔,0,0,0,1,1,0,0,2,0.3666666666666667
子载波数据符号,0,0,0,1,1,0,0,2,0.3666666666666667
总子载波,0,0,0,1,1,0,0,2,0.3666666666666667
正交分量,0,0,0,1,0,0,0,1,0.125
同相分量,0,0,0,1,0,0,0,1,0.125
表达式,0,0,0,1,0,0,0,1,0.125
ofdm多载波调制,0,0,0,1,0,0,0,1,0.125
信号带宽资源,0,0,0,1,0,0,0,1,0.125
多载波传输,0,0,0,1,0,0,0,1,0.125
利用率,0,0,0,1,0,0,0,1,0.125
并行数据传输系统,0,0,0,1,0,0,0,1,0.125
频率复用,0,0,0,1,0,0,0,1,0.125
信号传输,0,0,0,1,2,0,0,3,0.6083333333333334
并行数据,0,0,0,1,0,0,0,1,0.125
多载波,0,0,0,1,0,0,0,1,0.125
盲识别技,0,0,0,3,1,0,0,4,0.6166666666666667
包络方差,0,0,0,1,0,0,0,1,0.125
副载波信号,0,0,0,1,0,0,0,1,0.125
抗干扰性,0,0,0,1,0,0,0,1,0.125
频谱截取,0,0,0,1,0,0,0,1,0.125
频率矩形窗,0,0,0,1,0,0,0,1,0.125
有效带宽,0,0,0,1,0,0,0,1,0.125
中心频率,0,0,0,1,0,0,0,1,0.125
gar模型,0,0,0,1,0,0,0,1,0.125
源信号,0,0,0,15,0,3,0,18,2.6
概率密度函数,0,0,0,9,0,0,0,9,1.125
分离矩阵,0,0,0,8,0,5,0,13,2.208333333333333
接收机,0,0,0,8,0,0,0,8,1.0
分离准则,0,0,0,4,0,0,0,4,0.5
分量,0,0,0,4,0,3,0,7,1.225
信号分离,0,0,0,4,0,0,0,4,0.5
自适应盲源分离算法,0,0,0,3,0,0,0,3,0.375
接收数据,0,0,0,3,0,0,0,3,0.375
互信息量,0,0,0,3,0,0,0,3,0.375
信息论,0,0,0,3,0,0,0,3,0.375
ica,0,0,0,3,0,0,0,3,0.375
发射信号,0,0,0,3,0,0,0,3,0.375
几何分离算法,0,0,0,2,0,0,0,2,0.25
对角化,0,0,0,2,0,1,0,3,0.4916666666666667
截取信号,0,0,0,2,0,0,0,2,0.25
残差噪声,0,0,0,2,0,0,0,2,0.25
混叠矩阵,0,0,0,2,0,1,0,3,0.4916666666666667
代价函数,0,0,0,2,0,0,0,2,0.25
信息传输,0,0,0,2,0,0,0,2,0.25
边缘概率密度函数,0,0,0,2,0,0,0,2,0.25
联合概率密度函数,0,0,0,2,0,0,0,2,0.25
最大信噪比准则,0,0,0,2,0,0,0,2,0.25
信息论准则,0,0,0,2,0,0,0,2,0.25
语音信号,0,0,0,2,0,0,0,2,0.25
似然准则,0,0,0,2,0,0,0,2,0.25
ica分离,0,0,0,2,0,0,0,2,0.25
成型滤波器,0,0,0,2,0,0,0,2,0.25
逐幸存路径处理,0,0,0,2,0,0,0,2,0.25
多维映射,0,0,0,2,0,0,0,2,0.25
符号序列,0,0,0,2,0,0,0,2,0.25
变换滤波,0,0,0,2,0,0,0,2,0.25
盲源分离模型,0,0,0,2,0,0,0,2,0.25
矢量,0,0,0,2,0,0,0,2,0.25
分集增益,0,0,0,1,0,0,0,1,0.125
接收天线,0,0,0,1,0,0,0,1,0.125
正定盲源分离算法,0,0,0,1,0,0,0,1,0.125
正定分离,0,0,0,1,0,0,0,1,0.125
超定分离,0,0,0,1,0,0,0,1,0.125
预处理,0,0,0,1,0,0,0,1,0.125
正交化,0,0,0,1,0,5,0,6,1.3333333333333333
超定盲源分离,0,0,0,1,0,0,0,1,0.125
分离速度,0,0,0,1,0,0,0,1,0.125
联合对角化算法,0,0,0,1,0,0,0,1,0.125
单位阵,0,0,0,1,0,1,0,2,0.3666666666666667
粒子群优化算法,0,0,0,1,0,0,0,1,0.125
智能算法,0,0,0,1,0,0,0,1,0.125
对角,1,0,0,1,0,0,0,2,1.125
分离矩阵力,0,0,0,1,0,0,0,1,0.125
零点,0,0,0,1,0,0,0,1,0.125
极值,0,0,0,1,0,0,0,1,0.125
梯度,0,0,0,1,0,0,0,1,0.125
先关矩阵,0,0,0,1,0,0,0,1,0.125
目标函数,0,0,0,1,0,0,0,1,0.125
残差信号,0,0,0,1,0,0,0,1,0.125
误差,0,0,0,1,0,0,0,1,0.125
源信,0,0,0,1,0,0,0,1,0.125
最大信噪比,0,0,0,1,0,0,0,1,0.125
级数,0,0,0,1,0,0,0,1,0.125
样本数,0,0,0,1,0,0,0,1,0.125
对数似然函数,0,0,0,1,0,0,0,1,0.125
估计,0,0,0,1,0,0,0,1,0.125
概率密度分布函数,0,0,0,1,0,0,0,1,0.125
似然,0,0,0,1,0,0,0,1,0.125
最大端准则,0,0,0,1,0,0,0,1,0.125
pqcy,0,0,0,1,0,0,0,1,0.125
互信息,0,0,0,1,0,0,0,1,0.125
调节,0,0,0,1,0,0,0,1,0.125
准则,0,0,0,1,0,0,0,1,0.125
离散随机变量,0,0,0,1,0,0,0,1,0.125
微分烯,0,0,0,1,0,0,0,1,0.125
最小,0,0,0,1,0,0,0,1,0.125
最小化互信息,0,0,0,1,0,0,0,1,0.125
概率论,0,0,0,1,0,0,0,1,0.125
线性关系,0,0,0,1,0,0,0,1,0.125
尸力氏,0,0,0,1,0,0,0,1,0.125
n维随机矢量,0,0,0,1,0,0,0,1,0.125
几何分离方法,0,0,0,1,0,0,0,1,0.125
自适应分离算法,0,0,0,1,0,0,0,1,0.125
ari,0,0,0,1,0,0,0,1,0.125
matrice,0,0,0,1,0,0,0,1,0.125
cardoso,0,0,0,1,0,0,0,1,0.125
正定盲源分离,0,0,0,1,0,0,0,1,0.125
计分离,0,0,0,1,0,0,0,1,0.125
对基函数学,0,0,0,1,0,0,0,1,0.125
先验时域基函数,0,0,0,1,0,0,0,1,0.125
生物医学信号,0,0,0,1,0,0,0,1,0.125
高维空间,0,0,0,1,0,0,0,1,0.125
svd映射,0,0,0,1,0,0,0,1,0.125
奇异值分解,0,0,0,1,0,0,0,1,0.125
同频数字调制信号,0,0,0,1,0,0,0,1,0.125
恒模特性,0,0,0,1,0,0,0,1,0.125
广义峭度信号,0,0,0,1,0,0,0,1,0.125
信号功率差异特性法,0,0,0,1,0,0,0,1,0.125
多维观测信号,0,0,0,1,0,0,0,1,0.125
信号延迟,0,0,0,1,0,0,0,1,0.125
多倍采样技,0,0,0,1,0,0,0,1,0.125
差异特性法,0,0,0,1,0,0,0,1,0.125
稀疏编码,0,0,0,1,0,0,0,1,0.125
有限字符特性,0,0,0,1,0,0,0,1,0.125
反馈序列,0,0,0,1,0,0,0,1,0.125
状态空间转移方程,0,0,0,1,0,0,0,1,0.125
混合信号,0,0,0,1,0,0,0,1,0.125
粒子滤波法,0,0,0,1,0,0,0,1,0.125
瞬时相位算法,0,0,0,1,0,0,0,1,0.125
线性插值法,0,0,0,1,0,0,0,1,0.125
分段式,0,0,0,1,0,0,0,1,0.125
多项式相位拟合法,0,0,0,1,0,0,0,1,0.125
交叉项,0,0,0,1,0,0,0,1,0.125
时频域,0,0,0,1,0,0,0,1,0.125
重构源信号,0,0,0,1,0,0,0,1,0.125
小波脊信息,0,0,0,1,0,0,0,1,0.125
时频信息,0,0,0,1,0,0,0,1,0.125
ar模型,0,0,0,1,0,0,0,1,0.125
差分能量算子,0,0,0,1,0,0,0,1,0.125
能量算子,0,0,0,1,0,0,0,1,0.125
时频分辨率,0,0,0,1,0,0,0,1,0.125
交叉,0,0,0,1,0,0,0,1,0.125
时频聚集性,0,0,0,1,0,0,0,1,0.125
瞬时频率法,0,0,0,1,0,0,0,1,0.125
瞬时幅度值,0,0,0,1,0,0,0,1,0.125
不重叠广义谱,0,0,0,1,0,0,0,1,0.125
时频混叠信号,0,0,0,8,0,0,0,8,1.0
线性时变维纳滤波法,0,0,0,1,0,0,0,1,0.125
信道参数,0,0,0,1,0,0,0,1,0.125
多参数,0,0,0,1,0,0,0,1,0.125
差异信息,0,0,0,1,0,0,0,1,0.125
再提取源信号,0,0,0,1,0,0,0,1,0.125
先验信,0,0,0,1,0,0,0,1,0.125
数学模型,0,0,0,1,0,0,0,1,0.125
特性分布,0,0,0,1,0,0,0,1,0.125
欠定盲源分离,0,0,0,1,0,0,0,1,0.125
发射机,0,0,0,1,0,0,0,1,0.125
超定,0,0,0,1,0,0,0,1,0.125
分离信号矩阵,0,0,0,1,0,0,0,1,0.125
分离模型,0,0,0,1,0,0,0,1,0.125
分离信号,0,0,0,1,0,4,0,5,1.0916666666666668
自适应调节,0,0,0,1,0,0,0,1,0.125
维混叠矩阵,0,0,0,1,0,0,0,1,0.125
n维源信号,0,0,0,1,0,0,0,1,0.125
发送端,0,0,0,1,0,0,0,1,0.125
m维观测信号,0,0,0,1,0,0,0,1,0.125
blindsourceseparation,0,0,0,1,0,0,0,1,0.125
半球面,0,0,0,1,0,0,0,1,0.125
均匀线阵,0,0,0,1,0,0,0,1,0.125
波束成形器,0,0,0,1,0,0,0,1,0.125
空域可分空间滤波技,0,0,0,1,0,0,0,1,0.125
fir滤波器,0,0,0,1,0,0,0,1,0.125
iir,0,0,0,1,0,0,0,1,0.125
频域可分数字滤波技术,0,0,0,1,0,0,0,1,0.125
分离器,0,0,0,1,0,0,0,1,0.125
提取,0,0,0,1,0,0,0,1,0.125
接收信号序列,0,0,0,1,0,0,0,1,0.125
频率差异性,0,0,0,2,0,0,0,2,0.25
效特征参数,0,0,0,1,0,0,0,1,0.125
频率点,0,0,0,1,0,0,0,1,0.125
非零谱线,0,0,0,1,0,0,0,1,0.125
循环频率,0,0,0,1,0,0,0,1,0.125
发射天线,0,0,0,1,0,0,0,1,0.125
独立性,0,0,0,1,0,0,0,1,0.125
wi-fi混叠信号,0,0,0,1,0,2,0,3,0.6083333333333334
时频混叠现象,0,0,0,1,0,0,0,1,0.125
偏时域相干分析,0,0,0,1,0,0,0,1,0.125
频域混叠信号,0,0,0,1,0,0,0,1,0.125
提取空域,0,0,0,1,0,0,0,1,0.125
频域特征,0,0,0,1,0,0,0,1,0.125
傅里叶变换,0,0,0,1,3,0,0,4,0.85
时域混叠信号,0,0,0,1,0,0,0,1,0.125
时频混叠,0,0,0,1,0,0,0,1,0.125
频域混叠,0,0,0,1,0,0,0,1,0.125
时域混叠,0,0,0,1,0,0,0,1,0.125
混叠,0,0,0,1,0,0,0,1,0.125
导频,0,0,0,1,1,0,0,2,0.3666666666666667
征参数,0,0,0,1,1,0,0,2,0.3666666666666667
fft,1,0,0,1,10,2,0,14,4.025
fft大小,0,0,0,1,1,0,0,2,0.3666666666666667
机器学习算法,0,0,0,1,0,0,0,1,0.125
深度神经网络,0,0,0,1,0,0,0,1,0.125
深度机器学习算法,0,0,0,1,0,0,0,1,0.125
多维特征参数,0,0,0,1,0,0,0,1,0.125
无线环,0,0,0,1,0,0,0,1,0.125
盲源分离基础技术,0,0,0,1,0,0,0,1,0.125
八阶统计量,0,0,0,0,7,0,0,7,1.6916666666666667
有效子载波特征参数,1,0,0,0,2,0,1,4,1.725
信号盲识别算法,0,0,0,0,2,1,1,4,0.9666666666666667
wi-fi单信号,0,0,0,0,2,0,0,2,0.48333333333333334
单信号盲识别系统,0,0,0,0,1,0,0,1,0.24166666666666667
神经网络技术,0,0,0,0,1,0,0,1,0.24166666666666667
神经网络分离器,0,0,0,0,1,0,0,1,0.24166666666666667
区分度,0,0,0,0,1,0,0,1,0.24166666666666667
izkm,0,0,0,0,1,0,0,1,0.24166666666666667
ye,0,0,0,0,1,0,0,1,0.24166666666666667
el,0,0,0,0,1,0,0,1,0.24166666666666667
ys,0,0,0,0,1,0,0,1,0.24166666666666667
信号结构,1,0,0,0,1,1,0,3,1.4833333333333334
\^-fi,0,0,0,0,1,0,0,1,0.24166666666666667
digitalconver,0,0,0,0,1,1,0,2,0.48333333333333334
数模转换,0,0,0,0,1,1,0,2,0.48333333333333334
射频终端接收,0,0,0,0,1,1,0,2,0.48333333333333334
被认知网络系统,0,0,0,0,1,1,0,2,0.48333333333333334
瑞利信道,0,0,0,0,1,2,0,3,0.725
终端,0,0,0,0,1,1,0,2,0.48333333333333334
radiofrequency,0,0,0,0,1,1,0,2,0.48333333333333334
射频,0,0,0,0,1,1,0,2,0.48333333333333334
analog,0,0,0,0,1,1,0,2,0.48333333333333334
to,0,0,0,0,1,1,0,2,0.48333333333333334
digital,0,0,0,0,1,1,0,2,0.48333333333333334
模数转换,0,0,0,0,1,1,0,2,0.48333333333333334
二进制数据,0,0,0,0,1,1,0,2,0.48333333333333334
wi-fi网路系统,0,0,0,0,1,1,0,2,0.48333333333333334
盲识别系统模型,0,0,0,0,1,0,0,1,0.24166666666666667
通信终端,0,0,0,0,1,1,0,2,0.48333333333333334
异构认知网络模型,0,0,0,0,1,1,1,3,0.725
瑞利衰落信道,0,0,0,0,5,0,0,5,1.2083333333333333
滚降系数,0,0,0,0,1,0,0,1,0.24166666666666667
升余弦函数,0,0,0,0,1,0,0,1,0.24166666666666667
脉冲成型函数,0,0,0,0,1,0,0,1,0.24166666666666667
基带,0,0,0,0,1,0,0,1,0.24166666666666667
估计信息,0,0,0,0,1,0,0,1,0.24166666666666667
数据子载波,0,0,0,0,1,0,0,1,0.24166666666666667
数据信息,0,0,0,0,1,0,0,1,0.24166666666666667
直流直流子载波,0,0,0,0,1,0,0,1,0.24166666666666667
传播时延,0,0,0,0,1,0,0,1,0.24166666666666667
多径,0,0,0,0,3,1,0,4,0.9666666666666667
衰落因子,0,0,0,0,1,0,0,1,0.24166666666666667
路径,0,0,0,0,1,0,0,1,0.24166666666666667
传输模型,0,0,0,0,1,0,0,1,0.24166666666666667
周期信号,0,0,0,0,4,0,0,4,0.9666666666666667
自先关函数,0,0,0,0,2,0,0,2,0.48333333333333334
周期函数,0,0,0,0,2,0,0,2,0.48333333333333334
傅里叶级数,0,0,0,0,2,0,0,2,0.48333333333333334
wgn信号,0,0,0,0,1,0,0,1,0.24166666666666667
awgn信号,0,0,0,0,2,0,0,2,0.48333333333333334
ofdm周期信号,0,0,0,0,1,0,0,1,0.24166666666666667
时间间隔,0,0,0,0,1,0,0,1,0.24166666666666667
横坐标,0,0,0,0,5,3,0,8,1.9333333333333333
纵坐标,0,0,0,0,5,3,0,8,1.9333333333333333
共轲操作,0,0,0,0,1,0,0,1,0.24166666666666667
实信号,0,0,0,0,1,0,0,1,0.24166666666666667
mw-n,0,0,0,0,1,0,0,1,0.24166666666666667
tjf,0,0,0,0,1,0,0,1,0.24166666666666667
月碗,0,0,0,0,1,0,0,1,0.24166666666666667
自相关性,0,0,0,0,1,0,0,1,0.24166666666666667
循环结构,0,0,0,0,1,0,0,1,0.24166666666666667
自相关数函数,0,0,0,0,1,0,0,1,0.24166666666666667
大小参数,0,0,0,0,1,0,0,1,0.24166666666666667
峰值个数,0,0,0,0,2,0,0,2,0.48333333333333334
频谱图,0,0,0,0,1,0,0,1,0.24166666666666667
谱图,0,0,0,0,1,0,0,1,0.24166666666666667
时域信号,0,0,0,0,1,0,0,1,0.24166666666666667
采样率,0,0,0,0,1,0,0,1,0.24166666666666667
月阳,0,0,0,0,1,0,0,1,0.24166666666666667
powerspectraldensity,0,0,0,0,1,0,0,1,0.24166666666666667
采样,0,0,0,0,2,0,0,2,0.48333333333333334
抗码间干扰能力,0,0,0,0,1,0,0,1,0.24166666666666667
过采样率参数,0,0,0,0,2,0,0,2,0.48333333333333334
四阶谱,0,0,0,0,5,0,0,5,1.2083333333333333
能量,0,0,0,0,4,0,0,4,0.9666666666666667
高阶谱估计信号,0,0,0,0,1,0,0,1,0.24166666666666667
highorderstatistics,0,0,0,0,1,0,0,1,0.24166666666666667
fft变换,0,0,0,0,1,3,0,4,0.9666666666666667
hos频谱,0,0,0,0,1,0,0,1,0.24166666666666667
fft变换频谱,0,0,0,0,1,0,0,1,0.24166666666666667
传输时延,0,0,0,0,1,0,0,1,0.24166666666666667
确定性信号,0,0,0,0,1,0,0,1,0.24166666666666667
离散,0,0,0,0,1,0,0,1,0.24166666666666667
xggj,0,0,0,0,1,0,0,1,0.24166666666666667
k阶谱,0,0,0,0,1,0,0,1,0.24166666666666667
k阶累积量谱,0,0,0,0,1,0,0,1,0.24166666666666667
fourier变换,0,0,0,0,1,0,0,1,0.24166666666666667
k阶累积量,0,0,0,0,1,0,0,1,0.24166666666666667
效子载波,0,0,0,0,1,0,0,1,0.24166666666666667
多径瑞利信道,0,0,0,0,1,2,0,3,0.725
平坦性衰落,0,0,0,0,1,0,0,1,0.24166666666666667
多径衰落,0,0,0,0,1,0,0,1,0.24166666666666667
时延拓展,0,0,0,0,1,0,0,1,0.24166666666666667
时长时长,0,0,0,0,1,0,0,1,0.24166666666666667
窄带传输,0,0,0,0,1,0,0,1,0.24166666666666667
非平坦信道,0,0,0,0,1,0,0,1,0.24166666666666667
无线信道,0,0,0,0,1,0,0,1,0.24166666666666667
并行传输,0,0,0,0,1,0,0,1,0.24166666666666667
子载波调制,0,0,0,0,1,0,0,1,0.24166666666666667
正交子信道,0,0,0,0,1,0,0,1,0.24166666666666667
0fdm调制技术,0,0,0,0,1,0,0,1,0.24166666666666667
高斯白噪声干扰,0,0,0,0,1,0,0,1,0.24166666666666667
mq,0,0,0,0,1,0,0,1,0.24166666666666667
fft大小参数,0,0,0,0,1,0,0,1,0.24166666666666667
通信过程,0,0,0,0,1,0,0,1,0.24166666666666667
wi.fi信号,0,0,0,0,1,0,0,1,0.24166666666666667
乘法次数,0,0,0,0,2,1,0,3,0.725
加法次数,0,0,0,0,2,1,0,3,0.725
加法,0,0,0,0,2,1,0,3,0.725
乘法次数量级,0,0,0,0,2,1,0,3,0.725
加法次数量,0,0,0,0,2,0,0,2,0.48333333333333334
乘法,0,0,0,0,1,1,0,2,0.48333333333333334
计算机,0,0,0,0,1,1,0,2,0.48333333333333334
乘法复杂度,0,0,0,0,1,1,0,2,0.48333333333333334
nlogn,0,0,0,0,1,0,0,1,0.24166666666666667
准确识别次数,0,0,0,0,1,1,0,2,0.48333333333333334
蒙特卡洛仿真次数,0,0,0,0,1,1,0,2,0.48333333333333334
别次数,0,0,0,0,1,1,0,2,0.48333333333333334
mhz,0,0,0,0,1,1,0,2,0.48333333333333334
lte信号,0,0,0,0,5,4,0,9,2.175
wi.fi,0,0,0,0,1,1,0,2,0.48333333333333334
etu信道参数,0,0,0,0,1,0,0,1,0.24166666666666667
ofdm符号数,0,0,0,0,1,2,0,3,0.725
瑞利衰落信道模型,0,0,0,0,1,1,0,2,0.48333333333333334
urbanmodel,0,0,0,0,1,0,0,1,0.24166666666666667
extendedtypical,0,0,0,0,1,0,0,1,0.24166666666666667
etu,0,0,0,0,1,4,0,5,1.2083333333333333
仿真中信道,0,0,0,0,1,1,0,2,0.48333333333333334
snr,0,0,0,0,9,9,0,18,4.35
idb,0,0,0,0,2,0,0,2,0.48333333333333334
波动,0,0,0,0,2,0,0,2,0.48333333333333334
信号盲识别性能,0,0,0,0,1,0,0,1,0.24166666666666667
对比算法,0,0,0,0,1,0,0,1,0.24166666666666667
识别性能,0,0,0,0,1,1,0,2,0.48333333333333334
neuralnet,0,0,0,0,1,0,0,1,0.24166666666666667
eightorderstatistics,0,0,0,0,1,0,0,1,0.24166666666666667
pe-sbr,0,0,0,0,1,0,0,1,0.24166666666666667
signalblindrecognition,0,0,0,0,1,0,0,1,0.24166666666666667
parametersestimation,0,0,0,0,1,0,0,1,0.24166666666666667
bp,0,0,0,0,1,0,0,1,0.24166666666666667
宏蜂窝,0,0,0,0,1,0,0,1,0.24166666666666667
密集性,0,0,0,0,1,0,0,1,0.24166666666666667
用户设备,0,0,0,0,1,0,0,1,0.24166666666666667
微蜂窝,0,0,0,0,1,0,0,1,0.24166666666666667
ition,0,0,0,0,1,1,0,2,0.48333333333333334
correctreco,0,0,0,0,1,1,0,2,0.48333333333333334
ba,0,0,0,0,1,1,0,2,0.48333333333333334
signaltonoiseratio,0,0,0,0,1,0,0,1,0.24166666666666667
ofdm调制参数,0,0,0,0,1,1,0,2,0.48333333333333334
盲识别准确率,0,0,0,0,1,0,0,1,0.24166666666666667
仿真性能,0,0,0,0,1,1,0,2,0.48333333333333334
阶统计量,0,0,0,0,1,0,0,1,0.24166666666666667
matlab仿真,0,0,0,0,1,0,0,1,0.24166666666666667
80,0,0,0,0,1,0,0,1,0.24166666666666667
3gpp/lte,0,0,0,0,1,0,1,2,0.48333333333333334
盲识系统模型,0,0,0,0,0,1,0,1,0.24166666666666667
盲识别算,0,0,0,0,0,3,1,4,0.9666666666666667
抗高斯白噪声,0,0,0,0,0,1,1,2,0.48333333333333334
高阶谱构造信号,0,0,0,0,0,2,0,2,0.48333333333333334
高阶累积量构造信号,0,0,0,0,0,2,0,2,0.48333333333333334
认知终端,0,0,0,0,0,1,0,1,0.24166666666666667
正定混叠信号模型,0,0,0,0,0,1,0,1,0.24166666666666667
发射端,0,0,0,0,0,1,0,1,0.24166666666666667
二维发射源信号,0,0,0,0,0,1,0,1,0.24166666666666667
二维混叠信号,0,0,0,0,0,1,0,1,0.24166666666666667
线性瞬时混叠系统,0,0,0,0,0,1,0,1,0.24166666666666667
白化矩阵,0,0,0,0,0,7,0,7,1.6916666666666667
均衡解,0,0,0,0,0,4,0,4,0.9666666666666667
正交解,0,0,0,0,0,4,0,4,0.9666666666666667
感知阵列,0,0,0,0,0,1,0,1,0.24166666666666667
收敛速度,0,0,0,0,0,1,0,1,0.24166666666666667
迭代初值,0,0,0,0,0,1,0,1,0.24166666666666667
运算量量,0,0,0,0,0,1,0,1,0.24166666666666667
特征值分解,0,0,0,0,0,2,0,2,0.48333333333333334
接收阵列,0,0,0,0,0,1,0,1,0.24166666666666667
估计参数,0,0,0,0,0,1,0,1,0.24166666666666667
噪声影响,0,0,0,0,0,1,0,1,0.24166666666666667
特征向量矩阵,0,0,0,0,0,2,0,2,0.48333333333333334
特征值对角阵,0,0,0,0,0,1,0,1,0.24166666666666667
协方差矩阵,0,0,0,0,0,3,0,3,0.725
共朝转置,0,0,0,0,0,1,0,1,0.24166666666666667
白化信号,0,0,0,0,0,1,0,1,0.24166666666666667
对角阵,0,0,0,0,0,2,0,2,0.48333333333333334
协方差,0,0,0,0,0,1,0,1,0.24166666666666667
前解,0,0,0,0,0,1,0,1,0.24166666666666667
收敛过程,0,0,0,0,0,1,0,1,0.24166666666666667
参数个数,0,0,0,0,0,1,0,1,0.24166666666666667
正交化操,0,0,0,0,0,1,0,1,0.24166666666666667
信号预处理,0,0,0,0,0,1,0,1,0.24166666666666667
白化,0,0,0,0,0,1,0,1,0.24166666666666667
givens,0,0,0,0,0,4,0,4,0.9666666666666667
四阶累积量,0,0,0,0,0,4,0,4,0.9666666666666667
旋转矩阵,0,0,0,0,0,2,0,2,0.48333333333333334
ijade算法,0,0,0,0,0,2,0,2,0.48333333333333334
旋转角,0,0,0,0,0,1,0,1,0.24166666666666667
ijade,0,0,0,0,0,8,0,8,1.9333333333333333
四阶谱理论,0,0,0,0,0,1,0,1,0.24166666666666667
信号矩阵仪,0,0,0,0,0,1,0,1,0.24166666666666667
频域四阶谱理论,0,0,0,0,0,1,0,1,0.24166666666666667
初始化分离矩阵,0,0,0,0,0,1,0,1,0.24166666666666667
特征矩阵元素,0,0,0,0,0,1,0,1,0.24166666666666667
构造特征矩阵,0,0,0,0,0,1,0,1,0.24166666666666667
四阶累积量矩阵,0,0,0,0,0,1,0,1,0.24166666666666667
vedjade,0,0,0,0,0,1,0,1,0.24166666666666667
im,0,0,0,0,0,1,0,1,0.24166666666666667
通信信号,0,0,0,0,0,1,0,1,0.24166666666666667
高阶累积量准则,0,0,0,0,0,1,0,1,0.24166666666666667
分离后信号,0,0,0,0,0,2,0,2,0.48333333333333334
ade,0,0,0,0,0,1,0,1,0.24166666666666667
加法复杂度,0,0,0,0,0,1,0,1,0.24166666666666667
加法次数量级,0,0,0,0,0,1,0,1,0.24166666666666667
uade,0,0,0,0,0,1,0,1,0.24166666666666667
初始化,0,0,0,0,0,1,0,1,0.24166666666666667
已分离信号,0,0,0,0,0,1,0,1,0.24166666666666667
自先关特性,0,0,0,0,0,1,0,1,0.24166666666666667
tvprl,0,0,0,0,0,1,0,1,0.24166666666666667
频域谱图,0,0,0,0,0,1,0,1,0.24166666666666667
normalizedamplitude,0,0,0,0,0,1,0,1,0.24166666666666667
归一化幅度,0,0,0,0,0,1,0,1,0.24166666666666667
高斯分布,0,0,0,0,0,1,0,1,0.24166666666666667
中心极限,0,0,0,0,0,1,0,1,0.24166666666666667
线性组合,0,0,0,0,0,1,0,1,0.24166666666666667
正交矩阵,0,0,0,0,0,1,0,1,0.24166666666666667
正交,0,0,0,0,0,1,0,1,0.24166666666666667
正交分离矩阵,0,0,0,0,0,1,0,1,0.24166666666666667
干扰信号,0,0,0,0,0,1,0,1,0.24166666666666667
通信系统,0,0,0,0,0,1,0,1,0.24166666666666667
etu信道,0,0,0,0,0,1,0,1,0.24166666666666667
城市,0,0,0,0,0,1,0,1,0.24166666666666667
awgn信道,0,0,0,0,0,2,0,2,0.48333333333333334
ofdmsymbols,0,0,0,0,0,4,0,4,0.9666666666666667
blindrecognitionmeth,0,0,0,0,0,2,0,2,0.48333333333333334
wi-fi20mhz,0,0,0,0,0,2,0,2,0.48333333333333334
wi-fi40mhz,0,0,0,0,0,2,0,2,0.48333333333333334
wi-fi80mhz,0,0,0,0,0,2,0,2,0.48333333333333334
混得信号,0,0,0,0,0,2,0,2,0.48333333333333334
确率,0,0,0,0,0,2,1,3,0.725
盲源分,0,0,0,0,0,1,0,1,0.24166666666666667
basedonjade,0,0,0,0,0,1,0,1,0.24166666666666667
jade混叠信号,0,0,0,0,0,1,0,1,0.24166666666666667
basedonijade,0,0,0,0,0,1,0,1,0.24166666666666667
三仁,0,0,0,0,0,1,0,1,0.24166666666666667
b-lte,0,0,0,0,0,1,0,1,0.24166666666666667
lte15mhz,0,0,0,0,0,1,0,1,0.24166666666666667
带宽参数,0,0,0,0,0,1,0,1,0.24166666666666667
s-lte,0,0,0,0,0,1,0,1,0.24166666666666667
lte5mhz,0,0,0,0,0,1,0,1,0.24166666666666667
a-lte15mhz,0,0,0,0,0,1,0,1,0.24166666666666667
mqeq,0,0,0,0,0,1,0,1,0.24166666666666667
igh,0,0,0,0,0,1,0,1,0.24166666666666667
ray,0,0,0,0,0,1,0,1,0.24166666666666667
aw,0,0,0,0,0,1,0,1,0.24166666666666667
蒙特卡洛仿真,0,0,0,0,0,1,0,1,0.24166666666666667
jade盲源分离,0,0,0,0,0,1,0,1,0.24166666666666667
阶累积量,0,0,0,0,0,1,0,1,0.24166666666666667
感知混叠信号,0,0,0,0,0,1,0,1,0.24166666666666667
混叠信号模型,0,0,0,0,0,1,0,1,0.24166666666666667
ofdm符号长度,0,0,0,0,0,0,1,1,0.24166666666666667
频域高阶谱构造信号,0,0,0,0,0,0,1,1,0.24166666666666667
时域高阶累积量构造信号,0,0,0,0,0,0,1,1,0.24166666666666667
功率参数,0,0,0,0,0,0,1,1,0.24166666666666667
统计量,1,0,0,0,0,0,1,2,1.2416666666666667
11,0,0,0,0,0,0,1,1,0.24166666666666667
ieee802,0,0,0,0,0,0,1,1,0.24166666666666667
仿真验证,0,0,0,0,0,0,1,1,0.24166666666666667
单信号盲识别技,0,0,0,0,0,0,1,1,0.24166666666666667
无线移动通信网络,0,0,0,2,0,0,0,2,0.25
无线通信环境,0,0,0,1,0,0,0,1,0.125
边缘用户,0,0,0,1,0,0,0,1,0.125
多层覆盖,0,0,0,1,0,0,0,1,0.125
devicetodevice,0,0,0,1,0,0,0,1,0.125
直连通信,0,0,0,1,0,0,0,1,0.125
adhoc网络,0,0,0,1,0,0,0,1,0.125
无线局域网,0,0,0,1,0,0,0,1,0.125
增强覆盖,0,0,0,1,0,0,0,1,0.125
通信制式,0,0,0,1,0,0,0,1,0.125
基础覆盖,0,0,0,1,0,0,0,1,0.125
容量指数,0,0,0,1,0,0,0,1,0.125
无线网络架构,0,0,0,1,0,0,0,1,0.125
空口技术,0,0,0,1,0,0,0,1,0.125
移动数据流量,0,0,0,1,0,0,0,1,0.125
高通,0,0,0,1,0,0,0,1,0.125
移动互联网业务,0,0,0,1,0,0,0,1,0.125
智能终端,1,0,0,1,0,0,0,2,1.125
LTE-U,0,1,0,0,0,0,0,1,2.0
Wi-Fi,0,1,0,0,0,0,0,1,2.0
对角化算法,1,0,0,0,0,0,0,1,1.0
orthogonalfrequency,1,0,0,0,0,0,0,1,1.0
vision,1,0,0,0,0,0,0,1,1.0
multiplexing,1,0,0,0,0,0,0,1,1.0
调制技,1,0,0,0,0,0,0,1,1.0
eration,1,0,0,0,0,0,0,1,1.0
802.11,1,0,0,0,0,0,0,1,1.0
wi-fi标准,1,0,0,0,0,0,0,1,1.0
fastfouriertransformation,1,0,0,0,0,0,0,1,1.0
点数,1,0,0,0,0,0,0,1,1.0
科学,1,0,0,0,0,0,0,1,1.0
信号处理技术,1,0,0,0,0,0,0,1,1.0
动态无线环境,1,0,0,0,0,0,0,1,1.0
频谱压力,1,0,0,0,0,0,0,1,1.0
网络容量,1,0,0,0,0,0,0,1,1.0
