,摘要,关键词,第一章,第二章,第三章,第四章,第五章,总词频,加权得分
自然图像,0,0,6,38,6,8,0,58,8.883333333333333
高斯分布,0,0,0,6,0,0,0,6,0.75
非高斯性,0,0,0,4,0,0,0,4,0.5
非高斯模型,0,0,0,1,0,0,0,1,0.125
自然图像特性,0,0,0,1,0,0,0,1,0.125
高斯性特点,0,0,0,1,0,0,0,1,0.125
重拖尾,0,0,0,1,0,0,0,1,0.125
突峰值,0,0,0,1,0,0,0,1,0.125
小波系数,0,0,3,38,0,0,0,41,5.125
轮廓,0,0,1,5,5,0,0,11,1.9583333333333333
边缘,0,0,1,12,2,0,0,15,2.1083333333333334
图像,1,0,55,69,24,22,4,175,28.583333333333336
傅立叶反变换,0,0,0,1,0,0,0,1,0.125
白化,0,0,0,1,0,0,0,1,0.125
高斯白噪声,0,0,0,1,1,0,0,2,0.3666666666666667
sian模型,0,0,0,1,0,0,0,1,0.125
ga,0,0,0,1,0,0,0,1,0.125
平稳二阶性,0,0,0,1,0,0,0,1,0.125
随机过程,0,0,0,1,0,0,0,1,0.125
失真,1,0,24,31,15,15,5,91,16.333333333333336
失真类型,0,0,6,11,2,14,1,34,6.233333333333333
失真图像,0,0,17,11,0,6,1,35,5.191666666666666
性能,0,0,9,4,0,24,3,40,8.15
brisque,0,0,4,0,0,3,0,7,1.225
特征,0,0,9,8,4,3,2,26,4.3
质量评价,0,0,7,2,1,0,2,12,1.85
概率,0,0,4,1,0,2,1,8,1.35
统计特性,0,1,5,11,0,0,0,17,4.0
算法,0,0,5,1,0,11,2,19,3.8916666666666666
mvg模型,0,0,2,0,0,16,0,18,4.116666666666667
双层框架,0,0,2,0,0,0,0,2,0.25
无参考图像质量评价算法,2,0,6,9,2,2,0,21,4.841666666666667
尺度,0,0,3,22,7,0,0,32,4.816666666666666
qi,0,0,2,0,0,0,0,2,0.25
图像质量评价,1,0,24,7,0,1,3,36,5.841666666666667
视觉特性,1,0,4,0,3,0,0,8,2.225
自然场景,0,1,3,8,0,1,0,13,3.6166666666666667
图像统计模型,0,0,1,2,0,0,0,3,0.375
频域,0,0,1,3,0,0,0,4,0.5
空域,0,0,1,5,0,0,0,6,0.75
brisque算法,0,0,1,0,0,3,0,4,0.85
协方差矩阵,0,0,1,0,0,2,0,3,0.6083333333333334
均值,0,0,1,7,4,1,0,13,2.208333333333333
自然场景统计特征,0,0,3,3,2,3,1,12,2.2
质量评价分值,0,0,2,0,0,2,1,5,0.975
参数,0,0,2,1,1,6,0,10,2.0666666666666664
数学统计模型,0,0,1,0,0,0,0,1,0.125
18维图像特征,0,0,1,0,0,0,0,1,0.125
niqe,0,0,1,0,0,0,0,1,0.125
que,0,0,1,0,0,0,0,1,0.125
br,0,0,1,0,0,0,0,1,0.125
ssim算法,0,0,7,0,0,0,0,7,0.875
参考评价,0,0,1,0,0,0,0,1,0.125
无参考评价算法,0,0,2,0,0,0,0,2,0.25
提取特征,0,0,1,0,1,0,0,2,0.3666666666666667
多尺度,0,0,2,0,0,0,0,2,0.25
方向信息,0,0,1,0,3,0,0,4,0.85
标准化亮度,0,0,1,0,0,0,0,1,0.125
失真程度,0,0,4,4,1,3,0,12,1.9666666666666668
距离,0,0,1,1,0,2,0,4,0.7333333333333334
自然图像模型,0,0,1,0,0,1,0,2,0.3666666666666667
标准化亮度信号,0,0,1,0,0,0,0,1,0.125
测试集,0,0,1,0,0,0,0,1,0.125
本质特征,0,0,1,0,0,0,0,1,0.125
型算法,0,0,1,0,0,0,0,1,0.125
提取,0,0,1,2,1,1,0,5,0.8583333333333334
小波变换,0,0,2,7,5,0,0,14,2.333333333333333
daubechies,0,0,1,0,0,0,0,1,0.125
广义高斯模型,0,0,1,0,1,0,0,2,0.3666666666666667
ggd,0,0,1,4,0,0,0,5,0.625
小波子带系数,0,0,1,0,0,0,0,1,0.125
小波分解,0,0,2,8,0,0,0,10,1.25
计算框架,0,0,1,0,0,0,0,1,0.125
brisque1281,0,0,1,0,0,0,0,1,0.125
in,0,0,1,0,0,0,0,1,0.125
人眼,1,0,10,1,1,0,0,13,2.6166666666666667
特性,0,0,2,5,1,1,0,9,1.3583333333333334
曲线,0,0,1,3,8,2,0,14,2.9166666666666665
高频分量,0,0,0,0,8,0,0,8,1.9333333333333333
contourlet系数,0,0,1,3,6,0,0,10,1.95
模糊失真,0,0,0,1,1,1,0,3,0.6083333333333334
尖峰,0,0,0,0,1,0,0,1,0.24166666666666667
高频,0,0,0,2,1,0,0,3,0.4916666666666667
加性高斯白噪声,0,0,0,0,1,0,0,1,0.24166666666666667
非高斯特征,0,0,0,0,1,0,0,1,0.24166666666666667
图像纹理,0,0,0,0,1,0,0,1,0.24166666666666667
长尾分布,0,0,0,0,1,0,0,1,0.24166666666666667
尺度参数,0,0,0,0,1,0,0,1,0.24166666666666667
扩展长度,0,0,0,0,1,0,0,1,0.24166666666666667
a控制分布,0,0,0,0,1,0,0,1,0.24166666666666667
ze,0,0,0,0,1,0,0,1,0.24166666666666667
asymmetricgenera,0,0,0,0,1,0,0,1,0.24166666666666667
aggd,0,0,0,1,1,0,0,2,0.3666666666666667
非对称型,0,0,0,0,1,0,0,1,0.24166666666666667
稀疏性,0,0,0,0,1,0,0,1,0.24166666666666667
contourlet变换,1,0,2,5,8,0,0,16,3.8083333333333336
零值,0,0,0,0,1,0,0,1,0.24166666666666667
幅值,0,0,0,0,1,0,0,1,0.24166666666666667
非高斯特性,0,0,0,2,1,0,0,3,0.4916666666666667
拖尾,0,0,0,0,1,0,0,1,0.24166666666666667
幅度值,0,0,0,1,1,0,0,2,0.3666666666666667
曲线图,0,0,0,0,1,0,0,1,0.24166666666666667
子带,0,0,8,18,6,0,0,32,4.7
概率密度曲线,0,0,0,0,1,0,0,1,0.24166666666666667
幅度,0,0,0,5,2,0,0,7,1.1083333333333334
噪声,0,0,0,0,1,1,0,2,0.48333333333333334
系数,0,0,0,9,3,0,0,12,1.85
模糊,0,0,0,2,3,1,0,6,1.2166666666666668
图像降质,0,0,0,0,1,0,0,1,0.24166666666666667
数幅值分布特征,0,0,0,0,1,0,0,1,0.24166666666666667
contouriet域,0,0,0,0,2,1,0,3,0.725
原始图像,0,0,6,1,1,2,0,10,1.6
图像质量评价算法,4,0,25,2,1,1,0,33,7.858333333333333
图像特征,0,0,6,4,0,4,0,14,2.216666666666667
信道,0,0,2,0,0,0,0,2,0.25
辅助通道,0,0,2,0,0,0,0,2,0.25
数字水印,0,0,3,0,0,0,0,3,0.375
wavelet域统计模型,0,0,1,0,0,0,0,1,0.125
主观,0,0,1,0,0,0,0,1,0.125
传输信道,0,0,1,0,0,0,0,1,0.125
性能准确度,0,0,1,0,0,0,0,1,0.125
半参考特征,0,0,1,0,0,0,0,1,0.125
图像质量评价性能,0,0,1,0,0,0,0,1,0.125
传输量,0,0,1,0,0,0,0,1,0.125
度量,0,0,2,0,0,0,0,2,0.25
失真图像特征,0,0,1,0,0,0,0,1,0.125
接收端,0,0,1,0,0,0,0,1,0.125
图像传输系统,0,0,1,0,0,0,0,1,0.125
关键信息,0,0,2,1,0,0,0,3,0.375
原始图像信息,0,0,1,0,0,0,0,1,0.125
质量评价算法,0,0,2,2,0,2,0,6,0.9833333333333334
机器学习,0,0,4,3,0,0,0,7,0.875
视觉码本,0,0,2,0,0,0,0,2,0.25
相位,0,0,3,0,0,0,0,3,0.375
grnn神经网络,0,0,2,0,0,0,0,2,0.25
无失真图像,0,0,2,3,0,0,0,5,0.625
聚类,0,0,2,0,0,0,0,2,0.25
图像质量,1,0,23,6,2,3,1,36,6.075
神经网络,0,0,2,0,0,0,0,2,0.25
码本,0,0,2,0,0,0,0,2,0.25
评价模型,0,0,2,0,0,0,0,2,0.25
图像信息,0,0,4,2,0,0,0,6,0.75
无参考型质量评价,0,0,1,0,0,0,0,1,0.125
svr回归模型,0,0,1,0,0,0,0,1,0.125
非线性特征,0,0,1,0,0,0,0,1,0.125
质量,0,0,5,7,0,1,0,13,1.7416666666666667
编码,0,0,1,0,0,0,0,1,0.125
soft-assignment,0,0,1,0,0,0,0,1,0.125
构建码本,0,0,1,0,0,0,0,1,0.125
k-means算法,0,0,1,0,0,0,0,1,0.125
预处理,0,0,3,0,0,0,0,3,0.375
旋转,0,0,1,0,0,0,0,1,0.125
亮度,0,0,7,0,0,0,0,7,0.875
视觉识别,0,0,1,0,0,0,0,1,0.125
纹理分析,0,0,1,0,0,0,0,1,0.125
codebook,0,0,1,0,0,0,0,1,0.125
失真图片梯度,0,0,1,0,0,0,0,1,0.125
无参考质量评价,0,0,1,0,0,0,0,1,0.125
期望,0,0,1,0,0,0,0,1,0.125
特征向量,0,0,1,2,1,7,0,11,2.3083333333333336
视觉词,0,0,1,0,0,0,0,1,0.125
聚类算法,0,0,1,0,0,0,0,1,0.125
k-means,0,0,1,0,0,0,0,1,0.125
图像块,0,0,5,2,0,24,0,31,6.675
重叠块,0,0,1,0,0,0,0,1,0.125
lsa,0,0,1,0,0,0,0,1,0.125
plsa,0,0,1,0,0,0,0,1,0.125
文本,0,0,1,0,0,0,1,2,0.3666666666666667
plsa算法,0,0,1,0,0,0,0,1,0.125
图像视觉主题概率模型,0,0,1,0,0,0,0,1,0.125
模型,0,0,2,0,1,2,0,5,0.975
文本主题模型,0,0,1,0,0,0,0,1,0.125
有效图像特征,0,0,1,0,0,0,0,1,0.125
图像评价质量,0,0,1,0,0,0,0,1,0.125
频率,0,0,7,1,0,0,0,8,1.0
多通道特性,0,0,5,0,0,0,0,5,0.625
掩盖效应,0,0,5,0,0,0,0,5,0.625
空间频率,0,0,4,0,0,0,0,4,0.5
视觉注意机制,0,0,4,0,0,0,0,4,0.5
hvs模型,0,0,4,0,0,0,0,4,0.5
hvs特性,0,0,4,0,1,0,0,5,0.7416666666666667
人类视觉系统,0,0,4,2,0,0,0,6,0.75
信息,1,0,9,3,1,0,3,17,3.466666666666667
信号,0,0,4,8,0,0,0,12,1.5
亮度非线性,0,0,3,0,0,0,0,3,0.375
人眼视觉特性,1,0,4,1,0,1,0,7,1.8666666666666667
生理学,0,0,4,0,0,0,0,4,0.5
激励,0,0,2,0,0,0,0,2,0.25
csf,0,0,2,0,0,0,0,2,0.25
对比度,0,0,4,1,0,0,0,5,0.625
通道,0,0,2,0,0,0,0,2,0.25
多通道分解,0,0,2,0,0,0,0,2,0.25
psnr,0,0,7,0,0,4,0,11,1.8416666666666668
误差,0,0,2,0,0,0,0,2,0.25
心理学,0,0,3,0,0,0,0,3,0.375
hvs,0,0,4,1,0,0,0,5,0.625
纯数学计算,0,0,1,0,0,0,0,1,0.125
加工处理,0,0,1,0,0,0,0,1,0.125
神经中枢,0,0,1,0,0,0,0,1,0.125
眼球,0,0,1,0,0,0,0,1,0.125
效率,0,0,1,2,0,0,0,3,0.375
获取信息,0,0,1,0,0,0,0,1,0.125
心理,0,0,1,0,0,0,0,1,0.125
平坦,0,0,1,0,0,0,0,1,0.125
图像纹理区域,0,0,1,0,0,0,0,1,0.125
对比掩盖因子,0,0,1,0,0,0,0,1,0.125
灵敏度阈值,0,0,1,0,0,0,0,1,0.125
watson模型,0,0,1,0,0,0,0,1,0.125
可见阈值,0,0,1,0,0,0,0,1,0.125
激励组合,0,0,1,0,0,0,0,1,0.125
视觉感受,0,0,2,0,0,0,0,2,0.25
人眼观察效果,0,0,1,0,0,0,0,1,0.125
垂直,0,0,1,0,0,0,0,1,0.125
水平,0,0,1,1,0,0,0,2,0.25
表达式,0,0,1,0,0,0,0,1,0.125
带通特性,0,0,1,0,0,0,0,1,0.125
线性,0,0,1,2,0,0,0,3,0.375
空域频率,0,0,1,0,0,0,0,1,0.125
敏感度,0,0,2,0,0,0,0,2,0.25
csf特性曲线,0,0,1,0,0,0,0,1,0.125
纵坐标,0,0,1,2,0,3,0,6,1.1
横坐标,0,0,1,2,0,0,0,3,0.375
时间频率,0,0,1,0,0,0,0,1,0.125
trastsensitivityfunction,0,0,1,0,0,0,0,1,0.125
对比度灵敏度函数,0,0,1,0,0,0,0,1,0.125
视觉感觉,0,0,1,0,0,0,0,1,0.125
直线,0,0,1,5,0,0,0,6,0.75
tic,0,0,1,0,0,0,0,1,0.125
just,0,0,1,0,0,0,0,1,0.125
感知亮度阈值,0,0,1,0,0,0,0,1,0.125
亮度差异,0,0,1,0,0,0,0,1,0.125
光强度量级,0,0,1,0,0,0,0,1,0.125
视觉接收,0,0,1,0,0,0,0,1,0.125
非线性,0,0,1,1,0,0,0,2,0.25
亮度值,0,0,2,0,0,0,0,2,0.25
敏感,0,0,1,0,0,0,0,1,0.125
contourlet,1,0,1,5,2,1,1,11,2.716666666666667
cortex变换,0,0,1,0,0,0,0,1,0.125
二维gabor变换,0,0,1,0,0,0,0,1,0.125
wavelet变换,0,0,1,0,0,0,0,1,0.125
dct变换,0,0,1,0,0,0,0,1,0.125
变换,0,0,1,1,1,0,0,3,0.4916666666666667
频域变换,0,0,1,0,0,0,0,1,0.125
对角线,0,0,1,0,1,0,0,2,0.3666666666666667
对角方,0,0,1,0,0,0,0,1,0.125
水平方向,0,0,1,0,0,0,0,1,0.125
垂直方向,0,0,1,0,0,0,0,1,0.125
各向异性,0,0,1,2,1,0,0,4,0.6166666666666667
视觉通道,0,0,1,0,0,0,0,1,0.125
视觉信号,0,0,1,2,0,0,0,3,0.375
颜色,0,0,1,0,0,0,0,1,0.125
视觉心理学,0,0,1,0,0,0,0,1,0.125
多通道,0,0,1,0,0,0,0,1,0.125
透视效应,0,0,1,0,0,0,0,1,0.125
视觉注意效应,0,0,1,0,0,0,0,1,0.125
科学试验,0,0,1,0,0,0,0,1,0.125
心理特性,0,0,1,0,0,0,0,1,0.125
视觉,0,0,1,1,1,0,0,3,0.4916666666666667
数学模型,0,0,1,0,0,0,0,1,0.125
光学系统,0,0,1,0,0,0,0,1,0.125
大脑神经,0,0,1,1,0,0,0,2,0.25
视觉活动,0,0,1,0,0,0,0,1,0.125
计算量,0,0,1,0,0,0,0,1,0.125
加权过程,0,0,1,0,0,0,0,1,0.125
误差加权,0,0,1,0,0,0,0,1,0.125
掩盖效应失真图像,0,0,1,0,0,0,0,1,0.125
加权,0,0,1,0,0,0,0,1,0.125
灵敏度,0,0,1,0,0,0,0,1,0.125
人眼特性,0,0,1,0,0,0,0,1,0.125
图像质量算法,0,0,1,0,0,0,0,1,0.125
视觉系统,0,0,1,2,0,0,0,3,0.375
误差统计,0,0,1,0,0,0,0,1,0.125
评价算法,0,0,2,0,0,0,0,2,0.25
图像像素,0,0,1,0,0,0,0,1,0.125
主观视觉感受,0,0,2,0,0,0,0,2,0.25
末端接收方,0,0,1,0,0,0,0,1,0.125
图像失真,1,0,3,8,1,0,0,13,2.6166666666666667
传输,0,0,2,0,0,0,0,2,0.25
压缩,0,0,1,1,0,0,0,2,0.25
客观评价算法,0,0,1,0,0,0,0,1,0.125
图像客观评价算法,0,0,1,0,0,0,0,1,0.125
复杂系统,0,0,1,0,0,0,0,1,0.125
视觉信息处理系统,0,0,1,0,0,0,0,1,0.125
自然场景统,0,0,1,1,0,0,0,2,0.25
先验信息,0,0,1,0,0,0,0,1,0.125
盲评价,0,0,1,0,0,0,0,1,0.125
无参考评价,0,0,1,0,0,0,0,1,0.125
客观质量评价,0,0,4,1,0,2,0,7,1.1083333333333334
参考图像,1,0,1,0,0,0,0,2,1.125
半参考,0,0,1,0,0,0,0,1,0.125
全参考,0,0,1,0,0,0,0,1,0.125
单调性,0,0,0,0,0,3,0,3,0.725
测试图像集,0,0,0,0,0,3,0,3,0.725
训练图像集,0,0,0,0,0,3,0,3,0.725
图像数据库,0,0,0,0,0,2,0,2,0.48333333333333334
算法性能,0,0,2,0,0,14,0,16,3.6333333333333333
srocc,0,0,0,0,0,11,0,11,2.658333333333333
性能评估参数,0,0,0,0,0,2,0,2,0.48333333333333334
线性相关性,0,0,0,0,0,2,0,2,0.48333333333333334
plcc,0,0,0,0,0,11,0,11,2.658333333333333
dmos分值,0,0,0,0,0,2,0,2,0.48333333333333334
中位值,0,0,0,0,0,1,0,1,0.24166666666666667
别重复试验,0,0,0,0,0,1,0,1,0.24166666666666667
性能评估,0,0,0,0,0,1,0,1,0.24166666666666667
对照算法,0,0,0,0,0,1,0,1,0.24166666666666667
内容相关性,0,0,0,0,0,1,0,1,0.24166666666666667
live试验库,0,0,0,0,0,1,0,1,0.24166666666666667
图像质量评价算,0,0,0,0,0,3,0,3,0.725
随机交叉验证,0,0,0,0,0,1,0,1,0.24166666666666667
数据库,0,0,0,1,0,2,0,3,0.6083333333333334
偶然因素,0,0,0,0,0,1,0,1,0.24166666666666667
随机,0,0,0,0,0,1,0,1,0.24166666666666667
客观分值,0,0,0,0,0,1,0,1,0.24166666666666667
次序,0,0,0,0,0,1,0,1,0.24166666666666667
变量,0,0,0,0,0,1,0,1,0.24166666666666667
rmse,0,0,0,0,0,3,0,3,0.725
均方根误差,0,0,0,0,0,3,0,3,0.725
等级次序,0,0,0,0,0,1,0,1,0.24166666666666667
speannan,0,0,0,0,0,1,0,1,0.24166666666666667
客观质量分值,0,0,0,1,0,1,0,2,0.3666666666666667
客观评分,0,0,1,0,0,1,0,2,0.3666666666666667
axlogistic,0,0,0,0,0,1,0,1,0.24166666666666667
qmos,0,0,0,0,0,1,0,1,0.24166666666666667
主观拟合函数,0,0,0,0,0,1,0,1,0.24166666666666667
主观质量评价,0,0,1,0,0,1,0,2,0.3666666666666667
客观图像质量评价模型,0,0,0,0,0,1,0,1,0.24166666666666667
质量评分,0,0,0,0,0,1,0,1,0.24166666666666667
评分,0,0,0,1,0,1,1,3,0.6083333333333334
毫无失真,0,0,0,0,0,1,0,1,0.24166666666666667
快速衰落失真图像,0,0,0,0,0,1,0,1,0.24166666666666667
高斯模糊失真图像,0,0,0,0,1,1,0,2,0.48333333333333334
白噪声失真图像,0,0,0,1,1,1,0,3,0.6083333333333334
jpeg压缩失真图像,0,0,0,0,0,1,0,1,0.24166666666666667
压缩失真图像,0,0,0,0,1,1,0,2,0.48333333333333334
jpeg2000,0,0,0,5,2,2,0,9,1.5916666666666668
失真类,0,0,0,3,1,7,0,11,2.3083333333333336
无失真,0,0,1,2,0,3,0,6,1.1
live图像库,0,0,0,1,0,2,0,3,0.6083333333333334
引盲,0,0,0,0,0,1,0,1,0.24166666666666667
测试图像,0,0,0,1,0,10,0,11,2.5416666666666665
自然图像库,0,0,0,0,0,7,0,7,1.6916666666666667
contourlet域,2,0,3,3,4,9,1,22,6.133333333333333
量度,0,0,0,0,0,2,0,2,0.48333333333333334
自然图像特征,1,0,0,6,0,3,3,13,3.2
mvg,0,0,0,0,0,2,0,2,0.48333333333333334
无参考图像质量评价,0,1,2,2,1,2,2,10,3.708333333333333
计算模型,0,0,1,0,0,1,0,2,0.3666666666666667
自然图像块,0,0,0,0,0,1,0,1,0.24166666666666667
特征提取,0,0,1,0,0,1,1,3,0.6083333333333334
全局,1,0,0,0,0,1,0,2,1.2416666666666667
均值向量,0,0,0,0,0,1,0,1,0.24166666666666667
图像距离,0,0,0,0,0,1,0,1,0.24166666666666667
全局框架算法,0,0,0,0,0,4,0,4,0.9666666666666667
复杂度,0,0,1,0,0,6,0,7,1.575
偏离程度,0,0,0,1,0,1,0,2,0.3666666666666667
量化,0,0,0,2,0,1,0,3,0.4916666666666667
统计特征,0,0,0,0,3,1,0,4,0.9666666666666667
无重叠图像块,0,0,0,0,0,1,0,1,0.24166666666666667
似然估计,0,0,0,0,0,1,0,1,0.24166666666666667
引用,0,0,0,0,0,1,0,1,0.24166666666666667
建模,0,0,0,0,0,1,0,1,0.24166666666666667
概率密度函数,0,0,0,2,0,1,0,3,0.4916666666666667
multivariategaus,0,0,0,0,0,1,0,1,0.24166666666666667
客观质量评价算法,0,0,3,0,0,0,0,3,0.375
评价,0,0,4,0,0,0,0,4,0.5
主观评价,0,0,2,0,0,0,0,2,0.25
图像处理,0,0,3,2,0,0,0,5,0.625
数字信息,0,0,2,0,0,0,0,2,0.25
无参考图像质量评价模型,0,0,1,0,0,0,0,1,0.125
参考型,0,0,1,0,0,0,0,1,0.125
无参考,1,0,4,0,0,0,0,5,1.5
客观质量,0,0,2,1,0,2,0,5,0.8583333333333334
始图像,0,0,1,3,0,0,0,4,0.5
传输带宽,0,0,2,0,0,0,0,2,0.25
网络传输,0,0,1,0,0,0,0,1,0.125
半参,0,0,2,0,0,0,0,2,0.25
原始信息,0,0,1,0,0,0,0,1,0.125
先验,0,0,1,0,0,0,0,1,0.125
半参考图像质量评价,0,0,1,0,0,0,0,1,0.125
参考,0,0,1,0,0,0,0,1,0.125
人眼视觉系统,0,0,1,0,0,0,0,1,0.125
视觉信息,0,0,4,2,0,0,2,8,1.2333333333333334
mos值,0,0,1,0,0,0,0,1,0.125
人眼评分,0,0,1,0,0,0,0,1,0.125
图像客观质量评价,0,0,1,0,0,0,0,1,0.125
工程,0,0,1,0,0,0,0,1,0.125
数学,0,0,1,1,0,0,0,2,0.25
人工,0,0,1,0,0,0,0,1,0.125
客观图像质量评价,0,0,1,0,0,0,0,1,0.125
meanopinionscore,0,0,1,0,0,0,0,1,0.125
mos,0,0,1,0,0,0,0,1,0.125
主观质量评分法,0,0,1,0,0,0,0,1,0.125
客观评价方,0,0,1,0,0,0,0,1,0.125
图像信息处理,0,0,1,0,0,0,0,1,0.125
传输图像质量,0,0,1,0,0,0,0,1,0.125
带宽,0,0,1,0,0,0,0,1,0.125
网络,0,0,1,0,0,0,1,2,0.3666666666666667
数字视频服务,0,0,1,0,0,0,0,1,0.125
动调节系统,0,0,1,0,0,0,0,1,0.125
安全监控,0,0,1,0,0,0,0,1,0.125
系统,0,0,1,0,0,0,0,1,0.125
数字图像系统,0,0,1,0,0,0,0,1,0.125
视觉感知,1,0,3,2,0,1,0,7,1.8666666666666667
信息的失真,0,0,1,0,0,0,0,1,0.125
信息传输,0,0,1,0,0,0,0,1,0.125
信息存储,0,0,1,0,0,0,0,1,0.125
信息显示,0,0,1,0,0,0,0,1,0.125
承载信息,0,0,1,0,0,0,0,1,0.125
互联网信息,0,0,1,0,0,0,0,1,0.125
信息源,0,0,1,0,0,0,0,1,0.125
机器识别,0,0,1,0,0,0,0,1,0.125
信息科学,0,0,1,0,0,0,0,1,0.125
框架,0,0,0,0,0,1,2,3,0.725
无参考质量评价算法,0,0,0,0,0,0,2,2,0.48333333333333334
视频,1,0,1,0,0,0,2,4,1.6083333333333334
全局框架,0,0,1,1,0,1,1,4,0.7333333333333334
图像视觉感知质量,0,0,0,0,0,0,1,1,0.24166666666666667
快速衰落失真,0,0,0,1,0,0,1,2,0.3666666666666667
svr,0,0,0,0,0,3,1,4,0.9666666666666667
先特征,0,0,0,0,0,0,1,1,0.24166666666666667
22维特征,0,0,0,0,0,0,1,1,0.24166666666666667
纹理区域,0,0,1,3,7,1,1,13,2.675
能量分布特征,0,0,0,1,1,0,1,3,0.6083333333333334
方向,0,0,0,3,0,0,1,4,0.6166666666666667
分布特征,0,0,0,0,0,0,1,1,0.24166666666666667
contourletnss,0,0,0,0,0,0,1,1,0.24166666666666667
中间,0,0,0,0,0,0,1,1,0.24166666666666667
低级特征,0,0,0,1,1,0,1,3,0.6083333333333334
像素级别,0,0,0,0,0,0,1,1,0.24166666666666667
contouriet系数,0,0,0,1,0,0,1,2,0.3666666666666667
自然图像统计特性,1,0,0,1,1,1,1,5,1.85
通用型,2,0,1,3,0,1,1,8,2.9833333333333334
参考图像质量评价,0,0,0,0,0,0,1,1,0.24166666666666667
客观,0,0,0,0,0,0,1,1,0.24166666666666667
体验质量,0,0,0,0,0,0,1,1,0.24166666666666667
终端用户,0,0,0,0,0,0,1,1,0.24166666666666667
大数据时代,0,0,0,0,0,0,1,1,0.24166666666666667
移动互联网,0,0,0,0,0,0,1,1,0.24166666666666667
能量分布,0,0,0,1,4,0,0,5,1.0916666666666668
能量值,0,0,0,2,2,0,0,4,0.7333333333333334
能量幅度,0,0,0,0,2,0,0,2,0.48333333333333334
白噪声,0,0,0,2,2,0,0,4,0.7333333333333334
os,0,0,0,0,2,0,0,2,0.48333333333333334
噪声图像,0,0,0,0,2,0,0,2,0.48333333333333334
dmos,0,0,0,0,2,0,0,2,0.48333333333333334
能量特征,0,0,0,0,1,0,0,1,0.24166666666666667
标准差,0,0,0,1,1,0,0,2,0.3666666666666667
方向能量,0,0,0,2,1,0,0,3,0.4916666666666667
直方图,0,0,0,6,1,0,0,7,0.9916666666666667
能量幅度值,0,0,0,0,1,0,0,1,0.24166666666666667
tourlet,0,0,0,0,1,0,0,1,0.24166666666666667
主能量,0,0,0,0,1,0,0,1,0.24166666666666667
模糊图像,0,0,1,1,1,0,0,3,0.4916666666666667
方向矩阵,0,0,0,0,1,0,0,1,0.24166666666666667
平均值,0,0,0,0,1,0,0,1,0.24166666666666667
能量,0,0,0,4,1,0,0,5,0.7416666666666667
方向系数,0,0,0,0,1,0,0,1,0.24166666666666667
子带标记序号,0,0,0,0,1,0,0,1,0.24166666666666667
图像子带,0,0,0,0,1,0,0,1,0.24166666666666667
dfb分解,0,0,0,0,3,0,0,3,0.725
lp尺度分解,0,0,0,0,2,0,0,2,0.48333333333333334
分辨率,1,0,1,5,1,0,0,8,1.9916666666666667
性能指标,0,0,1,0,0,1,0,2,0.3666666666666667
监控系统,0,0,1,0,0,0,0,1,0.125
互联网,0,0,1,0,0,0,0,1,0.125
无参考算法,0,0,1,1,0,3,0,5,0.975
全参考算法,0,0,1,0,0,2,0,3,0.6083333333333334
wavelet域,0,0,1,4,0,0,0,5,0.625
视觉感知系数,0,0,1,0,0,0,0,1,0.125
vs,0,0,1,0,0,0,0,1,0.125
边缘概率分布,0,0,1,6,0,0,0,7,0.875
wavelet域特征,0,0,1,0,0,0,0,1,0.125
视觉主观感受,0,0,1,0,0,0,0,1,0.125
统计量度,0,0,1,0,0,0,0,1,0.125
视觉敏感系数,0,0,1,0,0,0,0,1,0.125
归一化系数,0,0,1,0,0,0,0,1,0.125
受损图像,0,0,1,0,0,0,0,1,0.125
iblerdivergence,0,0,1,0,0,0,0,1,0.125
back-,0,0,1,0,0,0,0,1,0.125
k-l散度,0,0,1,0,0,0,0,1,0.125
gaussiandensity,0,0,1,0,0,0,0,1,0.125
generalized,0,0,1,1,0,0,0,2,0.25
广义高斯密度,0,0,1,0,0,0,0,1,0.125
子带系数,0,0,1,3,0,0,0,4,0.5
自然图像统计模型,0,0,1,0,0,0,0,1,0.125
小波域,0,0,1,7,0,0,0,8,1.0
vqeg,0,0,4,0,0,0,0,4,0.5
半参考评价算法,0,0,1,0,0,0,0,1,0.125
全参考评价算法,0,0,1,0,0,0,0,1,0.125
图像质量评价体系,0,0,1,0,0,0,0,1,0.125
客观视频质量评价算法,0,0,1,0,0,0,0,1,0.125
图像视频质量,0,0,1,0,0,0,0,1,0.125
客观视频质量评价模型,0,0,1,0,0,0,0,1,0.125
验室,0,0,1,0,0,0,0,1,0.125
视频工程,0,0,1,0,0,0,0,1,0.125
图像与,0,0,1,0,0,0,0,1,0.125
视频质量,0,0,1,0,0,0,0,1,0.125
电信联盟,0,0,1,0,0,0,0,1,0.125
paramater,0,0,0,9,0,0,0,9,1.125
shape-,0,0,0,9,0,0,0,9,1.125
su,0,0,0,5,0,0,0,5,0.625
对数均值统计特性,0,0,0,4,0,0,0,4,0.5
权重,0,0,0,3,0,0,0,3,0.375
尺度子带,0,0,0,5,0,0,0,5,0.625
对数,0,0,0,3,0,0,0,3,0.375
形状参数,0,0,0,3,0,0,0,3,0.375
大尺度子带系数,0,0,0,3,0,0,0,3,0.375
对数均值,0,0,0,3,0,0,0,3,0.375
对数域,0,0,0,9,1,0,0,10,1.3666666666666667
子带质量,0,0,0,2,0,0,0,2,0.25
尺度序数,0,0,0,2,0,0,0,2,0.25
偏移量,0,0,0,4,0,0,0,4,0.5
最小尺度子带,0,0,0,2,0,0,0,2,0.25
jpeg失真,0,0,0,2,0,0,0,2,0.25
大尺度子带,0,0,0,2,0,0,0,2,0.25
线性递减,0,0,0,3,0,0,0,3,0.375
可视性,0,0,0,2,0,0,0,2,0.25
频段,0,0,0,2,0,0,0,2,0.25
低通滤波,0,0,0,2,1,0,0,3,0.4916666666666667
粗糙,0,0,0,2,0,0,0,2,0.25
无监督训练,0,0,0,1,0,0,0,1,0.125
分数,0,0,0,1,0,0,0,1,0.125
大尺度,0,0,0,1,0,0,0,1,0.125
未失真图像,0,0,0,1,0,0,0,1,0.125
失真图像质量,0,0,0,2,0,2,0,4,0.7333333333333334
数均值特性,0,0,0,1,0,0,0,1,0.125
训练集,0,0,0,1,0,0,0,1,0.125
直线预测,0,0,0,1,0,0,0,1,0.125
偏差,0,0,0,1,0,0,0,1,0.125
线性变,0,0,0,1,0,0,0,1,0.125
wavelet,0,0,1,1,0,0,0,2,0.25
dmos值,0,0,0,1,0,3,0,4,0.85
权重系数,0,0,0,1,0,0,0,1,0.125
大尺度子带序号,0,0,0,1,0,0,0,1,0.125
iog,0,0,0,1,0,0,0,1,0.125
预测值,0,0,0,1,0,0,0,1,0.125
大尺度子带对数,0,0,0,1,0,0,0,1,0.125
截距,0,0,0,1,0,0,0,1,0.125
直线斜率,0,0,0,1,0,0,0,1,0.125
个子带,0,0,0,1,0,0,0,1,0.125
近似斜率,0,0,0,2,0,0,0,2,0.25
小尺度子带,0,0,0,1,0,0,0,1,0.125
斜率,0,0,0,2,0,0,0,2,0.25
自然图像质量评价,0,0,1,1,0,0,0,2,0.25
无参考型,0,0,0,1,0,0,0,1,0.125
高斯平稳性,0,0,0,1,0,0,0,1,0.125
白噪声信号,0,0,0,1,0,0,0,1,0.125
概率分布,0,0,0,1,0,0,0,1,0.125
取子带,0,0,0,1,0,0,0,1,0.125
图像白噪声,0,0,0,1,0,0,0,1,0.125
模型参数,0,0,0,1,0,0,0,1,0.125
paramatero,0,0,0,1,0,0,0,1,0.125
ce,0,0,0,1,0,0,0,1,0.125
水平子带,0,0,0,1,0,0,0,1,0.125
边缘分布,0,0,0,3,0,0,0,3,0.375
垫套,0,0,0,1,0,0,0,1,0.125
边缘柢率分布,0,0,0,1,0,0,0,1,0.125
小波系,0,0,0,1,0,0,0,1,0.125
shap,0,0,0,1,0,0,0,1,0.125
shape-paramater,0,0,0,1,0,0,0,1,0.125
parainater,0,0,0,1,0,0,0,1,0.125
shape,0,0,0,1,0,0,0,1,0.125
eriance,0,0,0,1,0,0,0,1,0.125
velet,0,0,0,1,0,0,0,1,0.125
and,0,0,0,1,0,0,0,1,0.125
分布函数,0,0,0,1,0,0,0,1,0.125
拉普拉斯分布,0,0,0,1,0,0,0,1,0.125
形状,0,0,0,1,0,0,0,1,0.125
控制分布,0,0,0,1,0,0,0,1,0.125
gaussia,0,0,0,1,0,0,0,1,0.125
lu,0,0,0,1,0,0,0,1,0.125
日蜀,0,0,0,1,0,0,0,1,0.125
負躍,0,0,0,1,0,0,0,1,0.125
高频子带,0,0,0,1,0,0,0,1,0.125
细节信息,0,0,0,1,0,0,0,1,0.125
伪结构,0,0,0,1,0,0,0,1,0.125
块效应,0,0,0,1,0,0,0,1,0.125
畸变,0,0,0,1,0,0,0,1,0.125
细节分量,0,0,0,1,0,0,0,1,0.125
噪点,0,0,0,1,0,0,0,1,0.125
白噪声污染,0,0,0,1,0,0,0,1,0.125
小波系数幅值,0,0,0,1,0,0,0,1,0.125
平坦区域,0,0,0,1,0,0,0,1,0.125
边缘信息,0,0,0,1,1,0,0,2,0.3666666666666667
压缩失真,0,0,0,2,0,1,0,3,0.4916666666666667
高斯模糊,0,0,0,1,1,0,0,2,0.3666666666666667
jpeg压缩失真,0,0,0,2,0,5,0,7,1.4583333333333333
近似直线,0,0,0,1,0,0,0,1,0.125
红线,0,0,0,1,0,0,0,1,0.125
计特性,0,0,0,2,0,0,0,2,0.25
对数均值特性,0,0,0,1,0,0,0,1,0.125
子带编号,0,0,0,1,0,0,0,1,0.125
四级小波变换,0,0,0,1,0,0,0,1,0.125
图像小波变换,0,0,0,1,0,0,0,1,0.125
细节系数,0,0,0,1,0,0,0,1,0.125
两级小波分解,0,0,0,1,0,0,0,1,0.125
对角频率分量,0,0,0,1,0,0,0,1,0.125
垂直频率分量,0,0,0,1,0,0,0,1,0.125
水平频率分量,0,0,0,1,0,0,0,1,0.125
近似,0,0,0,1,0,0,0,1,0.125
下采样,0,0,0,1,0,0,0,1,0.125
低频,0,0,0,2,0,0,0,2,0.25
子信号,0,0,0,1,0,0,0,1,0.125
细节部,0,0,0,1,0,0,0,1,0.125
粗糙部分信号,0,0,0,1,0,0,0,1,0.125
高空间频率,0,0,0,1,0,0,0,1,0.125
低空间频率,0,0,0,1,0,0,0,1,0.125
细节,0,0,0,1,0,0,0,1,0.125
离散小波变换函数,0,0,0,1,0,0,0,1,0.125
滤波系数,0,0,0,1,0,0,0,1,0.125
滤波器,0,0,0,1,0,0,0,1,0.125
门限,0,0,0,4,0,0,0,4,0.5
互信息,0,0,1,2,0,0,0,3,0.375
频率分布,0,0,0,3,0,0,0,3,0.375
高维奇异性,0,0,0,6,1,0,0,7,0.9916666666666667
实验库,0,0,0,1,1,0,0,2,0.3666666666666667
图像质量评,0,0,0,1,0,0,0,1,0.125
wn,0,0,0,1,0,0,0,1,0.125
零点,0,0,0,1,0,0,0,1,0.125
量化失真,0,0,0,2,0,0,0,2,0.25
子带内系数,0,0,0,1,0,0,0,1,0.125
门限值,0,0,0,1,0,0,0,1,0.125
联合,0,0,0,1,0,0,0,1,0.125
联合分布图,0,0,0,1,0,0,0,1,0.125
统计模型,0,0,0,1,0,0,0,1,0.125
图像质量评价模型,0,0,0,1,0,0,0,1,0.125
自然场景统计特性,1,0,3,10,2,0,0,16,3.1083333333333334
依赖关,0,0,0,1,0,0,0,1,0.125
空间,0,0,0,1,0,0,0,1,0.125
联合直方图,0,0,0,2,0,0,0,2,0.25
线性预测系数,0,0,0,2,0,0,0,2,0.25
临近系数,0,0,0,1,0,0,0,1,0.125
兄弟姐妹系数,0,0,0,1,0,0,0,1,0.125
祖父辈系数,0,0,0,1,0,0,0,1,0.125
父辈系数,0,0,0,1,0,0,0,1,0.125
空间位置,0,0,0,1,0,0,0,1,0.125
contourlet变,0,0,0,1,1,0,0,2,0.3666666666666667
contouriet,0,0,0,1,0,0,0,1,0.125
线性的曲线,0,0,0,1,0,0,0,1,0.125
directionalfilterbank,0,0,0,1,0,0,0,1,0.125
方向滤波器组,0,0,0,1,0,0,0,1,0.125
多尺度分解,0,0,0,1,1,0,0,2,0.3666666666666667
laplacianpyramid,0,0,0,1,0,0,0,1,0.125
拉普拉斯塔型,0,0,0,1,0,0,0,1,0.125
几何结构,0,0,0,2,0,0,0,2,0.25
稀疏表,0,0,0,2,0,0,0,2,0.25
分段光滑图像,0,0,0,1,0,0,0,1,0.125
图像分析,0,0,0,3,3,0,0,6,1.1
pyramidaldirectionalfilter,0,0,0,1,0,0,0,1,0.125
塔型方向滤波器组,0,0,0,1,0,0,0,1,0.125
二维表示,0,0,0,1,0,0,0,1,0.125
图像视觉质量,0,0,0,1,0,0,0,1,0.125
结构信息,0,0,4,1,3,0,0,8,1.35
边缘主导性,0,0,0,2,0,0,0,2,0.25
多尺度几何分析,0,0,0,4,0,0,0,4,0.5
奇异曲线,0,0,0,4,0,0,0,4,0.5
小波分析,0,0,0,4,0,0,0,4,0.5
自适应,0,0,0,2,0,0,0,2,0.25
频谱,0,0,0,2,0,0,0,2,0.25
周期信号,0,0,0,2,0,0,0,2,0.25
基函数,0,0,0,2,1,0,0,3,0.4916666666666667
局部化,0,0,0,2,0,0,0,2,0.25
逼近,0,0,0,2,0,0,0,2,0.25
多分辨率,0,0,0,2,0,0,0,2,0.25
二维,0,0,0,2,1,0,0,3,0.4916666666666667
多尺度几何,0,0,0,3,0,0,0,3,0.375
失真分类,0,0,0,1,0,1,0,2,0.3666666666666667
阶段框架,0,0,0,1,0,0,0,1,0.125
质量分值,0,0,0,1,0,1,0,2,0.3666666666666667
通用型质量评价算法,0,0,0,1,0,0,0,1,0.125
通用型算法,0,0,0,1,0,0,0,1,0.125
curvelet域,0,0,0,1,0,0,0,1,0.125
自然场景特征,1,0,0,2,1,1,0,5,1.7333333333333334
多尺度分析,0,0,0,1,0,0,0,1,0.125
稀疏,0,0,0,1,1,0,0,2,0.3666666666666667
非零向量,0,0,0,1,0,0,0,1,0.125
非自适应方法,0,0,0,1,0,0,0,1,0.125
curvelet变换,0,0,0,3,0,0,0,3,0.375
先验结构特征,0,0,0,1,0,0,0,1,0.125
bandelet变换,0,0,0,1,0,0,0,1,0.125
先验边缘信息,0,0,0,1,0,0,0,1,0.125
边缘检测,0,0,0,1,0,0,0,1,0.125
非自适应,0,0,0,1,0,0,0,1,0.125
先验几何,0,0,0,1,0,0,0,1,0.125
mgax-leto,0,0,0,1,0,0,0,1,0.125
curvelet,0,0,0,1,0,0,0,1,0.125
bandelet,0,0,0,1,0,0,0,1,0.125
wedgelets,0,0,0,1,0,0,0,1,0.125
ridgelet,0,0,0,1,0,0,0,1,0.125
边缘检测过程,0,0,0,1,0,0,0,1,0.125
边界,0,0,0,1,0,0,0,1,0.125
扩散过程,0,0,0,1,0,0,0,1,0.125
跃变值,0,0,0,1,0,0,0,1,0.125
视觉神经元,0,0,0,2,0,0,0,2,0.25
mga,0,0,0,1,0,0,0,1,0.125
二维信号图像,0,0,0,1,0,0,0,1,0.125
子集,0,0,0,1,0,0,0,1,0.125
降维,0,0,0,1,0,0,0,1,0.125
高维数据,0,0,0,1,0,0,0,1,0.125
多变量函数,0,0,0,1,0,0,0,1,0.125
统计分析,0,0,0,1,0,0,0,1,0.125
数学分析,0,0,0,1,0,0,0,1,0.125
multiscalegeometrica,0,0,0,1,0,0,0,1,0.125
逼近模型,0,0,0,1,0,0,0,1,0.125
几何特征,0,0,0,1,0,0,0,1,0.125
支撑空间,0,0,0,1,0,0,0,1,0.125
小波基,0,0,0,1,0,0,0,1,0.125
分离,0,0,0,1,0,0,0,1,0.125
正方形,0,0,0,1,0,0,0,1,0.125
正方形支撑空间,0,0,0,1,0,0,0,1,0.125
小波,0,0,0,1,0,0,0,1,0.125
二维小波分解,0,0,0,1,0,0,0,1,0.125
二维可分离小波,0,0,0,1,0,0,0,1,0.125
结构特征,0,0,0,1,1,0,0,2,0.3666666666666667
高维信号,0,0,0,1,0,0,0,1,0.125
分段连续信号,0,0,0,1,0,0,0,1,0.125
二维信号,0,0,0,1,1,0,0,2,0.3666666666666667
分辨率图像,0,0,0,1,0,0,0,1,0.125
图像表示,0,0,0,1,0,0,0,1,0.125
频域定位性能,0,0,0,1,0,0,0,1,0.125
时域定位能力,0,0,0,1,0,0,0,1,0.125
傅里叶,0,0,0,1,0,0,0,1,0.125
傅里叶变换,0,0,0,2,0,0,0,2,0.25
时间局部化,0,0,0,1,0,0,0,1,0.125
频域变,0,0,0,1,0,0,0,1,0.125
傅里叶分析,0,0,0,1,0,0,0,1,0.125
内在特性,0,0,0,1,0,0,0,1,0.125
时域信号,0,0,0,1,0,0,0,1,0.125
时域,0,0,0,1,0,0,0,1,0.125
傅里叶变换分,0,0,0,1,0,0,0,1,0.125
纵横比,0,0,0,1,0,0,0,1,0.125
轮廓形状,0,0,0,1,0,0,0,1,0.125
均质,0,0,0,1,0,0,0,1,0.125
图像结构信息,0,0,1,1,0,0,0,2,0.25
方向性,0,0,0,1,0,0,0,1,0.125
重构图像,0,0,0,1,0,0,0,1,0.125
欠样,0,0,0,1,0,0,0,1,0.125
冗余信息,0,0,0,1,0,0,0,1,0.125
重构失真,0,0,0,1,0,0,0,1,0.125
过样,0,0,0,1,0,0,0,1,0.125
临界样值,0,0,0,1,0,0,0,1,0.125
临界,0,0,0,1,0,0,0,1,0.125
主体信息,0,0,0,1,0,0,0,1,0.125
多梦分辨率,0,0,0,1,0,0,0,1,0.125
粗细粒度,0,0,0,1,0,0,0,1,0.125
视觉画面,0,0,0,1,0,0,0,1,0.125
神经元,0,0,0,1,0,0,0,1,0.125
始信息,0,0,0,1,0,0,0,1,0.125
数学公式,0,0,0,1,0,0,0,1,0.125
像素,0,0,4,0,1,0,0,5,0.7416666666666667
mse,0,0,3,0,0,0,0,3,0.375
psnr算法,0,0,1,0,0,1,0,2,0.3666666666666667
人眼视觉感知,0,0,1,0,0,0,0,1,0.125
数值,0,0,1,0,0,0,0,1,0.125
空间位置信息,0,0,1,0,0,0,0,1,0.125
像素级,0,0,1,0,0,0,0,1,0.125
灰度图像,0,0,1,0,0,0,0,1,0.125
均方值,0,0,1,0,0,0,0,1,0.125
原始无失真图像,0,0,1,0,2,0,0,3,0.6083333333333334
像素数,0,0,1,0,0,0,0,1,0.125
量化值,0,0,1,0,0,0,0,1,0.125
数学统计,0,0,2,0,0,0,0,2,0.25
峰值信噪比,0,0,1,0,0,0,0,1,0.125
均方误差,0,0,1,0,0,0,0,1,0.125
sepsnr,0,0,1,0,0,0,0,1,0.125
即live试验库,0,0,1,0,0,0,0,1,0.125
仿真结,0,0,1,0,0,2,0,3,0.6083333333333334
仿真实,0,0,1,0,0,1,0,2,0.3666666666666667
图像失真程度,0,0,2,0,0,1,0,3,0.4916666666666667
多分辨率图像,0,0,1,0,0,0,0,1,0.125
客观评价,0,0,1,0,0,0,0,1,0.125
仿真,0,0,1,0,0,6,0,7,1.575
图片,0,0,1,0,2,0,0,3,0.6083333333333334
内容,0,0,0,0,2,0,0,2,0.48333333333333334
实验图片,0,0,0,0,1,0,0,1,0.24166666666666667
自然图片,0,0,0,0,1,0,0,1,0.24166666666666667
live实验库,0,0,0,0,1,0,0,1,0.24166666666666667
语义,0,0,0,0,1,0,0,1,0.24166666666666667
图像质量预测,0,0,0,0,1,0,0,1,0.24166666666666667
contourlet域提取,0,0,0,0,2,0,0,2,0.48333333333333334
biqi算法,0,0,0,0,0,1,0,1,0.24166666666666667
ff失真,0,0,0,0,0,5,0,5,1.2083333333333333
jpeg2000失真,0,0,0,0,0,1,0,1,0.24166666666666667
失真算法,0,0,0,0,0,1,0,1,0.24166666666666667
自然统计特征,0,0,0,0,0,1,0,1,0.24166666666666667
等级相关系数,0,0,0,0,0,2,0,2,0.48333333333333334
pearman,0,0,0,0,0,2,0,2,0.48333333333333334
线性相关系数,0,0,0,0,0,2,0,2,0.48333333333333334
pearson,0,0,0,0,0,2,0,2,0.48333333333333334
性能参数,0,0,0,0,0,2,0,2,0.48333333333333334
性能比,0,0,0,0,0,1,0,1,0.24166666666666667
biqlbrisque,0,0,0,0,0,1,0,1,0.24166666666666667
散点,0,0,0,0,0,2,0,2,0.48333333333333334
拟合曲线,0,0,0,0,0,2,0,2,0.48333333333333334
散点图,0,0,0,0,0,2,0,2,0.48333333333333334
仿真实验,1,0,0,0,0,1,0,2,1.2416666666666667
live图像实验库,0,0,0,0,0,1,0,1,0.24166666666666667
均衡算法,0,0,0,0,0,1,0,1,0.24166666666666667
专用型评价算法,0,0,0,0,0,1,0,1,0.24166666666666667
主观评价分值,0,0,0,0,0,1,0,1,0.24166666666666667
客观质量评价分值,0,0,0,0,0,1,0,1,0.24166666666666667
实验,0,0,0,0,0,1,0,1,0.24166666666666667
全局型,0,0,0,0,0,2,0,2,0.48333333333333334
图像内容,0,0,0,1,0,2,0,3,0.6083333333333334
边长,0,0,0,0,0,2,0,2,0.48333333333333334
泛化能力,0,0,0,0,0,1,0,1,0.24166666666666667
图像块个数,0,0,0,0,0,1,0,1,0.24166666666666667
算法性能指标,0,0,0,0,0,1,0,1,0.24166666666666667
图像库,0,0,0,0,0,1,0,1,0.24166666666666667
非连续点,0,0,0,2,0,0,0,2,0.25
连续信号,0,0,0,1,0,0,0,1,0.125
曲波系数,0,0,0,5,0,0,0,5,0.625
曲波,0,0,0,5,0,0,0,5,0.625
自然图像统计特征,1,0,0,3,1,0,0,5,1.6166666666666667
曲波变换,0,0,0,3,0,0,0,3,0.375
曲波域,0,0,0,2,0,0,0,2,0.25
概率分布函数,0,0,0,2,0,0,0,2,0.25
角度,0,0,0,2,0,0,0,2,0.25
curvelet系数,0,0,0,2,0,0,0,2,0.25
图像变换,0,0,0,1,0,0,0,1,0.125
框架模型,0,0,0,1,0,0,0,1,0.125
子带能量,0,0,0,1,0,0,0,1,0.125
受失真,0,0,0,1,0,0,0,1,0.125
窗口,0,0,0,1,0,0,0,1,0.125
子带能量分布特征,0,0,0,1,0,0,0,1,0.125
幅度分布,0,0,0,1,0,0,0,1,0.125
表征差,0,0,0,1,0,0,0,1,0.125
曲波能量分布,0,0,0,1,0,0,0,1,0.125
幅度均值,0,0,0,1,0,0,0,1,0.125
表征图像质量,0,0,0,1,0,0,0,1,0.125
方向能量信息,0,0,0,1,0,0,0,1,0.125
拟合,0,0,0,1,0,0,0,1,0.125
asymmetricgeneralize,0,0,0,1,0,0,0,1,0.125
aggd函数,0,0,0,1,0,0,0,1,0.125
曲波系数分布,0,0,0,1,0,0,0,1,0.125
概率分布特征,0,0,0,1,0,0,0,1,0.125
坐标,0,0,0,1,0,0,0,1,0.125
位置索引,0,0,0,1,0,0,0,1,0.125
二阶函数,0,0,0,1,0,0,0,1,0.125
稀疏表示,0,0,0,1,0,0,0,1,0.125
曲波表示,0,0,0,1,0,0,0,1,0.125
异性,0,0,0,1,0,0,0,1,0.125
卷积,0,0,0,1,0,0,0,1,0.125
无参考图像质量,1,0,0,3,0,0,0,4,1.375
curvelet分析,0,0,0,1,0,0,0,1,0.125
自然场景统计,0,0,0,2,0,0,0,2,0.25
邻域系数,0,0,0,2,0,0,0,2,0.25
振铃效应,0,0,0,1,0,0,0,1,0.125
统计信息,0,0,0,1,0,0,0,1,0.125
零偏移,0,0,0,1,0,0,0,1,0.125
系数分布,0,0,0,1,0,0,0,1,0.125
零系数,0,0,0,1,0,0,0,1,0.125
2000,0,0,0,1,0,0,0,1,0.125
无压缩图像,0,0,0,1,0,0,0,1,0.125
系数弓,0,0,0,1,0,0,0,1,0.125
随机变量,0,0,0,1,0,0,0,1,0.125
线性关,0,0,0,1,0,0,0,1,0.125
预测系数,0,0,0,1,0,0,0,1,0.125
自然统计模型,0,0,0,1,0,0,0,1,0.125
自然场景统计模型,0,0,0,1,0,0,0,1,0.125
分布,0,0,0,4,0,0,0,4,0.5
小波系数分布,0,0,0,1,0,0,0,1,0.125
canny,0,0,0,2,0,0,0,2,0.25
视觉认知,0,0,0,1,0,0,0,1,0.125
对象,0,0,0,1,0,0,0,1,0.125
算子边缘检测,0,0,0,1,0,0,0,1,0.125
lena,0,0,0,1,0,0,0,1,0.125
边缘检测图,0,0,0,1,0,0,0,1,0.125
缘主导特性,0,0,0,1,0,0,0,1,0.125
图像细节,0,0,0,1,0,0,0,1,0.125
提取图像,0,0,0,1,1,0,0,2,0.3666666666666667
自然进化,0,0,0,0,1,0,0,1,0.24166666666666667
自相似性,0,0,0,2,0,0,0,2,0.25
振幅响应,0,0,0,1,0,0,0,1,0.125
带通滤波器,0,0,0,1,0,0,0,1,0.125
像素点,0,0,0,1,0,0,0,1,0.125
小波分解图,0,0,0,1,0,0,0,1,0.125
尺寸,0,0,0,1,0,0,0,1,0.125
尺度不变性,0,0,0,1,0,0,0,1,0.125
灰度值,0,0,0,1,0,0,0,1,0.125
直方图分布图,0,0,0,1,0,0,0,1,0.125
像素值,0,0,0,1,0,0,0,1,0.125
直方分布图,0,0,0,1,0,0,0,1,0.125
部像素值,0,0,0,1,0,0,0,1,0.125
风景图像,0,0,0,1,0,0,0,1,0.125
海岸线,0,0,0,1,0,0,0,1,0.125
lsi,0,0,0,11,0,0,0,11,1.375
ssi,0,0,0,8,0,0,0,8,1.0
隐状态,0,0,0,5,0,0,0,5,0.625
状态,0,0,0,4,0,0,0,4,0.5
hmt模型,0,0,0,4,0,0,0,4,0.5
隐马尔科夫树模型,0,0,0,4,0,0,0,4,0.5
父系数,0,0,0,3,0,0,0,3,0.375
方差,0,0,1,3,0,0,0,4,0.5
hmt,0,0,0,3,0,0,0,3,0.375
失真程,0,0,0,2,0,0,0,2,0.25
ssi幅度,0,0,0,2,0,0,0,2,0.25
子系数,0,0,0,2,0,0,0,2,0.25
相关性,0,0,0,2,0,0,0,2,0.25
尺度系数,0,0,0,2,0,0,0,2,0.25
先验值,0,0,0,1,0,0,0,1,0.125
偏移,0,0,0,1,0,0,0,1,0.125
尺度分布,0,0,0,1,0,0,0,1,0.125
无参考图像,0,0,0,1,0,0,0,1,0.125
参数值,0,0,0,1,0,0,0,1,0.125
ssi统计特性,0,0,0,1,0,0,0,1,0.125
高频信号,0,0,0,1,0,0,0,1,0.125
低频信号,0,0,0,1,0,0,0,1,0.125
边缘细节,0,0,0,1,0,0,0,1,0.125
高斯模糊图像,0,0,0,1,0,0,0,1,0.125
模糊程度,0,0,0,1,0,0,0,1,0.125
gn,0,0,0,1,0,0,0,1,0.125
largesigm,0,0,0,1,0,0,0,1,0.125
大方差,0,0,0,1,0,0,0,1,0.125
对数关系,0,0,0,1,0,0,0,1,0.125
响应,0,0,0,1,0,0,0,1,0.125
四叉树,0,0,0,1,0,0,0,1,0.125
更新概率,0,0,0,1,0,0,0,1,0.125
条件概率,0,0,0,1,0,0,0,1,0.125
气岡,0,0,0,1,0,0,0,1,0.125
子状态,0,0,0,1,0,0,0,1,0.125
转移矩阵,0,0,0,1,0,0,0,1,0.125
父状态,0,0,0,1,0,0,0,1,0.125
马尔科夫链,0,0,0,1,0,0,0,1,0.125
小波系数尺度,0,0,0,1,0,0,0,1,0.125
高斯密度函数,0,0,0,1,0,0,0,1,0.125
概率质量函数,0,0,0,1,0,0,0,1,0.125
高斯混合模型,0,0,1,1,0,0,0,2,0.25
二状态高斯混合模型,0,0,0,1,0,0,0,1,0.125
小状态,0,0,0,1,0,0,0,1,0.125
系数幅度,0,0,0,1,0,0,0,1,0.125
观测值,0,0,0,1,0,0,0,1,0.125
隐马尔科夫树,0,0,0,1,0,0,0,1,0.125
markovchain,0,0,0,1,0,0,0,1,0.125
延续性,0,0,0,1,0,0,0,1,0.125
自然场景图像,0,0,0,1,0,0,0,1,0.125
隐马尔科夫模型,0,0,0,1,0,0,0,1,0.125
自然场景特性,0,0,0,1,0,0,0,1,0.125
变换域,0,0,0,4,0,0,0,4,0.5
dct域,0,0,0,1,0,0,0,1,0.125
无参考图像算法,0,0,0,1,0,0,0,1,0.125
无参考图像质量算法,0,0,0,1,0,0,0,1,0.125
白噪声失真,0,0,0,0,2,1,0,3,0.725
子带分布折线,0,0,0,0,2,0,0,2,0.48333333333333334
子带结构,0,0,0,0,1,0,0,1,0.24166666666666667
对数绝对值分布,0,0,0,0,1,0,0,1,0.24166666666666667
统计,0,0,0,0,1,0,0,1,0.24166666666666667
粗糙尺度,0,0,0,0,1,0,0,1,0.24166666666666667
低频分量,0,0,0,0,1,0,0,1,0.24166666666666667
精细尺度,0,0,0,0,1,0,0,1,0.24166666666666667
轮廓信息,0,0,0,0,1,0,0,1,0.24166666666666667
纹理信息,0,0,0,0,2,0,0,2,0.48333333333333334
高斯模糊失真,0,0,0,0,1,1,0,2,0.48333333333333334
jpeg2000压缩失真,0,0,0,0,1,0,0,1,0.24166666666666667
线性关系,0,0,0,0,1,0,0,1,0.24166666666666667
纹理,0,0,1,0,2,0,0,3,0.6083333333333334
插值法,0,0,0,0,1,0,0,1,0.24166666666666667
微调阈值,0,0,0,0,1,0,0,1,0.24166666666666667
绝对均值,0,0,0,0,1,0,0,1,0.24166666666666667
绝对值,0,0,0,0,1,0,0,1,0.24166666666666667
lp分解,0,0,0,0,2,0,0,2,0.48333333333333334
ontourlet域,0,0,0,0,1,0,0,1,0.24166666666666667
3c,0,0,0,0,1,0,0,1,0.24166666666666667
dfb,0,0,0,0,5,0,0,5,1.2083333333333333
二维方向滤波器组,0,0,0,0,2,0,0,2,0.48333333333333334
奇异点,0,0,0,0,2,0,0,2,0.48333333333333334
contourlet分解,0,0,0,0,1,0,0,1,0.24166666666666667
bmp,0,0,0,0,1,0,0,1,0.24166666666666667
caps,0,0,0,0,1,0,0,1,0.24166666666666667
高低频分量,0,0,0,0,1,0,0,1,0.24166666666666667
离散contourlet变换,0,0,0,0,1,0,0,1,0.24166666666666667
边缘曲线段,0,0,0,0,1,0,0,1,0.24166666666666667
塔形方向滤波器组,0,0,0,0,1,0,0,1,0.24166666666666667
线形结构,0,0,0,0,1,0,0,1,0.24166666666666667
奇异,0,0,0,0,1,0,0,1,0.24166666666666667
高通子带,0,0,0,0,1,0,0,1,0.24166666666666667
lp子带,0,0,0,0,1,0,0,1,0.24166666666666667
方向子带,0,0,0,0,1,0,0,1,0.24166666666666667
多分辨率分解,0,0,0,0,1,0,0,1,0.24166666666666667
粒度,0,0,0,0,1,0,0,1,0.24166666666666667
低通图像,0,0,0,0,1,0,0,1,0.24166666666666667
差值图像,0,0,0,0,1,0,0,1,0.24166666666666667
逼近图像,0,0,0,0,1,0,0,1,0.24166666666666667
原始信号,0,0,0,0,1,0,0,1,0.24166666666666667
光滑曲线,0,0,0,0,1,0,0,1,0.24166666666666667
拉普拉斯塔式滤波器结构,0,0,0,0,1,0,0,1,0.24166666666666667
边缘轮廓,0,0,0,0,1,0,0,1,0.24166666666666667
非零系数,0,0,0,0,1,0,0,1,0.24166666666666667
高次复杂函数,0,0,0,0,1,0,0,1,0.24166666666666667
边缘特征,0,0,0,0,1,0,0,1,0.24166666666666667
奇异性,0,0,0,0,1,0,0,1,0.24166666666666667
信号处理,0,0,0,0,1,0,0,1,0.24166666666666667
奇异性结构信息,0,0,0,0,1,0,0,1,0.24166666666666667
贪心,0,0,0,0,1,0,0,1,0.24166666666666667
contourlet变换理论,0,0,0,0,1,0,0,1,0.24166666666666667
水印信息,0,0,1,0,0,0,0,1,0.125
水印,0,0,1,0,0,0,0,1,0.125
小波数字水印,0,0,1,0,0,0,0,1,0.125
印章,0,0,1,0,0,0,0,1,0.125
数据,0,0,1,0,0,0,0,1,0.125
信息保真度,0,0,2,0,0,0,0,2,0.25
工程学算法,0,0,1,0,0,0,0,1,0.125
图像结构,0,0,1,0,0,0,0,1,0.125
失真图片,0,0,1,0,0,0,0,1,0.125
始图片,0,0,1,0,0,0,0,1,0.125
像素信息,0,0,2,0,0,0,0,2,0.25
svm分类器,0,0,0,0,0,5,0,5,1.2083333333333333
质量评价分,0,0,0,0,0,3,0,3,0.725
框架算法,0,0,0,0,0,2,0,2,0.48333333333333334
jp2k失真,0,0,0,0,0,2,0,2,0.48333333333333334
biqi,0,0,0,0,0,2,0,2,0.48333333333333334
交叉验证,0,0,0,0,0,2,0,2,0.48333333333333334
svm,0,0,0,0,0,2,0,2,0.48333333333333334
v-svr,0,0,0,0,0,2,0,2,0.48333333333333334
分类器,0,0,0,0,0,2,0,2,0.48333333333333334
径向基核函数,0,0,0,0,0,2,0,2,0.48333333333333334
实时性,0,0,0,0,0,1,0,1,0.24166666666666667
训练,0,0,0,0,0,1,0,1,0.24166666666666667
回归器,0,0,0,0,0,1,0,1,0.24166666666666667
wn失真,0,0,0,0,0,1,0,1,0.24166666666666667
jp2k,0,0,0,0,0,1,0,1,0.24166666666666667
jpeg,0,0,0,0,0,1,0,1,0.24166666666666667
blur模糊,0,0,0,0,0,1,0,1,0.24166666666666667
分值,0,0,0,0,0,1,0,1,0.24166666666666667
psn,0,0,0,0,0,1,0,1,0.24166666666666667
svro,0,0,0,0,0,1,0,1,0.24166666666666667
映射,0,0,0,0,0,1,0,1,0.24166666666666667
回归,0,0,0,0,0,1,0,1,0.24166666666666667
向量回归器,0,0,0,0,0,1,0,1,0.24166666666666667
支持,0,0,0,0,0,1,0,1,0.24166666666666667
libsvm工具包,0,0,0,0,0,1,0,1,0.24166666666666667
rbf,0,0,0,0,0,1,0,1,0.24166666666666667
概率值,0,0,0,0,0,1,0,1,0.24166666666666667
块状失真,0,0,0,0,0,1,0,1,0.24166666666666667
分类,0,0,0,0,0,1,0,1,0.24166666666666667
二分类,0,0,0,0,0,1,0,1,0.24166666666666667
svm算法,0,0,0,0,0,1,0,1,0.24166666666666667
contouriet变换,0,0,0,0,0,1,0,1,0.24166666666666667
nr-iqa算法,0,0,0,0,0,1,0,1,0.24166666666666667
占比,0,0,0,0,0,1,0,1,0.24166666666666667
回归模型,0,0,0,0,0,1,0,1,0.24166666666666667
投影关系,0,0,0,0,0,1,0,1,0.24166666666666667
v-svm,0,0,0,0,0,1,0,1,0.24166666666666667
function,0,0,0,0,0,1,0,1,0.24166666666666667
radialba,0,0,0,0,0,1,0,1,0.24166666666666667
图像失真类型,0,0,0,0,0,1,0,1,0.24166666666666667
应失真程度,0,0,0,0,0,1,0,1,0.24166666666666667
人工图像,0,0,0,3,0,0,0,3,0.375
渐变性,0,0,0,1,0,0,0,1,0.125
自然景观,0,0,0,1,0,0,0,1,0.125
对称,0,0,0,1,0,0,0,1,0.125
医疗图像,0,0,0,1,0,0,0,1,0.125
肖像风景照,0,0,0,1,0,0,0,1,0.125
自适应处理,0,0,0,1,0,0,0,1,0.125
自然,0,0,0,1,0,0,0,1,0.125
冰环境,0,0,0,1,0,0,0,1,0.125
相机,0,0,0,1,0,0,0,1,0.125
cad制图,0,0,0,1,0,0,0,1,0.125
素描作品,0,0,0,1,0,0,0,1,0.125
图像素材,0,0,0,1,0,0,0,1,0.125
ssim,0,0,5,0,0,0,0,5,0.625
相似度,0,0,5,0,0,0,0,5,0.625
信息测量,0,0,2,0,0,0,0,2,0.25
vif指标,0,0,2,0,0,0,0,2,0.25
vif算法,0,0,2,0,0,0,0,2,0.25
保真度,0,0,2,0,0,0,0,2,0.25
信息论,0,0,2,0,0,0,0,2,0.25
低层视觉特性,0,0,2,0,0,0,0,2,0.25
梯度,0,0,2,0,0,0,0,2,0.25
信号失真信道,0,0,1,0,0,0,0,1,0.125
人眼视觉失真通道,0,0,1,0,0,0,0,1,0.125
子带数,0,0,1,0,0,0,0,1,0.125
互信息测量,0,0,1,0,0,0,0,1,0.125
visualinformationfidelity,0,0,1,0,0,0,0,1,0.125
iterio,0,0,1,0,0,0,0,1,0.125
informationfidelity,0,0,1,0,0,0,0,1,0.125
信息保真度准则,0,0,1,0,0,0,0,1,0.125
通信理论,0,0,1,0,0,0,0,1,0.125
mid,0,0,1,0,0,0,0,1,0.125
质量评价模型,0,0,1,0,0,0,0,1,0.125
相似性,0,0,1,0,0,0,0,1,0.125
模糊积分,0,0,1,0,0,0,0,1,0.125
平滑区,0,0,1,0,0,0,0,1,0.125
纹理区,0,0,1,0,0,0,0,1,0.125
加权相似度图,0,0,1,0,0,0,0,1,0.125
相位一致性特征,0,0,1,0,0,0,0,1,0.125
局部相似度,0,0,1,0,0,0,0,1,0.125
对比度信息,0,0,1,0,0,0,0,1,0.125
ntmagnitude,0,0,1,0,0,0,0,1,0.125
ra,0,0,1,0,0,0,0,1,0.125
梯度强度,0,0,1,0,0,0,0,1,0.125
相位一致性,0,0,1,0,0,0,0,1,0.125
致性,0,0,1,0,0,0,0,1,0.125
featuressimilarityinde,0,0,1,0,0,0,0,1,0.125
特征结构,0,0,1,0,0,0,0,1,0.125
noiserati,0,0,1,0,0,0,0,1,0.125
visualsignal,0,0,1,0,0,0,0,1,0.125
视觉信噪比,0,0,1,0,0,0,0,1,0.125
人眼视觉感知阈值,0,0,1,0,0,0,0,1,0.125
人类视觉特性,0,0,1,0,0,0,0,1,0.125
纹理变化,0,0,1,0,0,0,0,1,0.125
遂缘,0,0,1,0,0,0,0,1,0.125
失真人眼,0,0,1,0,0,0,0,1,0.125
图像边缘,0,0,1,0,0,0,0,1,0.125
主观感受,0,0,1,0,0,0,0,1,0.125
统计误差,0,0,1,0,0,0,0,1,0.125
纯数学,0,0,1,0,0,0,0,1,0.125
有界性,0,0,1,0,0,0,0,1,0.125
im,0,0,1,0,0,0,0,1,0.125
对称性,0,0,1,0,0,0,0,1,0.125
测度,0,0,1,0,0,0,0,1,0.125
度量准则,0,0,1,0,0,0,0,1,0.125
正常量,0,0,1,0,0,0,0,1,0.125
分母,0,0,1,0,0,0,0,1,0.125
协方差,0,0,1,0,0,0,0,1,0.125
ilarity,0,0,1,0,0,0,0,1,0.125
ssimstructurals,0,0,1,0,0,0,0,1,0.125
结构相似性,0,0,1,0,0,0,0,1,0.125
ssimuu算法,0,0,1,0,0,0,0,1,0.125
Contourlet变换,0,1,0,0,0,0,0,1,2.0
 人眼视觉特性,0,1,0,0,0,0,0,1,2.0
表征能力,1,0,0,0,0,0,0,1,1.0
人眼视觉感知特性,1,0,0,0,0,0,0,1,1.0
图像信息工程,1,0,0,0,0,0,0,1,1.0
视觉信息处理,1,0,0,0,0,0,0,1,1.0
移动设备,1,0,0,0,0,0,0,1,1.0
多媒体信息,1,0,0,0,0,0,0,1,1.0
无需,1,0,0,0,0,0,0,1,1.0
