,摘要,关键词,第一章,第二章,第三章,第四章,第五章,总词频,加权得分
设备,2,0,24,1,3,84,3,117,26.875
成新率,0,0,0,0,0,17,0,17,4.108333333333333
价值评估,0,0,2,1,0,10,2,15,3.275
年限,0,0,0,0,0,8,0,8,1.9333333333333333
重置成本,0,0,0,0,0,2,0,2,0.48333333333333334
设备资产管理模块,0,0,0,0,0,6,0,6,1.45
安装费,0,0,0,0,0,2,0,2,0.48333333333333334
运杂费,0,0,0,0,0,4,0,4,0.9666666666666667
技术鉴定,0,0,0,0,0,2,0,2,0.48333333333333334
年限法,0,0,0,0,0,1,0,1,0.24166666666666667
成本法,0,0,1,0,0,1,1,3,0.6083333333333334
资产评估,0,0,0,0,0,1,0,1,0.24166666666666667
用寿命,0,0,2,1,1,3,0,7,1.3416666666666668
数据库,0,0,0,0,0,11,0,11,2.658333333333333
信息,0,0,2,0,0,5,0,7,1.4583333333333333
台账状态,0,0,0,0,0,1,0,1,0.24166666666666667
采购,0,0,0,0,0,1,0,1,0.24166666666666667
采购人员,0,0,0,0,0,1,0,1,0.24166666666666667
资产管理,0,0,2,0,0,6,1,9,1.9416666666666667
设备台账信息,0,0,0,0,0,5,0,5,1.2083333333333333
源域,2,0,7,25,19,0,6,59,12.041666666666668
目标域,2,0,7,24,17,0,5,55,11.191666666666666
特征空间,4,0,2,3,1,0,4,14,5.833333333333333
模型,0,0,11,9,12,3,3,38,6.85
数据,1,0,12,24,10,24,3,74,14.441666666666666
rul预测算法,2,0,5,0,1,7,2,17,5.041666666666666
权重,1,0,2,2,20,0,2,27,6.816666666666666
分布差异,1,0,2,0,4,0,2,9,2.7
样本差异度量,2,0,2,0,0,0,2,6,2.7333333333333334
年限成新率,0,0,0,0,0,1,1,2,0.48333333333333334
预测性,1,0,2,0,0,1,1,5,1.7333333333333334
工业设备运维系统,1,0,5,0,0,8,1,15,3.8
微信小程序,1,0,5,0,0,14,1,21,5.25
设备状态监测,0,0,0,0,0,1,1,2,0.48333333333333334
工况权重计算机,0,0,1,0,0,0,1,2,0.3666666666666667
域自适应模型,0,0,2,1,2,0,1,6,1.1
模型性能,0,0,4,0,1,0,1,6,0.9833333333333334
均值差异,0,0,0,1,0,0,1,2,0.3666666666666667
损失函数,3,0,7,10,12,0,1,33,8.266666666666666
分布差异项,0,0,0,0,0,0,1,1,0.24166666666666667
稀疏自编码,0,0,0,0,0,0,1,1,0.24166666666666667
特征,0,0,1,8,1,0,1,11,1.6083333333333334
处理,0,0,0,0,0,0,1,1,0.24166666666666667
原始数据,0,0,0,2,0,0,1,3,0.4916666666666667
长短期记忆网络,0,0,4,0,1,0,1,6,0.9833333333333334
预测器,0,0,1,0,0,0,1,2,0.3666666666666667
稀疏自编码器,1,0,5,6,5,0,1,18,3.825
特征提取器,0,0,1,1,0,0,1,3,0.4916666666666667
泛化性,0,0,4,2,4,0,1,11,1.9583333333333333
分布,1,0,5,7,7,0,1,21,4.433333333333334
自适应模型,0,0,2,0,0,0,1,3,0.4916666666666667
工况,0,1,7,2,6,1,1,18,5.058333333333334
目标域数据,0,0,0,0,4,0,1,5,1.2083333333333333
工业生产,1,0,6,1,5,2,0,15,3.5666666666666664
数据驱动,0,0,13,7,3,0,0,23,3.225
工业设备,2,0,7,0,0,1,0,10,3.1166666666666667
传感器,2,0,6,4,6,4,0,22,5.666666666666666
性能,1,0,9,3,12,0,0,25,5.4
测试集,1,0,4,2,21,0,0,28,6.825
训练集,1,0,4,2,21,0,0,28,6.825
数据分布,1,0,8,4,7,0,0,20,4.191666666666666
健康管理,1,0,2,0,0,0,0,3,1.25
故障预测,1,0,2,0,0,0,0,3,1.25
设备维护,0,0,5,0,0,4,0,9,1.5916666666666668
预测性维护,0,0,7,1,0,1,0,9,1.2416666666666667
效率,1,0,2,0,0,1,0,4,1.4916666666666667
维修,0,0,2,0,0,6,0,8,1.7
生产效率,0,0,3,0,0,1,0,4,0.6166666666666667
智能制造,1,0,2,0,0,0,0,3,1.25
工业大数据技术,1,0,2,0,0,0,0,3,1.25
工业,0,0,5,0,0,1,0,6,0.8666666666666667
工业领,0,0,2,0,1,1,0,4,0.7333333333333334
rul预测理论,0,0,1,0,0,0,0,1,0.125
公开数据集,0,0,1,0,0,1,0,2,0.3666666666666667
刀具,1,0,2,8,12,0,0,23,5.15
轴承,0,0,4,6,16,1,0,27,5.358333333333333
权重分配,1,0,3,0,1,0,0,5,1.6166666666666667
迁移学习,1,1,13,10,2,0,0,27,6.358333333333333
预测精度,0,0,2,0,0,0,0,2,0.25
rul,0,0,8,1,4,6,0,19,3.5416666666666665
预测性维护技术,0,0,1,0,0,0,0,1,0.125
rul预测,0,0,10,2,0,2,0,14,1.9833333333333334
迁移学习算法,0,0,1,0,0,0,0,1,0.125
机器学习算法,0,0,3,7,0,0,0,10,1.25
剩余使用寿命预测,0,1,1,0,0,0,0,2,2.125
深度学习,1,0,4,1,0,0,0,6,1.625
机器学习技术,0,0,1,0,0,0,0,1,0.125
实时,0,0,1,0,0,0,0,1,0.125
预测,0,0,2,0,0,1,0,3,0.4916666666666667
温度,0,0,2,0,1,0,0,3,0.4916666666666667
振动信号,0,0,2,4,0,0,0,6,0.75
运行数据,0,0,1,0,0,1,0,2,0.3666666666666667
数据中心,0,0,1,1,0,0,0,2,0.25
控制器,1,0,1,3,1,0,0,6,1.7416666666666667
人工干预,0,0,1,0,0,0,0,1,0.125
寿命,0,0,8,5,3,4,0,20,3.3166666666666664
rul预测结果,0,0,1,0,0,0,0,1,0.125
剩余使用寿命,0,0,3,0,1,6,0,10,2.0666666666666664
工作时间,0,0,1,0,1,0,0,2,0.3666666666666667
ini,1,0,1,0,0,0,0,2,1.125
寿命预测,1,0,9,2,1,0,0,13,2.6166666666666667
智能管理,0,0,1,0,0,0,0,1,0.125
使用寿命,0,0,4,1,1,2,0,8,1.35
故障检测,0,0,1,0,0,0,0,1,0.125
工业系统,0,0,2,0,0,0,0,2,0.25
数据分析,0,0,1,0,0,0,0,1,0.125
信号处理,0,0,1,1,0,0,0,2,0.25
信号,0,0,1,14,11,0,0,26,4.533333333333333
状态数据,0,0,1,0,0,0,0,1,0.125
机器,0,0,1,0,0,0,0,1,0.125
phm,1,0,2,0,0,0,0,3,1.25
healthmanage,1,0,1,0,0,0,0,2,1.125
prognostics,1,0,1,0,0,0,0,2,1.125
预防性维护,0,0,4,0,0,2,0,6,0.9833333333333334
资源,0,0,2,0,0,0,0,2,0.25
定期维修,0,0,1,0,0,0,0,1,0.125
被动维护,0,0,1,0,0,0,0,1,0.125
工厂,1,0,5,0,0,6,0,12,3.075
系统,0,0,2,0,0,1,0,3,0.4916666666666667
大型系统,0,0,1,0,0,0,0,1,0.125
管理,0,0,1,0,0,3,0,4,0.85
人工决策,0,0,1,0,0,0,0,1,0.125
行数据,0,0,1,0,0,2,0,3,0.6083333333333334
企业信息数据,0,0,1,0,0,0,0,1,0.125
智能服务,0,0,1,0,0,0,0,1,0.125
创新能力,0,0,1,0,0,0,0,1,0.125
生产率,0,0,1,0,0,0,0,1,0.125
制造业,0,0,2,0,0,0,0,2,0.25
工业大数据,1,0,3,2,0,0,0,6,1.625
大数据技术,1,0,1,0,0,1,0,3,1.3666666666666667
智能化管理,1,0,1,0,0,0,0,2,1.125
机械设备,0,0,1,0,0,0,0,1,0.125
人工智能,1,0,2,0,0,0,0,3,1.25
信息技术,0,0,1,0,0,1,0,2,0.3666666666666667
智能制造时代,0,0,1,0,0,0,0,1,0.125
测试功能,0,0,0,0,0,4,0,4,0.9666666666666667
小程序,0,0,0,0,0,21,0,21,5.075
工单,0,0,0,0,0,19,0,19,4.591666666666667
功能测试,0,0,0,0,0,5,0,5,1.2083333333333333
资产管理模块,0,0,0,0,0,4,0,4,0.9666666666666667
任务管理功能,0,0,0,0,0,2,0,2,0.48333333333333334
停用机组,0,0,0,0,0,3,0,3,0.725
运行机组数,0,0,0,0,0,2,0,2,0.48333333333333334
机组,0,0,0,0,0,14,0,14,3.3833333333333333
任务管理模块,0,0,0,0,0,5,0,5,1.2083333333333333
实时监测,0,0,2,0,0,11,0,13,2.908333333333333
台账信息,0,0,0,0,0,7,0,7,1.6916666666666667
功能,0,0,0,0,0,1,0,1,0.24166666666666667
设备台账,0,0,0,0,0,6,0,6,1.45
设备资产管理,1,0,2,0,0,4,0,7,2.216666666666667
工单信息,0,0,0,0,0,9,0,9,2.175
上传工单,0,0,0,0,0,1,0,1,0.24166666666666667
技术员,0,0,0,0,0,1,0,1,0.24166666666666667
任务管理功能测试,0,0,0,0,0,1,0,1,0.24166666666666667
显示通讯录,0,0,0,0,0,1,0,1,0.24166666666666667
通讯录,0,0,0,0,0,5,0,5,1.2083333333333333
人员信息,0,0,0,0,0,5,0,5,1.2083333333333333
设备状态,0,0,0,0,0,5,0,5,1.2083333333333333
历史数据模块,0,0,0,0,0,1,0,1,0.24166666666666667
测试样例,0,0,0,0,0,1,0,1,0.24166666666666667
统计功能,0,0,0,0,0,1,0,1,0.24166666666666667
工况参数,0,0,0,0,0,3,0,3,0.725
状态数量,0,0,0,0,0,1,0,1,0.24166666666666667
实时监测功能测试,0,0,0,0,0,1,0,1,0.24166666666666667
实时监测功能,0,0,0,0,0,1,0,1,0.24166666666666667
测试,0,0,0,0,1,2,0,3,0.725
登录模块,0,0,0,0,0,1,0,1,0.24166666666666667
历史数据统计模块,0,0,0,0,0,2,0,2,0.48333333333333334
预警模块,0,0,0,0,0,3,0,3,0.725
测试效果,0,0,0,0,0,1,0,1,0.24166666666666667
功能模块,0,0,0,0,0,6,0,6,1.45
特征提取,0,0,3,7,4,0,0,14,2.216666666666667
数据预处理,0,0,0,5,3,1,0,9,1.5916666666666668
信号采集,0,0,0,4,0,0,0,4,0.5
时间窗,0,0,0,4,6,0,0,10,1.95
原始信号,0,0,1,3,0,0,0,4,0.5
信号数据,0,0,0,2,0,0,0,2,0.25
模型训练,0,0,1,3,2,0,0,6,0.9833333333333334
寿命预测框架,0,0,0,2,0,0,0,2,0.25
及时警报,0,0,0,1,0,0,0,1,0.125
测值,0,0,0,1,1,0,0,2,0.3666666666666667
深度学习算法,0,0,1,1,0,0,0,2,0.25
时频域,0,0,0,2,2,0,0,4,0.7333333333333334
频域,0,0,0,3,2,0,0,5,0.8583333333333334
时域,0,0,1,5,2,0,0,8,1.2333333333333334
非工作段信号,0,0,0,1,3,0,0,4,0.85
异常值,0,0,0,1,2,0,0,3,0.6083333333333334
缺失值,0,0,0,1,2,0,0,3,0.6083333333333334
异常数据,0,0,0,1,0,0,0,1,0.125
采集,0,0,0,1,0,0,0,1,0.125
电流信号,0,0,0,2,0,0,0,2,0.25
设备部件,0,0,0,1,0,1,0,2,0.3666666666666667
rul预测模型,0,0,1,1,4,2,0,8,1.7
设备监测信号,0,0,0,1,0,0,0,1,0.125
传感器技术,0,0,1,2,0,0,0,3,0.375
剩余,1,0,2,6,1,2,0,12,2.725
寿命预测模型,2,0,2,0,1,0,0,5,2.4916666666666667
负面效应,0,0,1,0,0,0,0,1,0.125
工况数据,0,0,1,0,0,0,0,1,0.125
退化,0,0,1,0,2,0,0,3,0.6083333333333334
预测性能,1,0,2,1,1,0,0,5,1.6166666666666667
机器学习,2,0,2,0,0,0,0,4,2.25
工业数据集,0,0,1,0,0,0,0,1,0.125
泛化性能,0,0,1,0,0,0,0,1,0.125
物件,0,0,1,0,0,0,0,1,0.125
刀具切削,0,0,1,0,0,0,0,1,0.125
转速,0,0,1,3,3,0,0,7,1.225
工业生产环,1,0,1,0,0,0,0,2,1.125
参数,0,0,3,5,6,2,0,16,2.9333333333333336
自适应,0,0,1,8,2,0,0,11,1.6083333333333334
参数迁移,0,0,0,3,0,0,0,3,0.375
网络,0,0,3,5,3,0,0,11,1.725
标签信息,0,0,0,2,0,0,0,2,0.25
标签,0,0,1,3,3,0,0,7,1.225
数据集,0,0,4,8,14,0,0,26,4.883333333333333
知识,0,0,1,2,0,0,0,3,0.375
目标域标签预测,0,0,0,1,0,0,0,1,0.125
跨域场景,0,0,0,1,0,0,0,1,0.125
层间参数,0,0,0,1,0,0,0,1,0.125
隐式,0,0,0,1,0,0,0,1,0.125
空间,0,0,0,1,0,0,0,1,0.125
深度神经网络,0,0,0,1,0,0,0,1,0.125
特征变换,0,0,0,1,0,0,0,1,0.125
初始化,0,0,1,1,2,0,0,4,0.7333333333333334
深度学习模型,0,0,1,1,0,0,0,2,0.25
学习,0,0,1,1,0,0,0,2,0.25
统计分布,0,0,0,1,0,0,0,1,0.125
惩罚项,0,0,0,1,0,0,0,1,0.125
样本,0,0,0,14,6,0,0,20,3.2
抽象,0,0,0,1,0,0,0,1,0.125
中间层,0,0,0,1,0,0,0,1,0.125
顶层,0,0,0,1,0,0,0,1,0.125
高层抽象表征,0,0,0,1,0,0,0,1,0.125
非线性变换,0,0,0,1,0,0,0,1,0.125
深层网络,0,0,0,1,0,0,0,1,0.125
表征学习,0,0,0,1,0,0,0,1,0.125
域自适应技术,0,0,1,2,0,0,0,3,0.375
条件分布,0,0,1,4,0,0,0,5,0.625
边缘分布,0,0,0,6,0,0,0,6,0.75
标签集合,0,0,0,1,0,0,0,1,0.125
域自适应,0,0,4,2,21,1,0,28,6.066666666666666
定源域,0,0,0,1,0,0,0,1,0.125
标签厂,0,0,0,1,0,0,0,1,0.125
能力,0,0,1,1,0,0,0,2,0.25
轴承数据,0,0,0,1,2,0,0,3,0.6083333333333334
负载,0,0,2,1,3,0,0,6,1.1
轴承磨损,0,0,0,1,0,0,0,1,0.125
人工,0,0,0,1,0,0,0,1,0.125
迁移,0,0,1,3,2,0,0,6,0.9833333333333334
生产,0,0,1,1,0,0,0,2,0.25
待预测数据,0,0,0,1,0,0,0,1,0.125
机器学习模型,0,0,0,1,0,0,0,1,0.125
概率分布,0,0,0,1,0,0,0,1,0.125
数据量,0,0,1,1,3,0,0,5,0.975
寿命预测算法,1,0,1,1,0,1,0,4,1.4916666666666667
damoc,1,0,2,0,21,0,0,24,6.325
轴承数据集,1,0,3,2,14,1,0,21,5.25
刀具数据集,0,0,1,3,11,0,0,15,3.158333333333333
rmse,0,0,0,0,9,0,0,9,2.175
pl,0,0,0,0,5,0,0,5,1.2083333333333333
动态赋值法,0,0,0,0,6,0,0,6,1.45
运行时间,0,0,0,0,4,0,0,4,0.9666666666666667
rmse指标,0,0,0,0,4,0,0,4,0.9666666666666667
工况权重,0,0,0,0,4,0,0,4,0.9666666666666667
dasl,0,0,0,0,5,0,0,5,1.2083333333333333
lstm,0,0,7,0,14,0,0,21,4.258333333333333
score,0,0,0,0,7,0,0,7,1.6916666666666667
随机赋值,0,0,0,0,4,0,0,4,0.9666666666666667
a-distance,0,0,0,0,7,0,0,7,1.6916666666666667
score指标,0,0,0,0,3,0,0,3,0.725
lightgbm,0,0,0,0,4,0,0,4,0.9666666666666667
sae-lstm,0,0,1,0,7,0,0,8,1.8166666666666667
权重赋值,0,0,0,0,4,0,0,4,0.9666666666666667
快速退化状态,0,0,0,0,4,0,0,4,0.9666666666666667
缓慢退化状态,0,0,0,0,4,0,0,4,0.9666666666666667
域自适应过程,0,0,0,0,5,0,0,5,1.2083333333333333
时间,1,0,1,0,3,3,0,8,2.575
damoc模型,0,0,1,0,9,0,0,10,2.3
00,0,0,0,0,4,0,0,4,0.9666666666666667
td003,0,0,0,0,7,0,0,7,1.6916666666666667
域自适应机制,0,0,0,0,4,0,0,4,0.9666666666666667
基准模型,0,0,4,0,2,0,0,6,0.9833333333333334
dnn,0,0,0,0,3,0,0,3,0.725
小搜索,0,0,0,0,1,0,0,1,0.24166666666666667
索法,0,0,0,0,1,0,0,1,0.24166666666666667
赋值,0,0,0,0,4,0,0,4,0.9666666666666667
随机,0,0,0,0,1,0,0,1,0.24166666666666667
评估值,0,0,0,0,1,0,0,1,0.24166666666666667
rmse-subm,0,0,0,0,1,0,0,1,0.24166666666666667
平均值,0,0,0,0,3,0,0,3,0.725
动态域自适应因子,0,0,0,0,1,0,0,1,0.24166666666666667
均值,0,0,0,2,2,0,0,4,0.7333333333333334
平均,0,0,0,0,1,0,0,1,0.24166666666666667
时间窗长度,0,0,0,0,4,0,0,4,0.9666666666666667
teslam,0,0,0,0,1,0,0,1,0.24166666666666667
操作工况,0,0,1,0,1,0,0,2,0.3666666666666667
退化阶段,0,0,2,0,1,0,0,3,0.4916666666666667
评价,0,0,0,0,1,0,0,1,0.24166666666666667
lgb,0,0,0,0,1,0,0,1,0.24166666666666667
全寿命子数据集,0,0,0,0,1,0,0,1,0.24166666666666667
轴承数,0,0,0,0,1,0,0,1,0.24166666666666667
dam0c,0,0,0,0,1,0,0,1,0.24166666666666667
负迁移,0,0,0,0,1,0,0,1,0.24166666666666667
td002,0,0,0,0,3,0,0,3,0.725
001,0,0,0,0,4,0,0,4,0.9666666666666667
工况条件,0,0,0,0,1,0,0,1,0.24166666666666667
sae-lstm模型,0,0,0,0,5,0,0,5,1.2083333333333333
dasl算法,0,0,0,0,1,0,0,1,0.24166666666666667
sae-lstm算法,0,0,0,0,1,0,0,1,0.24166666666666667
distance,0,0,0,0,1,0,0,1,0.24166666666666667
动态调整,0,0,0,0,1,0,0,1,0.24166666666666667
工况影响,0,0,0,0,1,0,0,1,0.24166666666666667
domainadaptations,0,0,0,0,3,0,0,3,0.725
深度,0,0,0,0,1,0,0,1,0.24166666666666667
sae,0,0,5,3,7,0,0,15,2.6916666666666664
时序数据,0,0,1,0,1,0,0,2,0.3666666666666667
神经网络,0,0,1,0,2,0,0,3,0.6083333333333334
gbdt模型,0,0,0,0,1,0,0,1,0.24166666666666667
内存消耗,0,0,0,0,1,0,0,1,0.24166666666666667
训练速度,0,0,0,0,1,0,0,1,0.24166666666666667
预排序遍历算法,0,0,0,0,1,0,0,1,0.24166666666666667
分割算法,0,0,0,0,1,0,0,1,0.24166666666666667
直方图,0,0,0,0,1,0,0,1,0.24166666666666667
gbdt算法,0,0,0,0,1,0,0,1,0.24166666666666667
lightgbmro,0,0,0,0,1,0,0,1,0.24166666666666667
对比模型,0,0,0,0,1,0,0,1,0.24166666666666667
评分函数,0,0,0,0,3,0,0,3,0.725
均方根误差,0,0,0,0,3,0,0,3,0.725
评价标准,0,0,0,0,1,0,0,1,0.24166666666666667
数据分布差异度量指标,0,0,0,2,0,0,0,2,0.25
条件分布自适应,0,0,0,3,0,0,0,3,0.375
边缘分布自适应,0,0,0,2,0,0,0,2,0.25
时频域特征,0,0,0,2,1,0,0,3,0.4916666666666667
频域特征提取,0,0,0,2,0,0,0,2,0.25
时域特征提取,0,0,0,2,0,0,0,2,0.25
信号特征提取,0,0,0,3,0,0,0,3,0.375
径向力,0,0,0,4,0,0,0,4,0.5
实验平台,0,0,0,4,0,0,0,4,0.5
文件,0,0,0,3,0,0,0,3,0.375
磨损时期,0,0,0,2,0,0,0,2,0.25
采样频率,0,0,0,2,0,0,0,2,0.25
温度信号,0,0,0,2,0,0,0,2,0.25
pronostia,0,0,0,2,0,0,0,2,0.25
phm2012,0,0,3,2,2,0,0,7,1.1083333333333334
频域特征,0,0,1,1,1,0,0,3,0.4916666666666667
时域特征,0,0,0,1,2,0,0,3,0.6083333333333334
震动信号,0,0,0,1,0,0,0,1,0.125
下转速,0,0,0,1,0,0,0,1,0.125
测量部件,0,0,0,1,0,0,0,1,0.125
退化生成部件,0,0,0,1,0,0,0,1,0.125
旋转部件,0,0,0,1,0,0,0,1,0.125
承磨损退化实验,0,0,0,1,0,0,0,1,0.125
测数据,0,0,0,1,0,0,0,1,0.125
自编码器,0,0,0,8,0,0,0,8,1.0
特征维数,0,0,0,4,0,0,0,4,0.5
隐藏神经元,0,0,0,3,0,0,0,3,0.375
正则项,0,0,0,2,0,0,0,2,0.25
稀疏约束项,0,0,0,2,0,0,0,2,0.25
平均激活度压,0,0,0,2,0,0,0,2,0.25
激活值,0,0,0,2,0,0,0,2,0.25
惩罚系数,0,0,0,1,0,0,0,1,0.125
稀疏项,0,0,0,1,0,0,0,1,0.125
过拟合,0,0,0,1,0,0,0,1,0.125
神经元,0,0,0,1,0,0,0,1,0.125
稀疏项惩罚,0,0,0,1,0,0,0,1,0.125
fc,0,0,0,1,1,0,0,2,0.3666666666666667
kl散度,0,0,1,2,0,0,0,3,0.375
平均稀疏激活度,0,0,0,1,0,0,0,1,0.125
常数,0,0,0,1,0,0,0,1,0.125
稀疏约束,0,0,0,1,0,0,0,1,0.125
惩罚因子,0,0,0,1,0,0,0,1,0.125
稀疏自编码器算法,0,0,0,1,0,0,0,1,0.125
稀疏表达,0,0,0,1,0,0,0,1,0.125
庞虫心,0,0,0,1,0,0,0,1,0.125
样本集,0,0,0,2,0,0,0,2,0.25
降维,0,0,0,1,0,0,0,1,0.125
稀疏特征,0,0,0,1,0,0,0,1,0.125
稀疏惩罚项,0,0,0,1,0,0,0,1,0.125
特征提取能力,0,0,0,1,0,0,0,1,0.125
mmd,0,0,1,7,2,0,0,10,1.4833333333333334
距离,0,0,0,6,0,0,0,6,0.75
希尔伯特空间,0,0,0,3,0,0,0,3,0.375
度量指标,0,0,0,2,0,0,0,2,0.25
数据分布差异,0,0,2,1,0,0,0,3,0.375
核技,0,0,0,1,0,0,0,1,0.125
运算复杂度,0,0,0,1,0,0,0,1,0.125
平均距离,0,0,0,2,0,0,0,2,0.25
距离度量准则,0,0,0,1,0,0,0,1,0.125
cy,0,0,0,1,0,0,0,1,0.125
ep,0,0,0,1,0,0,0,1,0.125
maximummeandis,0,0,0,1,1,0,0,2,0.3666666666666667
最大均值差异,0,0,0,2,1,0,0,3,0.4916666666666667
kz,0,0,0,1,0,0,0,1,0.125
iblerdivergence,0,0,0,1,0,0,0,1,0.125
kullback-,0,0,0,1,0,0,0,1,0.125
cosinedistance,0,0,0,1,0,0,0,1,0.125
余弦距离,0,0,0,1,0,0,0,1,0.125
by,0,0,0,1,0,0,0,1,0.125
chebyshevdista,0,0,0,1,0,0,0,1,0.125
切比雪夫距离,0,0,0,1,0,0,0,1,0.125
tan,0,0,0,1,0,0,0,1,0.125
man,0,0,0,1,0,0,0,1,0.125
manhattandistance,0,0,0,1,0,0,0,1,0.125
曼哈顿距离,0,0,0,1,0,0,0,1,0.125
de,0,0,0,1,0,0,0,1,0.125
uc,0,0,0,1,0,0,0,1,0.125
euclideandistance,0,0,0,1,0,0,0,1,0.125
欧式距离,0,0,0,1,0,0,0,1,0.125
数据分布度量,0,0,0,1,0,0,0,1,0.125
度量数据,0,0,0,1,0,0,0,1,0.125
差异度量,0,0,0,1,0,0,0,1,0.125
分布度量,0,0,0,1,0,0,0,1,0.125
安全生产,0,0,1,0,0,0,0,1,0.125
预测算法,0,0,2,0,1,1,0,4,0.7333333333333334
运维管理,0,0,3,0,0,4,0,7,1.3416666666666668
泛化能力,0,0,1,0,0,0,0,1,0.125
训练模型,0,0,1,0,0,0,0,1,0.125
剩余使用寿命预测模型,0,0,2,0,0,0,0,2,0.25
迁移学习技术,0,0,1,3,0,0,0,4,0.5
迁移学习理论,0,0,1,0,0,0,0,1,0.125
运动轨迹,0,0,0,0,5,0,0,5,1.2083333333333333
退化状态,0,0,0,0,3,0,0,3,0.725
相对坐标,0,0,0,0,3,0,0,3,0.725
状态,0,0,2,0,2,0,0,4,0.7333333333333334
相关系数,0,0,0,0,2,0,0,2,0.48333333333333334
起始位置数据,0,0,0,0,2,0,0,2,0.48333333333333334
电机,0,0,0,0,2,0,0,2,0.48333333333333334
生命周期,0,0,0,1,2,2,0,5,1.0916666666666668
快速退化,0,0,0,0,1,0,0,1,0.24166666666666667
轴承编号,0,0,0,0,1,0,0,1,0.24166666666666667
轴承数据集退化状,0,0,0,0,1,0,0,1,0.24166666666666667
相关系数曲线,0,0,0,0,1,0,0,1,0.24166666666666667
退化周期,0,0,0,0,1,0,0,1,0.24166666666666667
基准值,0,0,0,0,1,0,0,1,0.24166666666666667
采集数据,0,0,0,0,1,0,0,1,0.24166666666666667
递减曲线,0,0,0,0,1,0,0,1,0.24166666666666667
皮尔逊相关系,0,0,0,0,1,0,0,1,0.24166666666666667
无磨损,0,0,0,0,1,0,0,1,0.24166666666666667
电机转速,0,0,0,0,1,0,0,1,0.24166666666666667
轴承故障,0,0,1,0,1,0,0,2,0.3666666666666667
phm2,0,0,0,0,1,0,0,1,0.24166666666666667
td00,0,0,0,0,1,0,0,1,0.24166666666666667
运动路径,0,0,0,0,1,0,0,1,0.24166666666666667
切削模式,0,0,0,0,1,0,0,1,0.24166666666666667
切削过,0,0,0,0,1,0,0,1,0.24166666666666667
波浪式切削,0,0,0,0,1,0,0,1,0.24166666666666667
切削,0,0,0,2,1,0,0,3,0.4916666666666667
td001,0,0,0,0,1,0,0,1,0.24166666666666667
刀具运动轨迹,0,0,0,0,1,0,0,1,0.24166666666666667
切削工况,0,0,0,0,1,0,0,1,0.24166666666666667
工件,0,0,0,0,1,0,0,1,0.24166666666666667
三维图像,0,0,0,0,1,0,0,1,0.24166666666666667
散点坐标,0,0,0,0,1,0,0,1,0.24166666666666667
折线图,0,0,0,0,1,1,0,2,0.48333333333333334
控制器信号,0,0,0,0,1,0,0,1,0.24166666666666667
磨损状态,0,0,1,1,1,0,0,3,0.4916666666666667
磨损状,0,0,0,1,1,0,0,2,0.3666666666666667
初始状态,0,0,0,1,1,0,0,2,0.3666666666666667
子数据集,0,0,0,1,4,0,0,5,1.0916666666666668
富士康,0,0,1,1,1,0,0,3,0.4916666666666667
削加工场,0,0,0,1,1,0,0,2,0.3666666666666667
工业大数据创新,0,0,0,0,1,0,0,1,0.24166666666666667
信通,0,0,0,1,1,0,0,2,0.3666666666666667
逻辑层,0,0,0,0,0,7,0,7,1.6916666666666667
视图层,0,0,0,0,0,7,0,7,1.6916666666666667
数据服务层,0,0,0,0,0,6,0,6,1.45
云数据库,0,0,0,0,0,8,0,8,1.9333333333333333
增删,0,0,0,0,0,1,0,1,0.24166666666666667
云开发控制台,0,0,0,0,0,1,0,1,0.24166666666666667
云函数,0,0,0,0,0,5,0,5,1.2083333333333333
微信,0,0,0,0,0,3,0,3,0.725
增删改查操作,0,0,0,0,0,1,0,1,0.24166666666666667
数据读取,0,0,0,0,0,1,0,1,0.24166666666666667
数据存储,0,0,0,0,0,1,0,1,0.24166666666666667
交互,0,0,0,0,0,1,0,1,0.24166666666666667
读取,0,0,0,0,0,1,0,1,0.24166666666666667
视图,0,0,0,0,0,1,0,1,0.24166666666666667
逻辑交互,0,0,0,0,0,1,0,1,0.24166666666666667
数据处理,0,0,0,0,0,1,0,1,0.24166666666666667
配置信息,0,0,0,0,0,1,0,1,0.24166666666666667
json文件,0,0,0,0,0,1,0,1,0.24166666666666667
逻辑结构,0,0,0,0,0,1,0,1,0.24166666666666667
js文件,0,0,0,0,0,1,0,1,0.24166666666666667
页面样式,0,0,0,0,0,1,0,1,0.24166666666666667
wxss文件,0,0,0,0,0,1,0,1,0.24166666666666667
页面结构,0,0,0,0,0,1,0,1,0.24166666666666667
wxml,0,0,0,0,0,1,0,1,0.24166666666666667
wxmrwxss,0,0,0,0,0,1,0,1,0.24166666666666667
可视化,0,0,0,0,0,2,0,2,0.48333333333333334
前端,0,0,0,0,0,2,0,2,0.48333333333333334
交互功能,0,0,0,0,0,1,0,1,0.24166666666666667
界面渲染功能,0,0,0,0,0,1,0,1,0.24166666666666667
操作界面,0,0,0,0,0,1,0,1,0.24166666666666667
维修工单,0,0,0,0,0,3,0,3,0.725
设备台账数,0,0,0,0,0,1,0,1,0.24166666666666667
人员信息数据,0,0,0,0,0,1,0,1,0.24166666666666667
数据存储层,0,0,0,0,0,1,0,1,0.24166666666666667
预警,0,0,2,0,0,10,0,12,2.6666666666666665
业务逻辑层,0,0,0,0,0,1,0,1,0.24166666666666667
界面,0,0,0,0,0,1,0,1,0.24166666666666667
ft页界面,0,0,0,0,0,1,0,1,0.24166666666666667
运维系统,0,0,0,0,0,20,0,20,4.833333333333333
自适应技术,1,0,4,2,1,0,0,8,1.9916666666666667
机床,0,0,0,2,0,0,0,2,0.25
传感器数据,0,0,2,2,0,0,0,4,0.5
磨损速度,0,0,0,1,0,0,0,1,0.125
部件,1,0,0,1,0,0,0,2,1.125
刀具数据,0,0,0,1,1,0,0,2,0.3666666666666667
刀具3,0,0,0,1,0,0,0,1,0.125
原始数据文件,0,0,0,1,0,0,0,1,0.125
连续采集,0,0,0,1,0,0,0,1,0.125
时间信息,0,0,0,1,0,0,0,1,0.125
刀具坐标信息,0,0,0,1,0,0,0,1,0.125
主轴负载信号,0,0,0,1,0,0,0,1,0.125
控制器数据,0,0,0,1,0,0,0,1,0.125
原始子数据集,0,0,0,1,0,0,0,1,0.125
工程,0,0,2,0,0,3,0,5,0.975
富士康刀具数据集,0,0,2,0,1,0,0,3,0.4916666666666667
复杂工况,0,0,1,0,0,0,0,1,0.125
工业数据,0,0,1,0,2,0,0,3,0.6083333333333334
距离度量指标,0,0,1,1,0,0,0,2,0.25
特征提取算法,0,0,1,0,0,0,0,1,0.125
自适应算法,0,0,3,0,0,0,0,3,0.375
故障诊断,0,0,3,0,0,1,0,4,0.6166666666666667
tabbar,0,0,0,0,0,2,0,2,0.48333333333333334
密码,0,0,0,0,0,2,0,2,0.48333333333333334
账号,0,0,0,0,0,2,0,2,0.48333333333333334
权限,0,0,0,0,0,2,0,2,0.48333333333333334
用户,0,0,0,0,0,2,0,2,0.48333333333333334
export,0,0,0,0,0,1,0,1,0.24166666666666667
list内容,0,0,0,0,0,1,0,1,0.24166666666666667
bar,0,0,0,0,0,1,0,1,0.24166666666666667
底部导航,0,0,0,0,0,1,0,1,0.24166666666666667
js,0,0,0,0,0,1,0,1,0.24166666666666667
app,0,0,0,0,0,1,0,1,0.24166666666666667
用户身份,0,0,0,0,0,1,0,1,0.24166666666666667
校验,0,0,0,0,0,1,0,1,0.24166666666666667
用户信息表,0,0,0,0,0,1,0,1,0.24166666666666667
后台数据库,0,0,0,0,0,1,0,1,0.24166666666666667
登录页,0,0,0,0,0,1,0,1,0.24166666666666667
技术,0,0,0,0,0,7,0,7,1.6916666666666667
传运维系统,0,0,0,0,0,1,0,1,0.24166666666666667
运维,1,0,0,0,0,2,0,3,1.4833333333333334
组件,0,0,0,0,0,1,0,1,0.24166666666666667
可调用api,0,0,0,0,0,1,0,1,0.24166666666666667
app开,0,0,0,0,0,1,0,1,0.24166666666666667
操作系统,0,0,0,0,0,1,0,1,0.24166666666666667
运维人员,0,0,0,0,0,1,0,1,0.24166666666666667
任务管,0,0,0,0,0,1,0,1,0.24166666666666667
预测设备,0,0,0,0,0,1,0,1,0.24166666666666667
外勤技术人,0,0,0,0,0,4,0,4,0.9666666666666667
工厂运维管理人员,0,0,0,0,0,1,0,1,0.24166666666666667
工厂设备,0,0,0,0,0,1,0,1,0.24166666666666667
价值,0,0,0,0,0,1,0,1,0.24166666666666667
任务管理,1,0,2,0,0,4,0,7,2.216666666666667
历史数据,1,0,2,0,0,7,0,10,2.9416666666666664
预测性维护系统,0,0,0,0,0,1,0,1,0.24166666666666667
人工智能技术,0,0,0,0,0,1,0,1,0.24166666666666667
数据采集,0,0,0,0,0,1,0,1,0.24166666666666667
物联网系统,0,0,0,0,0,1,0,1,0.24166666666666667
预测性维护策略,0,0,1,0,0,1,0,2,0.3666666666666667
故障,0,0,7,0,0,9,0,16,3.05
维护,0,0,0,0,0,3,0,3,0.725
安全保障,0,0,0,0,0,1,0,1,0.24166666666666667
负迁移效应,0,0,1,3,1,0,0,5,0.7416666666666667
样本特征数据,0,0,0,1,0,0,0,1,0.125
特征数据,0,0,0,1,0,0,0,1,0.125
久机,0,0,0,1,0,0,0,1,0.125
类别,0,0,0,1,0,0,0,1,0.125
mmdg,0,0,0,1,0,0,0,1,0.125
nce,0,0,0,1,0,0,0,1,0.125
di,0,0,0,1,0,0,0,1,0.125
类内迁移,0,0,0,1,0,0,0,1,0.125
功率谱,0,0,0,6,2,0,0,8,1.2333333333333334
傅里叶变换,0,0,0,4,1,0,0,5,0.7416666666666667
统计特征,0,0,0,3,1,0,0,4,0.6166666666666667
统计量,0,0,0,1,1,0,0,2,0.3666666666666667
welch,0,0,0,1,0,0,0,1,0.125
相位谱,0,0,0,1,0,0,0,1,0.125
幅度谱,0,0,0,1,0,0,0,1,0.125
特性,0,0,0,1,0,0,0,1,0.125
故障时间,0,0,0,0,0,1,0,1,0.24166666666666667
维修工,0,0,0,0,0,2,0,2,0.48333333333333334
设备故障,0,0,0,0,0,3,0,3,0.725
故障工单,0,0,0,0,0,1,0,1,0.24166666666666667
运维管理人,0,0,0,0,0,3,0,3,0.725
停机维,0,0,0,0,0,1,0,1,0.24166666666666667
外勤维修,0,0,0,0,0,1,0,1,0.24166666666666667
运维管理系统,0,0,0,0,0,2,0,2,0.48333333333333334
智能,0,0,0,0,0,1,0,1,0.24166666666666667
资产管理系统,0,0,0,0,0,1,0,1,0.24166666666666667
工单管理系统,0,0,0,0,0,1,0,1,0.24166666666666667
数据分析系统,0,0,0,0,0,1,0,1,0.24166666666666667
人工智能算法,0,0,2,0,1,1,0,4,0.7333333333333334
性能指标,0,0,0,0,0,1,0,1,0.24166666666666667
功能测试表,0,0,0,0,0,1,0,1,0.24166666666666667
核心模块,0,0,0,0,0,1,0,1,0.24166666666666667
历史数据统计,0,0,0,0,0,1,0,1,0.24166666666666667
传感器信号,0,0,0,1,4,0,0,5,1.0916666666666668
填充,0,0,0,0,1,0,0,1,0.24166666666666667
空值,0,0,0,0,1,0,0,1,0.24166666666666667
溢出,0,0,0,0,1,0,0,1,0.24166666666666667
信号缺失值,0,0,0,0,1,0,0,1,0.24166666666666667
波动,0,0,0,0,1,0,0,1,0.24166666666666667
截断,0,0,0,0,1,0,0,1,0.24166666666666667
振动加速度,0,0,0,0,1,0,0,1,0.24166666666666667
信号波形,0,0,0,0,1,0,0,1,0.24166666666666667
无效信号,0,0,0,0,1,0,0,1,0.24166666666666667
数据时间窗,0,0,0,0,1,0,0,1,0.24166666666666667
预处理,0,0,0,0,1,0,0,1,0.24166666666666667
边缘概率分布,0,0,0,0,2,0,0,2,0.48333333333333334
样本数据,0,0,0,1,2,0,0,3,0.6083333333333334
样本数量,0,0,0,0,2,0,0,2,0.48333333333333334
时间序列数据,0,0,0,0,3,0,0,3,0.725
pq主p,0,0,0,0,1,0,0,1,0.24166666666666667
训练数据,3,0,1,0,2,0,0,6,3.6083333333333334
待预测值,0,0,0,0,1,0,0,1,0.24166666666666667
se,0,0,0,0,1,0,0,1,0.24166666666666667
源域数据,0,0,0,0,2,0,0,2,0.48333333333333334
设备传感器,0,0,0,0,1,0,0,1,0.24166666666666667
ext,0,0,0,0,1,0,0,1,0.24166666666666667
xsexs,0,0,0,0,1,0,0,1,0.24166666666666667
滑动窗口,0,0,0,0,1,0,0,1,0.24166666666666667
小时间窗,0,0,0,0,1,0,0,1,0.24166666666666667
滑动时间窗,0,0,0,0,1,0,0,1,0.24166666666666667
原始数据集,0,0,0,0,1,0,0,1,0.24166666666666667
特征维度,0,0,0,1,1,0,0,2,0.3666666666666667
分布自适应技术,0,0,0,0,2,0,0,2,0.48333333333333334
监测,0,0,1,0,1,0,0,2,0.3666666666666667
多维,0,0,0,0,1,0,0,1,0.24166666666666667
解码器,0,0,0,6,0,0,0,6,0.75
编码器,0,0,0,5,1,0,0,6,0.8666666666666667
偏置,0,0,0,2,0,0,0,2,0.25
非线性映射函数,0,0,0,1,0,0,0,1,0.125
auto-encoder,0,0,0,1,0,0,0,1,0.125
深度学习网络,0,0,0,1,0,0,0,1,0.125
自动编码器,0,0,0,1,0,0,0,1,0.125
方差,0,0,0,1,2,1,0,4,0.85
系数,0,0,0,0,1,0,0,1,0.24166666666666667
自回归模型,0,0,0,0,1,0,0,1,0.24166666666666667
能量特征,0,0,0,0,1,0,0,1,0.24166666666666667
wavedec函数,0,0,0,0,1,0,0,1,0.24166666666666667
5级小波变换,0,0,0,0,1,0,0,1,0.24166666666666667
裕度,0,0,0,0,1,0,0,1,0.24166666666666667
脉冲值,0,0,0,0,1,0,0,1,0.24166666666666667
峰值因子,0,0,0,0,1,0,0,1,0.24166666666666667
波形因子,0,0,0,0,1,0,0,1,0.24166666666666667
峰度,0,0,0,0,1,0,0,1,0.24166666666666667
偏度,0,0,0,1,1,0,0,2,0.3666666666666667
均方根值,0,0,0,0,1,0,0,1,0.24166666666666667
最小值,0,0,0,0,1,0,0,1,0.24166666666666667
最大值,0,0,0,0,1,0,0,1,0.24166666666666667
提取信号,0,0,0,0,1,0,0,1,0.24166666666666667
能量,0,0,0,0,1,0,0,1,0.24166666666666667
功率,0,0,1,0,1,0,0,2,0.3666666666666667
外勤技术,0,0,0,0,0,3,0,3,0.725
model,0,0,0,0,0,4,0,4,0.9666666666666667
调度中心,0,0,0,0,0,2,0,2,0.48333333333333334
数据统计模块,0,0,0,0,0,3,0,3,0.725
调度,0,0,0,0,0,2,0,2,0.48333333333333334
运维管理人员,1,0,0,0,0,1,0,2,1.2416666666666667
部门考勤,0,0,0,0,0,3,0,3,0.725
工单记录,0,0,0,0,0,3,0,3,0.725
维修记录,0,0,0,0,0,6,0,6,1.45
数据统计模,0,0,0,0,0,1,0,1,0.24166666666666667
设备状态统计,0,0,0,0,0,1,0,1,0.24166666666666667
工单数量,0,0,0,0,0,2,0,2,0.48333333333333334
核心监测指标,0,0,0,0,0,1,0,1,0.24166666666666667
平台,0,0,0,0,0,2,0,2,0.48333333333333334
phm平台,0,0,0,0,0,3,0,3,0.725
joblib,0,0,0,0,0,2,0,2,0.48333333333333334
前端界面,0,0,0,0,0,1,0,1,0.24166666666666667
预测模型,1,0,0,0,0,1,0,2,1.2416666666666667
rul预测模块,0,0,0,0,0,2,0,2,0.48333333333333334
实时监测模块,0,0,0,0,0,3,0,3,0.725
外勤技术人员,0,0,0,0,0,3,0,3,0.725
警报,0,0,0,0,0,1,0,1,0.24166666666666667
安全剩余,0,0,0,0,0,1,0,1,0.24166666666666667
正常设备,0,0,0,0,0,1,0,1,0.24166666666666667
已故障设备,0,0,0,0,0,1,0,1,0.24166666666666667
正常运行设备,0,0,0,0,0,1,0,1,0.24166666666666667
前端页面,0,0,0,0,0,1,0,1,0.24166666666666667
诊断模块,0,0,0,0,0,1,0,1,0.24166666666666667
子功能,0,0,0,0,0,1,0,1,0.24166666666666667
hkl散度,0,0,3,0,0,0,0,3,0.375
跨域特征,0,0,3,0,0,0,0,3,0.375
速度,0,0,3,0,0,0,0,3,0.375
变速箱,0,0,2,0,0,0,0,2,0.25
tca,0,0,2,0,0,0,0,2,0.25
转移成分分析,0,0,2,0,0,0,0,2,0.25
领域自适应,1,0,3,0,1,0,0,5,1.6166666666666667
工作条件,0,0,1,0,0,0,0,1,0.125
时间依赖性,0,0,1,0,0,0,0,1,0.125
双向长短期记忆网络,0,0,1,0,0,0,0,1,0.125
无监督对抗域,0,0,1,0,0,0,0,1,0.125
端到端,0,0,1,0,0,0,0,1,0.125
涡扇发动机,0,0,1,0,0,0,0,1,0.125
体系结构,0,0,1,0,0,0,0,1,0.125
lssvm,0,0,1,0,0,0,0,1,0.125
二乘支持向量机,0,0,1,0,0,0,0,1,0.125
深度自适应特征,0,0,1,0,0,0,0,1,0.125
cdae,0,0,1,0,0,0,0,1,0.125
压缩去噪自动编码器,0,0,1,0,0,0,0,1,0.125
权值更新,0,0,1,0,0,0,0,1,0.125
隐藏特征转移,0,0,1,0,0,0,0,1,0.125
权值转移,0,0,1,0,0,0,0,1,0.125
dtl,0,0,1,0,0,0,0,1,0.125
深度转移学习,0,0,1,0,0,0,0,1,0.125
稀疏自动编码器,0,0,1,0,0,0,0,1,0.125
齿轮箱数据集,0,0,1,0,0,0,0,1,0.125
滚动轴承数据集,0,0,1,0,0,0,0,1,0.125
健康,0,0,1,0,0,0,0,1,0.125
softmax,0,0,1,0,0,0,0,1,0.125
特征分类,0,0,1,0,0,0,0,1,0.125
共享特征,0,0,1,0,0,0,0,1,0.125
稀疏滤波,0,0,1,0,0,0,0,1,0.125
故障诊断网络,0,0,1,0,0,0,0,1,0.125
迁移学,0,0,1,0,0,0,0,1,0.125
散度,0,0,1,0,0,0,0,1,0.125
hkl,0,0,1,0,0,0,0,1,0.125
高阶kullback-leibler,0,0,1,0,0,0,0,1,0.125
数据集分布差异度量算法,0,0,1,0,0,0,0,1,0.125
cmdp2,0,0,1,0,0,0,0,1,0.125
传递学习模型,0,0,1,0,0,0,0,1,0.125
健康状态,0,0,4,0,0,0,0,4,0.5
机车轴承,0,0,1,0,0,0,0,1,0.125
高斯核,0,0,1,1,0,0,0,2,0.25
多项式核,0,0,1,1,0,0,0,2,0.25
pk-mmd,0,0,1,0,0,0,0,1,0.125
多项式核诱导mmd,0,0,1,0,0,0,0,1,0.125
距离度量,0,0,1,0,1,0,0,2,0.3666666666666667
测量,0,0,1,0,0,0,0,1,0.125
分布匹配,0,0,1,0,0,0,0,1,0.125
深度传输网络,0,0,1,0,0,0,0,1,0.125
jda,0,0,1,0,0,0,0,1,0.125
联合分布自适应,0,0,1,0,0,0,0,1,0.125
断性能,0,0,1,0,0,0,0,1,0.125
cnn,0,0,2,0,0,0,0,2,0.25
卷积神经网络,0,0,2,0,0,0,0,2,0.25
跨域故障诊断,0,0,1,0,0,0,0,1,0.125
域不变特征,0,0,1,0,0,0,0,1,0.125
大平均差异损失,0,0,1,0,0,0,0,1,0.125
多核,0,0,1,0,0,0,0,1,0.125
域混淆,0,0,1,0,0,0,0,1,0.125
对抗性,0,0,1,0,0,0,0,1,0.125
das模型,0,0,1,0,0,0,0,1,0.125
边际分布,0,0,1,0,0,0,0,1,0.125
未知数据,0,0,1,0,0,0,0,1,0.125
转移学习技术,0,0,1,0,0,0,0,1,0.125
dsa,0,0,1,0,0,0,0,1,0.125
动态安全评估,0,0,1,0,0,0,0,1,0.125
传输能力,0,0,1,0,0,0,0,1,0.125
对抗策略,0,0,1,0,0,0,0,1,0.125
不变特征,0,0,1,0,0,0,0,1,0.125
跨域,0,0,1,0,0,0,0,1,0.125
wdman,0,0,1,0,0,0,0,1,0.125
迁移学习模型,0,0,1,0,0,1,0,2,0.3666666666666667
基线降维,0,0,1,0,0,0,0,1,0.125
tca性能,0,0,1,0,0,0,0,1,0.125
核函数,0,0,1,0,0,0,0,1,0.125
试验台,0,0,1,0,0,0,0,1,0.125
融合,0,0,1,0,0,0,0,1,0.125
跨域特征提取,0,0,1,0,0,0,0,1,0.125
相似性,0,0,1,0,0,0,0,1,0.125
操作条件,0,0,1,0,0,0,0,1,0.125
微调,0,0,1,0,0,0,0,1,0.125
神经网络结构,0,0,1,0,0,0,0,1,0.125
潜在特征,0,0,1,0,2,0,0,3,0.6083333333333334
故障诊断算法,0,0,1,0,0,0,0,1,0.125
ature,0,0,1,0,0,0,0,1,0.125
nt,0,0,1,0,0,0,0,1,0.125
学习系统,0,0,1,0,0,0,0,1,0.125
迁移学习方法,0,0,1,0,0,0,0,1,0.125
测试数据集,0,0,1,0,1,0,0,2,0.3666666666666667
训练数据集,0,0,1,0,1,0,0,2,0.3666666666666667
台账,0,0,0,0,0,2,0,2,0.48333333333333334
报废待处理设备,0,0,0,0,0,1,0,1,0.24166666666666667
旧设备,0,0,0,0,0,1,0,1,0.24166666666666667
半新设备,0,0,0,0,0,1,0,1,0.24166666666666667
全新设备,0,0,0,0,0,1,0,1,0.24166666666666667
鉴定,0,0,0,0,0,1,0,1,0.24166666666666667
价值评估结,0,0,0,0,0,1,0,1,0.24166666666666667
函数,0,0,0,0,0,2,0,2,0.48333333333333334
cal,0,0,0,0,0,1,0,1,0.24166666666666667
计算,0,0,0,0,0,1,0,1,0.24166666666666667
价值评估算法,0,0,0,0,0,1,0,1,0.24166666666666667
成新率参数,0,0,0,0,0,1,0,1,0.24166666666666667
综合成新率,0,0,0,0,0,1,0,1,0.24166666666666667
鉴率,0,0,0,0,0,1,0,1,0.24166666666666667
钿诙率,0,0,0,0,0,1,0,1,0.24166666666666667
成本,0,0,0,0,0,1,0,1,0.24166666666666667
价值评估模块,0,0,0,0,0,1,0,1,0.24166666666666667
设备价值评估模块,0,0,0,0,0,1,0,1,0.24166666666666667
査询云函数,0,0,0,0,0,1,0,1,0.24166666666666667
台账名称数组,0,0,0,0,0,1,0,1,0.24166666666666667
block组件,0,0,0,0,0,2,0,2,0.48333333333333334
ll,0,0,0,0,0,1,0,1,0.24166666666666667
滚动,0,0,0,0,0,1,0,1,0.24166666666666667
scroll-view组件,0,0,0,0,0,1,0,1,0.24166666666666667
供应商,0,0,0,0,0,1,0,1,0.24166666666666667
采购人,0,0,0,0,0,1,0,1,0.24166666666666667
设备id,0,0,0,0,0,1,0,1,0.24166666666666667
生产维修计划,0,0,0,0,0,1,0,1,0.24166666666666667
管理周期,0,0,0,0,0,1,0,1,0.24166666666666667
台账查询,0,0,0,0,0,1,0,1,0.24166666666666667
全连接层,0,0,1,0,4,0,0,5,1.0916666666666668
源域数据集,0,0,0,1,2,0,0,3,0.6083333333333334
分布差,0,0,0,0,1,0,0,1,0.24166666666666667
损失项,0,0,0,0,1,0,0,1,0.24166666666666667
损失,0,0,0,0,3,0,0,3,0.725
预测值,0,0,0,0,2,0,0,2,0.48333333333333334
域自适应损失,0,0,0,0,1,0,0,1,0.24166666666666667
目标域数据集,0,0,0,1,1,0,0,2,0.3666666666666667
深度网络,0,0,0,0,1,0,0,1,0.24166666666666667
频率,0,0,1,0,1,0,0,2,0.3666666666666667
中间密度,0,0,0,0,1,0,0,1,0.24166666666666667
非参数距离,0,0,0,0,1,0,0,1,0.24166666666666667
评估准则,0,0,0,0,1,0,0,1,0.24166666666666667
度量,0,0,0,0,1,0,0,1,0.24166666666666667
sae提取,0,0,0,0,1,0,0,1,0.24166666666666667
时间序列预测,0,0,0,0,1,0,0,1,0.24166666666666667
时间依赖特性,0,0,0,0,1,0,0,1,0.24166666666666667
源数据,0,0,0,0,1,0,0,1,0.24166666666666667
非线性特性,0,0,0,0,1,0,0,1,0.24166666666666667
多层网络,0,0,0,0,1,0,0,1,0.24166666666666667
特征处理,0,0,0,0,1,0,0,1,0.24166666666666667
特征提取层,0,0,0,0,2,0,0,2,0.48333333333333334
lstmosae,0,0,0,0,1,0,0,1,0.24166666666666667
多层,0,0,0,0,1,0,0,1,0.24166666666666667
基础,0,0,0,0,1,0,0,1,0.24166666666666667
rul预测框架,0,0,0,0,1,0,0,1,0.24166666666666667
自适应sae-lstm模型,0,0,0,0,1,0,0,1,0.24166666666666667
put,0,0,0,0,1,0,0,1,0.24166666666666667
undermultipleoperation,1,0,1,0,2,0,0,4,1.6083333333333334
domainadaptationmethod,1,0,1,0,2,0,0,4,1.6083333333333334
领域自适应模型,0,0,0,0,3,0,0,3,0.725
多工况,1,0,1,0,2,0,0,4,1.6083333333333334
2damoc模型,0,0,0,0,1,0,0,1,0.24166666666666667
设备监测,0,0,0,0,0,3,0,3,0.725
调取,0,0,0,0,0,2,0,2,0.48333333333333334
调用流程,0,0,0,0,0,2,0,2,0.48333333333333334
运行机组,0,0,0,0,0,2,0,2,0.48333333333333334
timefbnnat,0,0,0,0,0,1,0,1,0.24166666666666667
报表功能,0,0,0,0,0,1,0,1,0.24166666666666667
工况参数表格,0,0,0,0,0,1,0,1,0.24166666666666667
数组,0,0,0,0,0,1,0,1,0.24166666666666667
数据调取,0,0,0,0,0,1,0,1,0.24166666666666667
fanid传入函数,0,0,0,0,0,1,0,1,0.24166666666666667
监听,0,0,0,0,0,1,0,1,0.24166666666666667
request,0,0,0,0,0,1,0,1,0.24166666666666667
wx,0,0,0,0,0,1,0,1,0.24166666666666667
工单派,0,0,0,0,0,1,0,1,0.24166666666666667
故障模,0,0,0,0,0,1,0,1,0.24166666666666667
运维监测平台,0,0,0,0,0,1,0,1,0.24166666666666667
份信息,0,0,0,0,0,1,0,1,0.24166666666666667
api身,0,0,0,0,0,1,0,1,0.24166666666666667
模型预测结果,0,0,0,0,0,1,0,1,0.24166666666666667
ken,0,0,0,0,0,1,0,1,0.24166666666666667
access_,0,0,0,0,0,1,0,1,0.24166666666666667
算法,0,0,0,0,1,3,0,4,0.9666666666666667
post请求,0,0,0,0,0,1,0,1,0.24166666666666667
服务器,0,0,0,0,0,1,0,1,0.24166666666666667
wx.request,0,0,0,0,0,1,0,1,0.24166666666666667
身份认证信息,0,0,0,0,0,1,0,1,0.24166666666666667
token,0,0,0,0,0,1,0,1,0.24166666666666667
access,0,0,0,0,0,1,0,1,0.24166666666666667
access_token,0,0,0,0,0,1,0,1,0.24166666666666667
apisecret,0,0,0,0,0,1,0,1,0.24166666666666667
apikey,0,0,0,0,0,1,0,1,0.24166666666666667
api身份信息,0,0,0,0,0,1,0,1,0.24166666666666667
身份认证,0,0,0,0,0,1,0,1,0.24166666666666667
平台api,0,0,0,0,0,1,0,1,0.24166666666666667
振动,0,0,0,0,0,1,0,1,0.24166666666666667
x振动,0,0,0,0,0,1,0,1,0.24166666666666667
剩余寿命,0,0,0,0,0,1,0,1,0.24166666666666667
1号轴承,0,0,0,0,0,1,0,1,0.24166666666666667
api封装,0,0,0,0,0,1,0,1,0.24166666666666667
测算,0,0,0,0,0,1,0,1,0.24166666666666667
特征趋势,0,0,0,0,0,1,0,1,0.24166666666666667
button,0,0,0,0,0,1,0,1,0.24166666666666667
故障设备数,0,0,0,0,0,1,0,1,0.24166666666666667
行设备,0,0,0,0,0,1,0,1,0.24166666666666667
柱状图,0,0,0,0,0,1,0,1,0.24166666666666667
机组数,0,0,0,0,0,1,0,1,0.24166666666666667
颜色,0,0,0,0,0,1,0,1,0.24166666666666667
模拟数据,0,0,0,0,0,1,0,1,0.24166666666666667
滞后预测,0,0,0,0,2,0,0,2,0.48333333333333334
工业制造,0,0,0,0,1,0,0,1,0.24166666666666667
提前预测,0,0,0,0,1,0,0,1,0.24166666666666667
待测试样本,0,0,0,0,1,0,0,1,0.24166666666666667
拟合,0,0,0,0,1,0,0,1,0.24166666666666667
设备资产,0,0,0,0,0,3,0,3,0.725
资产,0,0,0,0,0,1,0,1,0.24166666666666667
峰峰值,0,0,0,1,0,0,0,1,0.125
impulsefactor,0,0,0,1,0,0,0,1,0.125
脉冲因子,0,0,0,1,0,0,0,1,0.125
均方根,0,0,0,1,0,0,0,1,0.125
时频,0,0,0,1,0,0,0,1,0.125
参数信,0,0,0,0,0,1,0,1,0.24166666666666667
工厂安全需求,0,0,0,0,0,1,0,1,0.24166666666666667
物理模型,0,0,8,0,6,0,0,14,2.45
失效机理,0,0,2,0,2,0,0,4,0.7333333333333334
差异,1,0,2,0,1,0,0,4,1.4916666666666667
样本特征差异度量,0,0,0,0,1,0,0,1,0.24166666666666667
测试模型,0,0,0,0,1,0,0,1,0.24166666666666667
监测数据,0,0,1,0,1,0,0,2,0.3666666666666667
非线性映射能力,0,0,1,0,1,0,0,2,0.3666666666666667
工业生产领域,0,0,0,0,1,0,0,1,0.24166666666666667
模型参数,0,0,2,0,1,0,0,3,0.4916666666666667
数学模型,0,0,1,0,1,0,0,2,0.3666666666666667
润滑,0,0,1,0,1,0,0,2,0.3666666666666667
载荷,0,0,2,0,1,0,0,3,0.4916666666666667
材料,0,0,1,0,1,0,0,2,0.3666666666666667
退化现,0,0,0,0,1,0,0,1,0.24166666666666667
数学方程,0,0,1,0,1,0,0,2,0.3666666666666667
设备退化机理,0,0,0,0,1,0,0,1,0.24166666666666667
混合模型,0,0,3,0,1,0,0,4,0.6166666666666667
命预测模型,0,0,0,0,1,0,0,1,0.24166666666666667
线性回归,0,0,4,0,0,0,0,4,0.5
时间尺度,0,0,3,0,0,0,0,3,0.375
卡尔曼滤波,0,0,3,0,0,0,0,3,0.375
退化模型,0,0,3,0,0,0,0,3,0.375
裂纹长度,0,0,3,0,0,0,0,3,0.375
rvm,0,0,2,0,0,0,0,2,0.25
失效物理模型,0,0,2,0,0,0,0,2,0.25
向量机,0,0,2,0,0,0,0,2,0.25
emd,0,0,2,0,0,0,0,2,0.25
时间序列,0,0,2,0,0,0,0,2,0.25
生存概率,0,0,2,0,0,0,0,2,0.25
前馈神经网络,0,0,2,0,0,0,0,2,0.25
失效概率,0,0,2,0,0,0,0,2,0.25
老化因子,0,0,2,0,0,0,0,2,0.25
统计模型,0,0,2,0,0,0,0,2,0.25
锂离子电池,0,0,2,0,0,0,0,2,0.25
soh,0,0,2,0,0,0,0,2,0.25
失效阈值,0,0,2,0,0,0,0,2,0.25
映射关系,0,0,1,0,0,0,0,1,0.125
提取,0,0,1,0,0,0,0,1,0.125
人工特征,0,0,1,0,0,0,0,1,0.125
数据驱动方法,0,0,1,0,0,0,0,1,0.125
rulo,0,0,1,0,0,0,0,1,0.125
轨迹,0,0,1,0,0,0,0,1,0.125
播粒子,0,0,1,0,0,0,0,1,0.125
电池,0,0,1,0,0,0,0,1,0.125
粒子滤波,0,0,1,0,0,0,0,1,0.125
内部参数,0,0,1,0,0,0,0,1,0.125
电池模型,0,0,1,0,0,0,0,1,0.125
温度读数,0,0,1,0,0,0,0,1,0.125
阻抗,0,0,1,0,0,0,0,1,0.125
电流,0,0,1,0,0,0,0,1,0.125
电压,0,0,1,0,0,0,0,1,0.125
失效退化模型,0,0,1,0,0,0,0,1,0.125
裂纹预测,0,0,1,0,0,0,0,1,0.125
含氢压力容器,0,0,1,0,0,0,0,1,0.125
贝叶斯网络模型,0,0,1,0,0,0,0,1,0.125
md值分布,0,0,1,0,0,0,0,1,0.125
rul分布,0,0,1,0,0,0,0,1,0.125
电阻,0,0,1,0,0,0,0,1,0.125
尺寸,0,0,1,0,0,0,0,1,0.125
重量,0,0,1,0,0,0,0,1,0.125
md,0,0,1,0,0,0,0,1,0.125
马氏距离,0,0,1,0,0,0,0,1,0.125
铁结构,0,0,1,0,0,0,0,1,0.125
腐蚀条件,0,0,1,0,0,0,0,1,0.125
线性双对数定律,0,0,1,0,0,0,0,1,0.125
大气腐蚀,0,0,1,0,0,0,0,1,0.125
贝叶斯网络,0,0,1,0,0,0,0,1,0.125
原始振动信号,0,0,1,0,0,0,0,1,0.125
目标函数,0,0,1,0,0,0,0,1,0.125
回归任务,0,0,1,0,0,0,0,1,0.125
双任务lstm网络,0,0,1,0,0,0,0,1,0.125
dag,0,0,1,0,0,0,0,1,0.125
有向无环图,0,0,1,0,0,0,0,1,0.125
cnn-lstm,0,0,1,0,0,0,0,1,0.125
cnn-lstm模型,0,0,1,0,0,0,0,1,0.125
高维特征提取能力,0,0,1,0,0,0,0,1,0.125
特征学习,0,0,1,0,0,0,0,1,0.125
模型构建,0,0,1,0,0,0,0,1,0.125
svm回归,0,0,1,0,0,0,0,1,0.125
固有模态函数,0,0,1,0,0,0,0,1,0.125
emd分解,0,0,1,0,0,0,0,1,0.125
回油流量,0,0,1,0,0,0,0,1,0.125
康监测,0,0,1,0,0,0,0,1,0.125
轴向柱塞泵,0,0,1,0,0,0,0,1,0.125
svm,0,0,1,0,0,0,0,1,0.125
pso,0,0,1,0,0,0,0,1,0.125
粒子群优化,0,0,1,0,0,0,0,1,0.125
经验模态分解,0,0,1,0,0,0,0,1,0.125
悬浮状态,0,0,1,0,0,0,0,1,0.125
人口特征,0,0,1,0,0,0,0,1,0.125
泵振动数据,0,0,1,0,0,0,0,1,0.125
rul值,0,0,1,0,0,0,0,1,0.125
回归问题,0,0,1,0,0,0,0,1,0.125
故障传播,0,0,1,0,0,0,0,1,0.125
故障模式,0,0,1,0,0,0,0,1,0.125
运行条件,0,0,1,0,0,0,0,1,0.125
单调,0,0,1,0,0,0,0,1,0.125
噪声,0,0,1,0,0,0,0,1,0.125
健康指示器,0,0,1,0,0,0,0,1,0.125
健康指标,0,0,1,0,0,0,0,1,0.125
燃油泵机组,0,0,1,0,0,0,0,1,0.125
发动机,0,0,1,0,0,0,0,1,0.125
飞机,0,0,1,0,0,0,0,1,0.125
泵转速,0,0,1,0,0,0,0,1,0.125
指标,0,0,1,0,0,1,0,2,0.3666666666666667
度指标,0,0,1,0,0,0,0,1,0.125
logistic回归,0,0,1,0,0,0,0,1,0.125
arma模型,0,0,1,0,0,0,0,1,0.125
电梯门,0,0,1,0,0,0,0,1,0.125
arma,0,0,1,0,0,0,0,1,0.125
自回归滑动平均,0,0,1,0,0,0,0,1,0.125
退化过程,0,0,1,0,0,0,0,1,0.125
匹配电池,0,0,1,0,0,0,0,1,0.125
线性ar模型,0,0,1,0,0,0,0,1,0.125
ar模型,0,0,1,0,0,0,0,1,0.125
退化因子,0,0,1,0,0,0,0,1,0.125
曲线,0,0,1,0,0,0,0,1,0.125
自回归时间序列模型,0,0,1,0,0,0,0,1,0.125
非线性加速退化因子,0,0,1,0,0,0,0,1,0.125
时间序列回归技术,0,0,1,0,0,0,0,1,0.125
持续时间,0,0,1,0,0,0,0,1,0.125
迭代优化,0,0,1,0,0,0,0,1,0.125
器件,0,0,1,0,0,0,0,1,0.125
隐马尔可夫状态转移模型,0,0,1,0,0,0,0,1,0.125
灰色模型,0,0,1,0,0,0,0,1,0.125
马尔可夫,0,0,1,0,0,0,0,1,0.125
mog-hmms,0,0,1,0,0,0,0,1,0.125
混合高斯隐马尔可夫模型,0,0,1,0,0,0,0,1,0.125
剩余使,0,0,1,0,0,0,0,1,0.125
hmm,0,0,1,0,0,0,0,1,0.125
隐马尔可夫模型,0,0,1,0,0,0,0,1,0.125
计模型,0,0,1,0,0,0,0,1,0.125
人工智能模型,0,0,1,0,0,0,0,1,0.125
数据驱动模型,0,0,1,0,0,0,0,1,0.125
物理量,0,0,1,0,0,0,0,1,0.125
物理,0,0,1,0,0,0,0,1,0.125
测量模型,0,0,1,0,0,0,0,1,0.125
内部状态映射,0,0,1,0,0,0,0,1,0.125
损伤,0,0,1,0,0,0,0,1,0.125
阀门,0,0,1,0,0,0,0,1,0.125
电磁阀模型,0,0,1,0,0,0,0,1,0.125
电磁阀,0,0,1,0,0,0,0,1,0.125
粒子过滤器,0,0,1,0,0,0,0,1,0.125
goebel,0,0,1,0,0,0,0,1,0.125
daigle,0,0,1,0,0,0,0,1,0.125
粒子滤波器,0,0,1,0,0,0,0,1,0.125
高斯噪声,0,0,1,0,0,0,0,1,0.125
线性系统,0,0,1,0,0,0,0,1,0.125
时间间隔,0,0,1,0,0,0,0,1,0.125
状态空间模型,0,0,1,0,0,0,0,1,0.125
离散时间,0,0,1,0,0,0,0,1,0.125
时间尺,0,0,1,0,0,0,0,1,0.125
soc,0,0,1,0,0,0,0,1,0.125
荷电状态,0,0,1,0,0,0,0,1,0.125
快速时变,0,0,1,0,0,0,0,1,0.125
多尺度框架,0,0,1,0,0,0,0,1,0.125
无迹卡尔曼滤波,0,0,1,0,0,0,0,1,0.125
非线性系统,0,0,1,0,0,0,0,1,0.125
白高斯,0,0,1,0,0,0,0,1,0.125
测量噪声,0,0,1,0,0,0,0,1,0.125
过程,0,0,1,0,0,0,0,1,0.125
线性,0,0,1,0,0,0,0,1,0.125
卡尔曼滤波器,0,0,1,0,0,0,0,1,0.125
模态频率,0,0,1,0,0,0,0,1,0.125
裂纹扩展,0,0,1,0,0,0,0,1,0.125
受拉钢带,0,0,1,0,0,0,0,1,0.125
kalman滤波,0,0,1,0,0,0,0,1,0.125
齿轮,0,0,1,0,0,0,0,1,0.125
贝叶斯,0,0,1,0,0,0,0,1,0.125
模拟裂纹长度,0,0,1,0,0,0,0,1,0.125
状态监测数据,0,0,1,0,0,0,0,1,0.125
应力分析,0,0,1,0,0,0,0,1,0.125
有限元模型,0,0,1,0,0,0,0,1,0.125
齿轮动力学模型,0,0,1,0,0,0,0,1,0.125
贝叶斯框架,0,0,1,0,0,0,0,1,0.125
正态分布,0,0,1,0,0,0,0,1,0.125
裂纹扩展过程,0,0,1,0,0,0,0,1,0.125
齿轮剩余,0,0,1,0,0,0,0,1,0.125
映射关,0,0,1,0,0,0,0,1,0.125
物理现象,0,0,1,0,0,0,0,1,0.125
失效模式,0,0,1,0,0,0,0,1,0.125
时间长度,0,0,1,0,0,0,0,1,0.125
时刻,0,0,1,0,0,0,0,1,0.125
运维人,0,0,1,0,0,0,0,1,0.125
安全阈值,0,0,1,0,0,0,0,1,0.125
及时性,0,0,1,0,0,0,0,1,0.125
复杂精密设备,0,0,1,0,0,0,0,1,0.125
调用成功率,0,0,0,0,0,15,0,15,3.625
缓存,0,0,0,0,0,4,0,4,0.9666666666666667
性能测试,0,0,0,0,0,5,0,5,1.2083333333333333
云函数调用测试,0,0,0,0,0,2,0,2,0.48333333333333334
软件开发,0,0,0,0,0,1,0,1,0.24166666666666667
en,0,0,0,0,0,1,0,1,0.24166666666666667
rt,0,0,0,0,0,1,0,1,0.24166666666666667
小程序云函数调用,0,0,0,0,0,1,0,1,0.24166666666666667
调用,0,0,0,0,0,1,0,1,0.24166666666666667
云函数调用,0,0,0,0,0,1,0,1,0.24166666666666667
运维小程序,0,0,0,0,0,1,0,1,0.24166666666666667
接口,0,0,0,0,0,1,0,1,0.24166666666666667
小程序算法,0,0,0,0,0,1,0,1,0.24166666666666667
算法api,0,0,0,0,0,1,0,1,0.24166666666666667
接口测试,0,0,0,0,0,1,0,1,0.24166666666666667
算法接口测试,0,0,0,0,0,1,0,1,0.24166666666666667
体验,0,0,0,0,0,1,0,1,0.24166666666666667
卡顿,0,0,0,0,0,2,0,2,0.48333333333333334
小波变换,0,0,0,6,0,0,0,6,0.75
小波基,0,0,0,3,0,0,0,3,0.375
低频,0,0,0,3,0,0,0,3,0.375
高频,0,0,0,2,0,0,0,2,0.25
小波包分解,0,0,0,2,0,0,0,2,0.25
三角函数基,0,0,0,1,0,0,0,1,0.125
平移系数,0,0,0,1,0,0,0,1,0.125
伸缩,0,0,0,1,0,0,0,1,0.125
尺度系数,0,0,0,1,0,0,0,1,0.125
小波基函数,0,0,0,1,0,0,0,1,0.125
有效信息,0,0,0,1,0,0,0,1,0.125
分解信号,0,0,0,1,0,0,0,1,0.125
时频域特征提取,0,0,0,1,0,0,0,1,0.125
运维管理员,0,0,0,0,0,12,0,12,2.9
报障工单,0,0,0,0,0,4,0,4,0.9666666666666667
员工,0,0,0,0,0,2,0,2,0.48333333333333334
单管理,0,0,0,0,0,1,0,1,0.24166666666666667
工单提醒,0,0,0,0,0,1,0,1,0.24166666666666667
hidden属性,0,0,0,0,0,1,0,1,0.24166666666666667
view组件,0,0,0,0,0,1,0,1,0.24166666666666667
activeindex,0,0,0,0,0,1,0,1,0.24166666666666667
js文件函数,0,0,0,0,0,1,0,1,0.24166666666666667
bindtap,0,0,0,0,0,1,0,1,0.24166666666666667
工单统计模,0,0,0,0,0,1,0,1,0.24166666666666667
工单统计,0,0,0,0,0,1,0,1,0.24166666666666667
工单管理,0,0,0,0,0,1,0,1,0.24166666666666667
加号,0,0,0,0,0,1,0,1,0.24166666666666667
运维管理员工单管理,0,0,0,0,0,1,0,1,0.24166666666666667
管理员,0,0,0,0,0,6,0,6,1.45
坯贡土,0,0,0,0,0,1,0,1,0.24166666666666667
工单表,0,0,0,0,0,1,0,1,0.24166666666666667
工单数据,0,0,0,0,0,1,0,1,0.24166666666666667
createorder,0,0,0,0,0,1,0,1,0.24166666666666667
callfunction,0,0,0,0,0,1,0,1,0.24166666666666667
cloud,0,0,0,0,0,1,0,1,0.24166666666666667
发布人,0,0,0,0,0,2,0,2,0.48333333333333334
检修类型,0,0,0,0,0,1,0,1,0.24166666666666667
例行检修,0,0,0,0,0,1,0,1,0.24166666666666667
报障,0,0,0,0,0,1,0,1,0.24166666666666667
检修工单,0,0,0,0,0,1,0,1,0.24166666666666667
工单类型,0,0,0,0,0,1,0,1,0.24166666666666667
部门,0,0,0,0,0,3,0,3,0.725
group变量,0,0,0,0,0,1,0,1,0.24166666666666667
bindchange,0,0,0,0,0,1,0,1,0.24166666666666667
选择值,0,0,0,0,0,1,0,1,0.24166666666666667
picker选择器组件,0,0,0,0,0,1,0,1,0.24166666666666667
故障设备,0,0,0,0,0,1,0,1,0.24166666666666667
维修信息,0,0,0,0,0,1,0,1,0.24166666666666667
技术员端,0,0,0,0,0,1,0,1,0.24166666666666667
运维管理员端,0,0,0,0,0,1,0,1,0.24166666666666667
外勤任务,0,0,0,0,0,1,0,1,0.24166666666666667
系统测试,0,0,0,0,0,3,0,3,0.725
工业设备运维小程序,0,0,0,0,0,1,0,1,0.24166666666666667
闪退,0,0,0,0,0,1,0,1,0.24166666666666667
模块,0,0,0,0,0,1,0,1,0.24166666666666667
加权,0,0,0,0,2,0,0,2,0.48333333333333334
a-distance方法,0,0,0,0,1,0,0,1,0.24166666666666667
样本分布,0,0,0,0,1,0,0,1,0.24166666666666667
区分度,0,0,0,0,1,0,0,1,0.24166666666666667
分类器,0,0,0,0,1,0,0,1,0.24166666666666667
线性分类器,0,0,0,0,1,0,0,1,0.24166666666666667
a-distance指标,0,0,0,0,1,0,0,1,0.24166666666666667
遍历,0,0,0,0,1,0,0,1,0.24166666666666667
步长,0,0,0,0,1,0,0,1,0.24166666666666667
搜索,0,0,0,0,1,0,0,1,0.24166666666666667
赋值策略,0,0,0,0,1,0,0,1,0.24166666666666667
工况迁移机制,0,0,0,0,1,0,0,1,0.24166666666666667
历史数据分析,0,0,2,0,0,0,0,2,0.25
工业运维系统,0,0,1,0,0,0,0,1,0.125
数据特征分布差异,0,0,1,0,0,0,0,1,0.125
工业场,0,0,1,0,0,0,0,1,0.125
预测性维护管理小程序,0,0,1,0,0,0,0,1,0.125
worker,0,0,0,0,0,4,0,4,0.9666666666666667
finish,0,0,0,0,0,2,0,2,0.48333333333333334
type,0,0,0,0,0,2,0,2,0.48333333333333334
描述信息,0,0,0,0,0,2,0,2,0.48333333333333334
submittime,0,0,0,0,0,2,0,2,0.48333333333333334
安装,0,0,0,0,0,2,0,2,0.48333333333333334
上传时间,0,0,0,0,0,1,0,1,0.24166666666666667
外勤人员,0,0,0,0,0,1,0,1,0.24166666666666667
currentprice,0,0,0,0,0,1,0,1,0.24166666666666667
maintenance,0,0,0,0,0,1,0,1,0.24166666666666667
设备编号,0,0,0,0,0,1,0,1,0.24166666666666667
dt,0,0,0,0,0,1,0,1,0.24166666666666667
工号,0,0,0,0,0,1,0,1,0.24166666666666667
历史数据分析模块,0,0,0,0,0,1,0,1,0.24166666666666667
维修工单表,0,0,0,0,0,1,0,1,0.24166666666666667
运杂,0,0,0,0,0,1,0,1,0.24166666666666667
设备台账数据库,0,0,0,0,0,1,0,1,0.24166666666666667
个人信息,0,0,0,0,0,1,0,1,0.24166666666666667
据库,0,0,0,0,0,1,0,1,0.24166666666666667
设备维修,0,0,0,0,0,1,0,1,0.24166666666666667
表结构,0,0,0,0,0,1,0,1,0.24166666666666667
非线性映射,0,0,0,2,0,0,0,2,0.25
映射,0,0,0,1,0,0,0,1,0.125
rkhs,0,0,0,1,0,0,0,1,0.125
再生希尔伯特空间,0,0,0,1,0,0,0,1,0.125
始数据,0,0,1,1,0,0,0,2,0.25
kernelhilbert,0,0,0,1,0,0,0,1,0.125
reproducing,0,0,0,1,0,0,0,1,0.125
再生核希尔伯特空间,0,0,0,1,0,0,0,1,0.125
dsqt,0,0,0,1,0,0,0,1,0.125
核均值,0,0,0,1,0,0,0,1,0.125
测量指标,0,0,0,1,0,0,0,1,0.125
衰退速度,0,0,0,0,1,0,0,1,0.24166666666666667
走刀路径,0,0,0,0,1,0,0,1,0.24166666666666667
domainadaptions,0,0,0,0,1,0,0,1,0.24166666666666667
特征分布,0,0,0,0,1,0,0,1,0.24166666666666667
定量计算,0,0,0,0,1,0,0,1,0.24166666666666667
维修人,0,0,0,0,0,2,0,2,0.48333333333333334
考勤,0,0,0,0,0,1,0,1,0.24166666666666667
塔家三査,0,0,0,0,0,1,0,1,0.24166666666666667
维修记录表单,0,0,0,0,0,1,0,1,0.24166666666666667
maintenancerecord,0,0,0,0,0,1,0,1,0.24166666666666667
查询云函数,0,0,0,0,0,1,0,1,0.24166666666666667
表单,0,0,0,0,0,1,0,1,0.24166666666666667
设备价值,0,0,0,0,0,1,0,1,0.24166666666666667
大修次数,0,0,0,0,0,1,0,1,0.24166666666666667
维修时间,0,0,0,0,0,1,0,1,0.24166666666666667
饼状图,0,0,0,0,0,1,0,1,0.24166666666666667
横坐标,0,0,0,0,0,1,0,1,0.24166666666666667
纵坐标,0,0,0,0,0,1,0,1,0.24166666666666667
echarts框架,0,0,0,0,0,1,0,1,0.24166666666666667
寿命信息,0,0,0,0,0,1,0,1,0.24166666666666667
关键数据,0,0,0,0,0,1,0,1,0.24166666666666667
复盘,0,0,0,0,0,1,0,1,0.24166666666666667
历史数据统计模,0,0,0,0,0,1,0,1,0.24166666666666667
程序,0,0,1,0,0,0,0,1,0.125
预测性维护管理,0,0,1,0,0,0,0,1,0.125
sae层数,0,0,1,0,0,0,0,1,0.125
迭代轮数,0,0,1,0,0,0,0,1,0.125
学习速率,0,0,1,0,0,0,0,1,0.125
pytorch深度学习框架,0,0,1,0,0,0,0,1,0.125
领域自适应算法,0,0,1,0,0,0,0,1,0.125
分布自适应,0,0,0,0,2,0,0,2,0.48333333333333334
sae-lstm网络,0,0,0,0,2,0,0,2,0.48333333333333334
离工scmmd,0,0,0,0,1,0,0,1,0.24166666666666667
自适应权重,0,0,0,0,1,0,0,1,0.24166666666666667
类别标签,0,0,0,0,1,0,0,1,0.24166666666666667
sae层,0,0,0,0,1,0,0,1,0.24166666666666667
初始,0,0,0,0,1,0,0,1,0.24166666666666667
sae参数,0,0,0,0,1,0,0,1,0.24166666666666667
学习率,0,0,0,0,1,0,0,1,0.24166666666666667
源域工况,0,0,0,0,1,0,0,1,0.24166666666666667
源域标签,0,0,0,0,1,0,0,1,0.24166666666666667
伪代码,0,0,0,0,1,0,0,1,0.24166666666666667
batch,0,0,0,0,1,0,0,1,0.24166666666666667
梯度,0,0,0,0,1,0,0,1,0.24166666666666667
mini-batch,0,0,0,0,1,0,0,1,0.24166666666666667
初始化参数,0,0,0,0,1,0,0,1,0.24166666666666667
网络权重,0,0,0,0,1,0,0,1,0.24166666666666667
在特征,0,0,0,0,1,0,0,1,0.24166666666666667
特征表征,0,0,0,0,1,0,0,1,0.24166666666666667
kaiming,0,0,0,0,1,0,0,1,0.24166666666666667
随机初始化,0,0,0,0,1,0,0,1,0.24166666666666667
算法流程,0,0,0,0,1,0,0,1,0.24166666666666667
工业设备运维,0,1,0,0,0,0,0,1,2.0
测试数据,3,0,0,0,0,0,0,3,3.0
动态域自适应,1,0,0,0,0,0,0,1,1.0
数据支持,1,0,0,0,0,0,0,1,1.0
工业装备部件,1,0,0,0,0,0,0,1,1.0
工业生产效率,1,0,0,0,0,0,0,1,1.0
用寿命预测,1,0,0,0,0,0,0,1,1.0
线下训练模型,1,0,0,0,0,0,0,1,1.0
线上测试模型,1,0,0,0,0,0,0,1,1.0
泛化性变差,1,0,0,0,0,0,0,1,1.0
