,摘要,关键词,第一章,第二章,第三章,第四章,第五章,总词频,加权得分
高频信道,4,0,16,6,16,11,4,57,14.241666666666667
建模,1,0,7,6,5,1,3,23,4.8
信道模型,1,0,9,30,11,3,5,59,10.466666666666667
校准仿真结,0,0,1,0,0,0,0,1,0.125
新特性模型,0,0,1,0,0,0,0,1,0.125
小尺度参数,1,0,5,2,18,25,1,52,12.508333333333333
大尺度参数,1,0,4,7,31,23,1,67,15.666666666666666
高频信道模型,3,0,2,6,2,2,1,16,5.208333333333333
信道传输系数,0,0,1,1,0,0,0,2,0.25
参数,1,0,3,12,8,23,1,48,10.608333333333334
信道建模,3,1,3,12,9,2,2,32,10.016666666666666
高频,1,1,5,1,1,2,5,16,5.683333333333334
无线通信技术,0,0,2,2,0,0,0,4,0.5
空间,0,0,1,5,11,9,1,27,5.825
校准,0,0,0,0,2,18,2,22,5.316666666666666
信道,0,0,2,18,14,19,7,60,12.166666666666666
时延,0,0,1,3,5,8,0,17,3.6416666666666666
曲线,0,0,0,0,0,11,0,11,2.658333333333333
耦合路损,0,0,0,0,0,8,0,8,1.9333333333333333
信道响应,0,0,0,4,0,4,0,8,1.4666666666666668
时间,0,0,0,5,3,5,0,13,2.5583333333333336
drop,0,0,0,1,4,3,0,8,1.8166666666666667
校准曲线,0,0,0,0,0,2,0,2,0.48333333333333334
仿真值,0,0,0,0,0,2,0,2,0.48333333333333334
信噪比,0,0,0,0,0,2,0,2,0.48333333333333334
空间一致性,0,0,0,2,9,4,1,16,3.6333333333333333
变化率曲线,0,0,0,0,0,2,0,2,0.48333333333333334
功率,0,0,0,8,7,11,0,26,5.35
校准结,0,0,0,0,0,2,0,2,0.48333333333333334
无线通信环境,1,0,0,1,0,1,0,3,1.3666666666666667
nlos,0,0,1,2,9,2,0,14,3.033333333333333
信道测量,0,0,0,10,3,1,0,14,2.216666666666667
nlos状态,0,0,0,0,0,1,0,1,0.24166666666666667
los,0,0,0,2,6,4,0,12,2.6666666666666665
ue间距离,0,0,0,0,0,1,0,1,0.24166666666666667
相关系数曲线,0,0,0,0,0,1,0,1,0.24166666666666667
平均值,0,0,0,0,0,2,0,2,0.48333333333333334
仿真结,0,0,1,0,0,3,0,4,0.85
系数曲线,0,0,0,0,0,1,0,1,0.24166666666666667
los/nlos状态,0,0,0,0,0,1,0,1,0.24166666666666667
水平到达角,0,0,0,0,0,1,0,1,0.24166666666666667
基本性能,0,0,0,0,0,1,0,1,0.24166666666666667
路损模型,0,0,2,0,0,1,0,3,0.4916666666666667
天线,0,0,2,5,14,24,0,45,10.058333333333334
准参考曲线,0,0,0,0,0,1,0,1,0.24166666666666667
校准数据,0,0,0,0,0,3,0,3,0.725
考值,0,0,0,0,0,1,0,1,0.24166666666666667
sinr,0,0,0,0,0,2,0,2,0.48333333333333334
系数,0,0,0,0,0,2,0,2,0.48333333333333334
参量,0,0,0,0,0,6,0,6,1.45
信道特性,1,0,0,3,0,2,0,6,1.8583333333333334
频段,0,0,0,2,0,5,0,7,1.4583333333333333
参数校准,0,0,0,0,0,2,1,3,0.725
致性,0,0,0,0,1,1,0,2,0.48333333333333334
一致性功率,0,0,0,0,0,1,0,1,0.24166666666666667
avgva,0,0,0,0,0,1,0,1,0.24166666666666667
时延平均变化率曲线,0,0,0,0,0,1,0,1,0.24166666666666667
功率平均変化?率曲絞,0,0,0,0,0,1,0,1,0.24166666666666667
水平到达,0,0,0,0,1,1,0,2,0.48333333333333334
校准参量,0,0,0,0,0,22,0,22,5.316666666666666
连续性,0,0,0,2,0,1,0,3,0.4916666666666667
信道参数,0,0,0,5,0,3,0,8,1.35
角度参数,0,0,0,0,4,4,0,8,1.9333333333333333
仿真,2,1,3,6,7,7,4,30,9.475
dropbased,0,0,0,0,0,1,0,1,0.24166666666666667
快照法,0,0,0,0,0,1,0,1,0.24166666666666667
ue移动模型,0,0,0,0,0,1,0,1,0.24166666666666667
高频新特性校准仿真,0,0,0,0,0,1,0,1,0.24166666666666667
信号,0,0,2,6,3,2,0,13,2.208333333333333
散射,0,0,0,6,1,0,0,7,0.9916666666666667
空间分辨率,0,0,0,2,0,0,0,2,0.25
大规模天线,0,0,0,2,0,0,0,2,0.25
天线阵列,0,0,0,3,2,4,0,9,1.825
电磁波,0,0,0,5,3,0,0,8,1.35
阴影衰落,0,0,2,3,4,1,0,10,1.8333333333333333
3dmimo信道模型,1,0,1,3,1,0,0,6,1.7416666666666667
3gpp信道模型,0,0,0,1,0,0,0,1,0.125
低频信道,0,0,0,1,1,0,0,2,0.3666666666666667
向下兼容性,0,0,0,3,1,0,0,4,0.6166666666666667
球面波模型,0,0,0,1,0,0,0,1,0.125
极化模型,0,0,0,1,0,1,0,2,0.3666666666666667
3d模型,0,0,0,2,0,0,0,2,0.25
兆赫,0,0,0,1,0,0,0,1,0.125
带宽,0,0,2,7,0,11,0,20,3.783333333333333
测量,0,0,0,3,0,0,0,3,0.375
高频段无线传输信道,0,0,0,1,0,0,0,1,0.125
tis,0,0,0,1,0,0,0,1,0.125
无线信道模型,0,0,0,1,0,0,0,1,0.125
大带宽,0,0,0,2,0,1,0,3,0.4916666666666667
高频段,2,0,3,4,0,0,0,9,2.875
可靠传输,0,0,0,1,0,0,0,1,0.125
干扰,0,0,0,1,1,2,0,4,0.85
用户,0,0,0,2,8,0,0,10,2.1833333333333336
强度,0,0,0,1,0,0,0,1,0.125
传输信号,0,0,0,1,2,1,0,4,0.85
波束赋形技术,0,0,0,1,0,0,0,1,0.125
导频污染,0,0,0,1,0,0,0,1,0.125
大规模天线技术,0,0,0,1,0,0,0,1,0.125
mimo系统,0,0,0,2,0,0,0,2,0.25
频谱效率,1,0,0,1,0,0,0,2,1.125
频域,0,0,0,2,0,0,0,2,0.25
时域,0,0,0,2,0,0,0,2,0.25
大规模天线阵列,0,0,0,1,0,1,0,2,0.3666666666666667
天线系统,0,0,0,1,1,0,0,2,0.3666666666666667
3dmimo信道,0,0,0,6,0,0,0,6,0.75
波束赋形,0,0,0,2,0,0,0,2,0.25
毫米波段,0,0,0,1,0,0,0,1,0.125
多径,0,0,0,1,20,2,0,23,5.441666666666666
反射,0,0,0,4,0,0,0,4,0.5
电磁波传播,0,0,0,1,0,0,0,1,0.125
粒子特性,0,0,0,1,0,0,0,1,0.125
衍射特性,0,0,0,2,1,0,0,3,0.4916666666666667
粒子性,0,0,0,2,1,0,0,3,0.4916666666666667
高频信号,0,0,0,1,0,0,0,1,0.125
衍射,0,0,0,3,0,0,0,3,0.375
直射路径,0,0,0,1,0,0,0,1,0.125
低频段,0,0,2,1,1,0,0,4,0.6166666666666667
额外损耗,0,0,0,1,0,0,0,1,0.125
建筑物,0,0,0,1,0,0,0,1,0.125
损耗,0,0,4,1,0,0,0,5,0.625
穿透建筑材料,0,0,0,1,0,0,0,1,0.125
扰动,0,0,0,1,0,0,0,1,0.125
穿透损耗,0,0,7,1,0,4,0,12,1.9666666666666668
人体遮挡,0,0,0,1,0,0,0,1,0.125
支持频率,0,0,0,1,0,0,0,1,0.125
移动速度,0,0,0,4,3,0,0,7,1.225
ue端,0,0,0,1,2,2,0,5,1.0916666666666668
街道,0,0,0,1,1,0,0,2,0.3666666666666667
广场,0,0,0,1,0,0,0,1,0.125
办公室,0,0,0,2,0,0,0,2,0.25
室内,0,0,0,3,1,2,0,6,1.1
micro,0,0,0,1,0,0,0,1,0.125
都市微小区,0,0,0,3,0,0,0,3,0.375
urbanmacro,0,0,0,1,0,0,0,1,0.125
都市宏小区,0,0,0,3,0,0,0,3,0.375
3dmemo模型,0,0,0,1,0,0,0,1,0.125
场景,0,0,1,3,4,3,0,11,2.1916666666666664
无线传输环境,0,0,0,2,0,0,0,2,0.25
无线信道建模,0,0,0,1,0,0,0,1,0.125
随机变量,0,0,0,0,15,0,0,15,3.625
多径功率,0,0,0,0,16,0,0,16,3.8666666666666667
过渡区域,0,0,0,0,8,0,0,8,1.9333333333333333
距离,0,0,2,1,20,2,0,25,5.691666666666666
ue,0,0,1,4,21,12,0,38,8.6
均匀分布,0,0,0,0,12,0,0,12,2.9
离开角,0,0,0,3,7,3,0,13,2.7916666666666665
延迟,0,0,0,3,9,1,0,13,2.7916666666666665
los概率,0,0,0,0,4,0,0,4,0.9666666666666667
基站,0,0,0,3,27,7,0,37,8.591666666666667
多径时延,0,0,0,0,3,0,0,3,0.725
到达角,0,0,0,4,9,3,0,16,3.4
随机数,0,0,0,0,3,0,0,3,0.725
相关距离,0,0,0,0,4,0,0,4,0.9666666666666667
变量,0,0,0,0,4,0,0,4,0.9666666666666667
角度,0,0,0,4,12,3,0,19,4.125
信道矩阵,0,0,0,2,2,6,0,10,2.1833333333333336
状态变量,0,0,0,0,2,0,0,2,0.48333333333333334
状态,0,0,0,0,2,0,0,2,0.48333333333333334
水平面,0,0,0,1,2,0,0,3,0.6083333333333334
角度变量,0,0,0,0,2,0,0,2,0.48333333333333334
zod,0,0,0,0,5,0,0,5,1.2083333333333333
aoa,0,0,0,0,6,0,0,6,1.45
突变,0,0,0,0,2,0,0,2,0.48333333333333334
轨迹,0,0,0,0,2,0,0,2,0.48333333333333334
插值,0,0,0,0,2,0,0,2,0.48333333333333334
随机角度,0,0,0,0,6,0,0,6,1.45
多径延迟,0,0,0,0,2,1,0,3,0.725
空间一致性变量,0,0,0,0,2,0,0,2,0.48333333333333334
动态ue模型,0,0,0,0,1,0,0,1,0.24166666666666667
静态,0,0,0,0,1,0,0,1,0.24166666666666667
hnlos,0,0,0,0,1,0,0,1,0.24166666666666667
花破,0,0,0,0,1,0,0,1,0.24166666666666667
路径损耗模型,0,0,1,0,3,0,0,4,0.85
路径损耗,0,0,2,1,5,5,0,13,2.7916666666666665
los概率公式,0,0,0,0,1,0,0,1,0.24166666666666667
高斯分布,0,0,0,0,3,0,0,3,0.725
ss,0,0,0,0,1,1,0,2,0.48333333333333334
浮点数,0,0,0,0,1,0,0,1,0.24166666666666667
qs,0,0,0,0,1,0,0,1,0.24166666666666667
nlo,0,0,0,0,2,0,0,2,0.48333333333333334
景相关距离,0,0,0,0,1,0,0,1,0.24166666666666667
softlos,0,0,0,0,1,0,0,1,0.24166666666666667
室内概率,0,0,0,0,1,0,0,1,0.24166666666666667
传播场景,0,0,1,1,1,0,0,3,0.4916666666666667
概率,0,0,0,1,1,0,0,2,0.3666666666666667
失心,0,0,0,0,1,0,0,1,0.24166666666666667
傀心,0,0,0,0,1,0,0,1,0.24166666666666667
朔皿,0,0,0,0,1,0,0,1,0.24166666666666667
最大时延,0,0,0,0,1,0,0,1,0.24166666666666667
多径时延生成,0,0,0,0,1,0,0,1,0.24166666666666667
仙和心,0,0,0,0,1,0,0,1,0.24166666666666667
非直射径,0,0,0,0,2,0,0,2,0.48333333333333334
直射径,0,0,0,0,4,0,0,4,0.9666666666666667
表面反射角度,0,0,0,0,1,0,0,1,0.24166666666666667
垂直高度,0,0,0,0,1,0,0,1,0.24166666666666667
水平距离,0,0,0,0,1,0,0,1,0.24166666666666667
偽血,0,0,0,0,1,0,0,1,0.24166666666666667
t时刻,0,0,0,0,1,0,0,1,0.24166666666666667
水平,0,0,0,0,8,3,0,11,2.658333333333333
qtzoa,0,0,0,0,1,0,0,1,0.24166666666666667
速率,0,0,0,0,1,0,0,1,0.24166666666666667
速度矢量,0,0,0,0,2,0,0,2,0.48333333333333334
真空中光速,0,0,0,0,1,0,0,1,0.24166666666666667
速度,0,0,0,0,4,2,0,6,1.45
刻信道,0,0,0,0,1,0,0,1,0.24166666666666667
to+t时刻,0,0,0,0,1,0,0,1,0.24166666666666667
ue移动特性,0,0,0,0,1,0,0,1,0.24166666666666667
空间一致性仿真假设,0,0,0,0,1,0,0,1,0.24166666666666667
移动,0,0,0,1,1,0,0,2,0.3666666666666667
3gpp,0,0,1,3,1,4,1,10,1.95
静止状态,0,0,0,0,1,1,0,2,0.48333333333333334
多径功率月,0,0,0,0,1,0,0,1,0.24166666666666667
zoa,0,0,0,0,6,0,0,6,1.45
aod,0,0,0,0,4,0,0,4,0.9666666666666667
欢血,0,0,0,0,1,0,0,1,0.24166666666666667
中簇,0,0,0,0,1,0,0,1,0.24166666666666667
绝对值符号,0,0,0,0,1,0,0,1,0.24166666666666667
相位,0,0,0,1,2,0,0,3,0.6083333333333334
复正态随机数,0,0,0,0,1,0,0,1,0.24166666666666667
孩叶,0,0,0,0,1,0,0,1,0.24166666666666667
正态随机变量,0,0,0,0,1,0,0,1,0.24166666666666667
网格,0,0,0,0,3,0,0,3,0.725
复杂度,0,0,1,3,2,1,0,7,1.225
独立随机变量,0,0,0,0,2,0,0,2,0.48333333333333334
复正态分布,0,0,0,0,1,0,0,1,0.24166666666666667
长宽,0,0,0,0,1,0,0,1,0.24166666666666667
室外,0,0,0,1,2,1,0,4,0.85
多径系数,0,0,0,0,1,0,0,1,0.24166666666666667
or,0,0,0,1,1,2,0,4,0.85
umiuma,0,0,0,0,1,0,0,1,0.24166666666666667
随机相位,0,0,0,0,1,0,0,1,0.24166666666666667
交叉极化功率比,0,0,0,0,5,1,0,6,1.45
随机耦合,0,0,0,0,1,1,0,2,0.48333333333333334
子径,0,0,0,9,15,10,0,34,7.166666666666667
子径特性,0,0,0,0,1,0,0,1,0.24166666666666667
空间一致性随机变量,0,0,0,0,1,0,0,1,0.24166666666666667
随机正负角,0,0,0,0,2,0,0,2,0.48333333333333334
角度偏移,0,0,0,0,3,0,0,3,0.725
阴影参数,0,0,0,0,2,0,0,2,0.48333333333333334
子径模型,0,0,0,0,1,0,0,1,0.24166666666666667
延退,0,0,0,0,1,0,0,1,0.24166666666666667
自相关,0,0,0,0,4,0,0,4,0.9666666666666667
cdf曲线,0,0,0,0,0,12,0,12,2.9
平均变化率,0,0,0,0,0,4,0,4,0.9666666666666667
服务小区,0,0,0,0,0,7,0,7,1.6916666666666667
rsrp,0,0,0,0,0,7,0,7,1.6916666666666667
crs0端口,0,0,0,0,0,4,0,4,0.9666666666666667
天线元素,0,0,0,0,0,2,0,2,0.48333333333333334
3d空间,0,0,0,0,0,3,0,3,0.725
校准参数,0,0,0,0,0,3,0,3,0.725
关系数,0,0,0,0,0,2,0,2,0.48333333333333334
耦合损耗,0,0,0,0,0,10,0,10,2.4166666666666665
中心频率,0,0,2,2,0,15,0,19,4.125
高频新特性,0,0,1,0,0,2,0,3,0.6083333333333334
变化率,0,0,0,0,0,1,0,1,0.24166666666666667
标准差,0,0,1,0,1,1,0,3,0.6083333333333334
延续时间,0,0,0,0,0,1,0,1,0.24166666666666667
高斯白噪声,0,0,0,0,0,4,0,4,0.9666666666666667
干扰小区,0,0,0,0,1,4,0,5,1.2083333333333333
widebandsinr,0,0,0,0,0,1,0,1,0.24166666666666667
宽带信干噪比,0,0,0,0,0,1,0,1,0.24166666666666667
couplingloss,0,0,0,0,0,3,0,3,0.725
交通工具,0,0,0,0,0,1,0,1,0.24166666666666667
静止人群,0,0,0,0,0,1,0,1,0.24166666666666667
模拟室内,0,0,0,0,0,1,0,1,0.24166666666666667
用户速度,0,0,0,0,0,1,0,1,0.24166666666666667
室内用户,0,0,1,0,1,1,0,3,0.6083333333333334
用户分布,0,0,0,0,0,2,0,2,0.48333333333333334
面板间隔,0,0,0,0,0,1,0,1,0.24166666666666667
天线面板数,0,0,0,0,0,2,0,2,0.48333333333333334
间隔,0,0,0,0,2,1,0,3,0.725
天线参数,0,0,0,1,2,5,0,8,1.8166666666666667
umi场景,0,0,0,0,2,1,0,3,0.725
校准场景,0,0,0,0,0,1,0,1,0.24166666666666667
载波频率,0,0,0,3,4,11,0,18,4.0
信干噪比,0,0,0,0,0,6,0,6,1.45
rsrp接入法,0,0,0,0,0,1,0,1,0.24166666666666667
ue移动,0,0,0,0,0,1,0,1,0.24166666666666667
室内环境,0,0,0,1,0,3,0,4,0.85
ue分布,0,0,0,0,4,3,0,7,1.6916666666666667
校准仿真,0,0,0,0,0,6,0,6,1.45
下倾角,0,0,0,0,4,7,0,11,2.658333333333333
crs端口,0,0,0,0,0,4,0,4,0.9666666666666667
天线阵子,0,0,0,0,4,4,0,8,1.9333333333333333
天线面板,0,0,0,0,2,2,0,4,0.9666666666666667
基站天线端口,0,0,0,0,0,2,0,2,0.48333333333333334
基站天线,0,0,0,0,2,8,0,10,2.4166666666666665
mi,0,0,0,0,0,2,0,2,0.48333333333333334
校准仿真參量,0,0,0,0,0,1,0,1,0.24166666666666667
新特性,0,0,0,0,0,1,0,1,0.24166666666666667
仿真校准,0,0,0,0,0,1,0,1,0.24166666666666667
仿真条件,0,0,0,0,0,3,0,3,0.725
阻塞模型,0,0,0,0,6,1,0,7,1.6916666666666667
氧衰损耗,0,0,0,0,0,1,0,1,0.24166666666666667
基础信道,0,0,0,0,0,1,0,1,0.24166666666666667
模型,0,0,0,1,0,1,0,2,0.3666666666666667
校准仿真假设,0,0,0,0,0,4,0,4,0.9666666666666667
转换,0,0,0,0,5,0,0,5,1.2083333333333333
指数,0,0,0,0,2,0,0,2,0.48333333333333334
相关系数矩阵,0,0,0,0,2,0,0,2,0.48333333333333334
tlsp,0,0,0,0,2,0,0,2,0.48333333333333334
相关矩阵,0,0,1,0,2,0,0,3,0.6083333333333334
相关性,0,0,0,0,2,0,0,2,0.48333333333333334
莱斯k因子,0,0,0,0,7,0,0,7,1.6916666666666667
分布,0,0,0,1,5,0,0,6,1.3333333333333333
时延扩展,0,0,0,1,4,2,0,7,1.575
链路,0,0,0,1,3,0,0,4,0.85
szsa,0,0,0,0,1,0,0,1,0.24166666666666667
szsd,0,0,0,0,1,0,0,1,0.24166666666666667
大尺度参数向量,0,0,0,0,1,0,0,1,0.24166666666666667
均值,0,0,0,0,2,0,0,2,0.48333333333333334
lsps,0,0,0,0,1,0,0,1,0.24166666666666667
tlsps,0,0,0,0,1,0,0,1,0.24166666666666667
csism,0,0,0,0,1,0,0,1,0.24166666666666667
线性变换,0,0,0,0,1,0,0,1,0.24166666666666667
滤波处,0,0,0,0,1,0,0,1,0.24166666666666667
坐标,0,0,0,0,2,0,0,2,0.48333333333333334
滤波器,0,0,0,0,1,0,0,1,0.24166666666666667
撒点总数,0,0,0,0,1,0,0,1,0.24166666666666667
ue链路,0,0,0,0,1,0,0,1,0.24166666666666667
转换大尺度参数,0,0,0,0,1,0,0,1,0.24166666666666667
映射转换,0,0,0,0,1,0,0,1,0.24166666666666667
独立高斯随机过程,0,0,0,0,1,0,0,1,0.24166666666666667
sp,0,0,0,0,1,0,0,1,0.24166666666666667
关矩阵,0,0,0,0,1,0,0,1,0.24166666666666667
ue距离,0,0,0,0,1,0,0,1,0.24166666666666667
终端距离,0,0,0,0,1,0,0,1,0.24166666666666667
sd,0,0,0,0,2,0,0,2,0.48333333333333334
垂直离开角角度扩展,0,0,0,0,1,0,0,1,0.24166666666666667
sa,0,0,0,1,2,0,0,3,0.6083333333333334
角角度扩展,0,0,0,0,1,0,0,1,0.24166666666666667
垂直到达,0,0,0,0,1,0,0,1,0.24166666666666667
水平离开角角度扩展,0,0,0,0,1,0,0,1,0.24166666666666667
asa,0,0,0,1,1,2,0,4,0.85
水平到达角角度扩展,0,0,0,0,1,0,0,1,0.24166666666666667
阴影衰落因子,0,0,0,0,1,0,0,1,0.24166666666666667
垂直,0,0,0,0,4,1,0,5,1.2083333333333333
离开角角度,0,0,0,0,1,0,0,1,0.24166666666666667
角度扩展,0,0,0,2,1,4,0,7,1.4583333333333333
性能,1,0,1,1,1,3,0,7,2.216666666666667
系统级仿真,0,0,1,1,3,0,0,5,0.975
信道段,0,0,0,0,1,0,0,1,0.24166666666666667
频率,0,0,2,1,3,26,0,32,7.383333333333334
3gpp标准,0,0,1,0,0,0,0,1,0.125
信道性能,0,0,1,0,0,3,0,4,0.85
无线传输技术,0,0,1,0,0,0,0,1,0.125
大尺度,0,0,1,0,0,1,0,2,0.3666666666666667
穿透损耗模型,0,0,1,0,0,0,0,1,0.125
概率计算模型,0,0,1,0,0,0,0,1,0.125
los/nlos,0,0,1,0,0,1,0,2,0.3666666666666667
建模场,0,0,1,0,0,0,0,1,0.125
信号传输模型,0,0,1,0,0,0,0,1,0.125
高频环境,0,0,2,0,0,0,0,2,0.25
刘xmimo信道模型,0,0,1,0,0,0,0,1,0.125
兼容性,0,0,1,0,1,0,1,3,0.6083333333333334
高频段下信道,0,0,1,0,0,0,0,1,0.125
信道中心频率,0,0,1,0,0,1,0,2,0.3666666666666667
建模标准化,0,0,1,0,0,0,0,1,0.125
传播环境,0,0,0,5,0,0,0,5,0.625
概率分布函数,0,0,0,3,0,0,0,3,0.375
统计性信道模型,0,0,0,3,0,0,0,3,0.375
mimo信道,0,0,0,4,0,0,0,4,0.5
mimo技术,0,0,0,3,0,0,0,3,0.375
接收天线,0,0,0,3,8,0,0,11,2.3083333333333336
随机参数,0,0,0,2,0,1,0,3,0.4916666666666667
射线,0,0,0,2,0,0,0,2,0.25
随机性,0,0,0,2,0,2,0,4,0.7333333333333334
散射体,0,0,0,4,0,0,0,4,0.5
射线追踪,0,0,0,3,0,0,0,3,0.375
信道冲击响应数据,0,0,0,2,0,0,0,2,0.25
实际模型,0,0,0,2,0,0,0,2,0.25
信道系数,0,0,2,3,7,2,0,14,2.8
容量,0,0,0,2,0,0,0,2,0.25
发射天线,0,0,0,2,3,1,0,6,1.2166666666666668
接收端,0,0,0,3,0,1,0,4,0.6166666666666667
mimo,0,0,0,2,0,0,0,2,0.25
路损,0,0,0,2,0,3,0,5,0.975
metis模型,0,0,0,1,0,0,0,1,0.125
混合信道模型模型,0,0,0,1,0,0,0,1,0.125
metis信道模型,0,0,0,1,0,0,0,1,0.125
阻塞,0,0,0,5,15,0,0,20,4.25
主径,0,0,0,3,0,0,0,3,0.375
建模精度,0,0,0,1,0,0,0,1,0.125
随机性信道模型,0,0,0,3,0,0,0,3,0.375
混合信道模型,0,0,0,2,0,0,0,2,0.25
误差,0,0,0,1,0,1,0,2,0.3666666666666667
传播参数,0,0,0,1,0,0,0,1,0.125
散射体分布,0,0,0,1,0,0,0,1,0.125
空间信道模型,0,0,0,1,0,0,0,1,0.125
空间统计特性,0,0,0,1,0,0,0,1,0.125
统计特性,0,0,0,2,0,0,0,2,0.25
测量数据,0,0,0,1,1,0,0,2,0.3666666666666667
传播特性,0,0,1,1,0,0,0,2,0.25
衰落统计特性,0,0,0,1,0,0,0,1,0.125
统计性模型,0,0,0,1,0,0,0,1,0.125
电磁传播损耗,0,0,0,1,0,0,0,1,0.125
传播,0,0,0,1,0,0,0,1,0.125
预测信号,0,0,0,1,0,0,0,1,0.125
电磁参数,0,0,0,1,0,0,0,1,0.125
地面,0,0,0,1,0,0,0,1,0.125
几何体建,0,0,0,1,0,0,0,1,0.125
传播场,0,0,0,1,0,0,0,1,0.125
射线传播理论,0,0,0,1,0,0,0,1,0.125
灵活性,0,0,0,1,0,0,0,1,0.125
场景参数,0,0,0,1,0,0,0,1,0.125
模拟信道,0,0,0,1,0,0,0,1,0.125
正弦波,0,0,0,1,0,0,0,1,0.125
冲击响应,0,0,0,1,0,0,0,1,0.125
信道衰落,0,0,0,1,0,0,0,1,0.125
传播环,0,0,0,1,0,0,0,1,0.125
射线追踪测量,0,0,0,1,0,0,0,1,0.125
测量建模,0,0,0,1,0,0,0,1,0.125
无线信道传输模型,0,0,0,2,0,0,0,2,0.25
确定性信道模型,0,0,0,2,0,0,0,2,0.25
确定性模型,0,0,0,1,0,0,0,1,0.125
mimo信道建模,0,0,0,1,0,0,0,1,0.125
滩度,0,0,0,1,0,0,0,1,0.125
传输路径,0,0,1,1,1,0,0,3,0.4916666666666667
无线信号,1,0,1,2,0,0,0,4,1.375
传输,0,0,1,1,0,0,0,2,0.25
建模复杂度,0,0,0,1,0,0,0,1,0.125
通信环境,0,0,0,1,0,0,0,1,0.125
通信,0,0,1,2,1,0,0,4,0.6166666666666667
衰落特性,0,0,0,1,0,0,0,1,0.125
空域,0,0,0,1,0,0,0,1,0.125
系统参数,0,0,0,1,0,0,0,1,0.125
通信场,0,0,0,1,0,0,0,1,0.125
发送天线,0,0,0,1,0,0,0,1,0.125
矩阵,0,0,0,1,1,0,0,2,0.3666666666666667
mxn,0,0,0,1,0,0,0,1,0.125
噪声,0,0,0,1,0,1,0,2,0.3666666666666667
接收端信号,0,0,0,1,0,0,0,1,0.125
发射端信号,0,0,0,1,0,0,0,1,0.125
传输环境,1,0,0,1,0,0,0,2,1.125
天线增益,0,0,0,2,4,4,0,10,2.1833333333333336
子信道,0,0,0,1,0,0,0,1,0.125
put,0,0,0,1,0,0,0,1,0.125
ngle,0,0,0,1,0,0,0,1,0.125
singleinput,0,0,0,1,0,0,0,1,0.125
so,0,0,0,1,0,0,0,1,0.125
单入单出,0,0,0,1,0,0,0,1,0.125
并行传输,0,0,0,1,0,0,0,1,0.125
信道相关性,0,0,0,1,0,0,0,1,0.125
无线通信系统,0,0,0,1,0,0,0,1,0.125
信道容量,1,0,1,1,0,0,0,3,1.25
传输效率,0,0,0,1,0,0,0,1,0.125
多径效应,0,0,0,1,0,0,0,1,0.125
无线信道,2,0,0,2,0,0,0,4,2.25
发射端,0,0,0,1,1,0,0,2,0.3666666666666667
通信系统,0,0,0,1,1,2,0,4,0.85
multipleoutput,0,0,0,1,0,0,0,1,0.125
multipleinput,0,0,0,1,0,0,0,1,0.125
多输出,0,0,0,1,0,0,0,1,0.125
多输入,0,0,0,1,0,0,0,1,0.125
建模标准,0,0,0,0,0,1,0,1,0.24166666666666667
定量校准,0,0,0,0,0,1,0,1,0.24166666666666667
定性,0,0,0,0,0,1,0,1,0.24166666666666667
校准阶段,0,0,0,0,0,1,0,1,0.24166666666666667
仿真场景,0,0,0,0,1,1,0,2,0.48333333333333334
附加特性校准,0,0,0,0,0,1,0,1,0.24166666666666667
小尺度参数校准,0,0,0,0,0,3,0,3,0.725
大尺度参数校准,0,0,0,0,0,3,0,3,0.725
自阻塞,0,0,0,3,8,0,0,11,2.3083333333333336
动态阻塞,0,0,0,3,0,0,0,3,0.375
物体,0,0,0,2,1,0,0,3,0.4916666666666667
车辆,0,0,0,2,0,0,0,2,0.25
设备,0,0,1,2,1,0,0,4,0.6166666666666667
多径分量,0,0,0,2,0,0,0,2,0.25
方位角,0,0,0,2,3,0,0,5,0.975
仰角,0,0,0,3,2,0,0,5,0.8583333333333334
特性,0,0,1,1,2,1,0,5,0.975
高频无线信道,0,0,0,1,0,0,0,1,0.125
角度扩展值,0,0,0,1,0,0,0,1,0.125
时延扩展值,0,0,0,1,0,0,0,1,0.125
直射,0,0,0,1,0,0,0,1,0.125
衰减,0,0,0,1,11,0,0,12,2.783333333333333
通堵塞,0,0,0,1,0,0,0,1,0.125
自堵塞,0,0,0,1,0,0,0,1,0.125
静止物体,0,0,0,1,0,0,0,1,0.125
静态阻塞,0,0,0,1,0,0,0,1,0.125
几何阻塞,0,0,0,1,0,0,0,1,0.125
无线电信号,0,0,0,1,0,0,0,1,0.125
电磁传播,0,0,0,1,0,0,0,1,0.125
无线传输信道,0,0,0,1,0,1,0,2,0.3666666666666667
信道阻塞,0,0,0,1,0,0,0,1,0.125
信道阻塞模型,0,0,0,1,0,0,0,1,0.125
信道评估,0,0,0,1,0,0,0,1,0.125
mim0,0,0,0,1,0,0,0,1,0.125
一致性,0,0,0,1,0,0,0,1,0.125
室外状态,0,0,0,1,0,0,0,1,0.125
延迟分布,0,0,0,1,1,0,0,2,0.3666666666666667
快速时变信道,0,0,0,1,0,0,0,1,0.125
信道功率,0,0,0,1,0,0,0,1,0.125
传输链路,0,0,0,1,0,0,0,1,0.125
自相关函数,0,0,0,1,0,0,0,1,0.125
3dmim,0,0,0,1,1,0,0,2,0.3666666666666667
随机信道模型,0,0,0,3,0,0,1,4,0.6166666666666667
快照,0,0,0,7,6,0,0,13,2.325
移动性,0,0,0,1,0,0,1,2,0.3666666666666667
旋转,0,0,0,1,0,0,0,1,0.125
高速移动模式,0,0,0,1,0,0,0,1,0.125
mall,0,0,0,1,0,0,0,1,0.125
商场,0,0,0,1,0,0,0,1,0.125
indooroffice,0,0,0,2,1,1,0,4,0.7333333333333334
opensquare,0,0,0,1,0,0,0,1,0.125
开放广场,0,0,0,1,0,0,0,1,0.125
streetcanyon,0,0,0,1,0,0,0,1,0.125
街谷,0,0,0,1,0,0,0,1,0.125
极化特性,0,0,0,1,0,0,0,1,0.125
天线单元,0,0,0,1,3,0,0,4,0.85
二维双极化,0,0,0,1,0,0,0,1,0.125
用户设备,0,0,0,1,0,0,0,1,0.125
ap,0,0,0,1,0,0,0,1,0.125
接入点,0,0,0,1,0,0,0,1,0.125
毫米波波段,0,0,0,1,0,0,0,1,0.125
3d信道模型,0,0,0,1,0,0,0,1,0.125
pp,0,0,0,1,0,0,0,1,0.125
umi,0,0,5,0,4,25,0,34,7.633333333333334
信干比,0,0,0,0,0,8,0,8,1.9333333333333333
室内场景,0,0,0,0,5,9,0,14,3.3833333333333333
耦合损耗曲线,0,0,0,0,0,2,0,2,0.48333333333333334
大尺度参数校准过程,0,0,0,0,0,1,0,1,0.24166666666666667
室内办公室场景,0,0,0,0,0,1,0,1,0.24166666666666667
对比图,0,0,0,0,0,1,0,1,0.24166666666666667
参考度量,0,0,0,0,0,1,0,1,0.24166666666666667
信道分析,0,0,0,0,0,1,0,1,0.24166666666666667
分布特性,0,0,0,0,0,1,0,1,0.24166666666666667
成过程,0,0,0,0,0,1,0,1,0.24166666666666667
垂直角角度,0,0,0,0,0,1,0,1,0.24166666666666667
水平角角度,0,0,0,0,0,1,0,1,0.24166666666666667
信道生成,0,0,0,0,0,1,0,1,0.24166666666666667
角度参数曲线,0,0,0,0,0,1,0,1,0.24166666666666667
角'度参数,0,0,0,0,0,1,0,1,0.24166666666666667
频尊,0,0,0,0,0,1,0,1,0.24166666666666667
zsd曲线,0,0,0,0,0,1,0,1,0.24166666666666667
zsa,0,0,0,0,0,2,0,2,0.48333333333333334
asd,0,0,0,1,0,2,0,3,0.6083333333333334
sir曲线,0,0,0,0,0,3,0,3,0.725
uma,0,0,4,0,3,16,0,23,5.091666666666667
低耦合路损,0,0,0,0,0,1,0,1,0.24166666666666667
高耦合路损,0,0,0,0,0,1,0,1,0.24166666666666667
干扰避免,0,0,0,0,0,1,0,1,0.24166666666666667
仿真参数,0,0,0,0,0,1,0,1,0.24166666666666667
对比曲线,0,0,0,0,0,1,0,1,0.24166666666666667
宽带信干比,0,0,0,0,0,2,0,2,0.48333333333333334
scm信道,0,0,0,7,0,0,0,7,0.875
中径,0,0,0,5,0,0,0,5,0.625
scme信道,0,0,0,3,0,0,0,3,0.375
scm模型,0,0,0,2,0,0,0,2,0.25
延迟域,0,0,0,2,0,0,0,2,0.25
城区,0,0,0,2,0,0,0,2,0.25
宏小区,0,0,0,3,0,0,0,3,0.375
多径传输,0,0,0,1,0,0,0,1,0.125
信道模型仿真实验,0,0,0,1,0,0,0,1,0.125
函数,0,0,0,1,0,0,0,1,0.125
链路级,0,0,0,1,0,0,0,1,0.125
移动台,0,0,0,1,0,0,0,1,0.125
小尺度衰落,0,0,0,1,0,0,0,1,0.125
单次仿真,0,0,0,1,0,0,0,1,0.125
随机信道,0,0,0,2,0,0,0,2,0.25
scm/scme信道,0,0,0,2,0,0,0,2,0.25
瑞利分布,0,0,0,1,0,0,0,1,0.125
单独子径,0,0,0,1,0,0,0,1,0.125
多样性,0,0,0,1,0,0,0,1,0.125
单抽,0,0,0,1,0,0,0,1,0.125
抽头功率,0,0,0,1,0,0,0,1,0.125
额外时延,0,0,0,1,0,0,0,1,0.125
频率相关特性,0,0,0,1,0,0,0,1,0.125
簇内偏移,0,0,0,1,0,0,0,1,0.125
簇内参数,0,0,0,1,0,0,0,1,0.125
scme模型,0,0,0,1,0,0,0,1,0.125
spatialchannelmodelextension,0,0,0,1,0,0,0,1,0.125
scme,0,0,0,1,0,0,0,1,0.125
支持信道模型,0,0,0,1,0,0,0,1,0.125
随机型信道模型,0,0,0,1,0,0,0,1,0.125
协议,0,0,0,1,0,0,0,1,0.125
tr25,0,0,0,1,0,0,0,1,0.125
快衰落参数,0,0,0,1,0,0,0,1,0.125
角度特性参数,0,0,0,1,0,0,0,1,0.125
子径传播,0,0,0,1,0,0,0,1,0.125
拉普拉斯分布,0,0,0,1,1,0,0,2,0.3666666666666667
子径角度分布,0,0,0,1,0,0,0,1,0.125
角度分布,0,0,0,1,0,0,0,1,0.125
狄拉克函数,0,0,0,1,1,0,0,2,0.3666666666666667
非视距,0,0,0,1,0,0,0,1,0.125
视距,0,0,0,2,0,0,0,2,0.25
城区微小区,0,0,0,1,0,0,0,1,0.125
通信场景,0,0,0,1,0,0,0,1,0.125
微小区,0,0,0,1,0,0,0,1,0.125
几何模型,0,0,0,2,0,0,0,2,0.25
传输子径,0,0,0,3,0,0,0,3,0.375
mimo信道模型,0,0,0,1,0,0,0,1,0.125
多径副散射传播,0,0,0,1,0,0,0,1,0.125
mimo算法,0,0,0,1,0,0,0,1,0.125
3gpp2,0,0,0,1,0,0,0,1,0.125
spatialchannelmodel,0,0,0,1,0,0,0,1,0.125
scm,0,0,0,1,0,0,0,1,0.125
scmscme信道,0,0,0,1,0,0,0,1,0.125
移动通信技术,0,0,5,1,0,0,0,6,0.75
移动通信网络,0,0,3,0,0,0,0,3,0.375
移动通信,0,0,3,0,0,0,0,3,0.375
通信技术,1,0,3,0,0,0,0,4,1.375
移动通信系统,0,0,2,0,0,0,0,2,0.25
imt-2020,0,0,2,0,0,0,0,2,0.25
传输速率,0,0,2,0,0,0,0,2,0.25
通信网络,1,0,2,0,0,0,0,3,1.25
物联网应用,0,0,2,0,0,0,0,2,0.25
物联网,0,0,2,0,0,0,0,2,0.25
导意义,0,0,1,0,0,0,0,1,0.125
高速率,0,0,1,0,0,0,0,1,0.125
爱立信,0,0,1,0,0,0,0,1,0.125
5g移动技术,0,0,1,0,0,0,0,1,0.125
移动技术,0,0,1,0,0,0,0,1,0.125
nttdocomo,0,0,1,0,0,0,0,1,0.125
移动运营商,0,0,1,0,0,0,0,1,0.125
通信厂商,0,0,1,0,0,0,0,1,0.125
itu-r,0,0,1,0,0,0,0,1,0.125
电联无线电通信,0,0,1,0,0,0,0,1,0.125
中兴,0,0,1,0,0,1,0,2,0.3666666666666667
华为,0,0,1,0,0,1,0,2,0.3666666666666667
5g,0,0,1,0,0,0,0,1,0.125
节奏紧凑,0,0,1,0,0,0,0,1,0.125
5g通信技术,0,0,1,0,0,0,0,1,0.125
4glte,0,0,1,0,0,0,0,1,0.125
信号传输,0,0,1,0,0,0,0,1,0.125
器件特性,0,0,1,0,0,0,0,1,0.125
无线传输技,0,0,1,0,0,0,0,1,0.125
带宽资源,0,0,1,0,0,0,0,1,0.125
无线通信业务,0,0,1,0,0,0,0,1,0.125
hz,0,0,1,1,0,5,0,7,1.4583333333333333
流量密度,0,0,1,0,0,0,0,1,0.125
数据速率,0,0,1,0,0,0,0,1,0.125
频谱带宽,1,0,1,0,0,0,0,2,1.125
功耗,0,0,1,0,0,0,0,1,0.125
可靠性,0,0,1,0,0,0,0,1,0.125
差异化,0,0,1,0,0,0,0,1,0.125
设备连接数,0,0,1,0,0,0,0,1,0.125
移动数据流量,0,0,1,0,0,0,0,1,0.125
流量,0,0,1,0,0,0,0,1,0.125
物联网业务,0,0,1,0,0,0,0,1,0.125
设备连接,0,0,1,0,0,0,0,1,0.125
通信领,0,0,1,0,0,0,0,1,0.125
移动通信行业,0,0,1,0,0,0,0,1,0.125
新兴产业,0,0,1,0,0,0,0,1,0.125
万物互联,0,0,1,0,0,0,0,1,0.125
环境检测,0,0,1,0,0,0,0,1,0.125
医疗服务,0,0,1,0,0,0,0,1,0.125
智能家居,0,0,1,0,0,0,0,1,0.125
车联网,0,0,1,0,0,0,0,1,0.125
智能互联,0,0,1,0,0,0,0,1,0.125
服务,0,0,1,0,0,0,0,1,0.125
机器,0,0,1,0,0,0,0,1,0.125
物联网概念,0,0,1,0,0,0,0,1,0.125
高速率传输,0,0,1,0,0,0,0,1,0.125
传递,0,0,1,0,0,0,0,1,0.125
大数据流量,0,0,1,0,0,0,0,1,0.125
通信业务,0,0,1,0,0,0,0,1,0.125
智能终端,0,0,1,0,0,0,0,1,0.125
4g,0,0,1,0,0,0,0,1,0.125
通信服务,0,0,1,0,0,0,0,1,0.125
数字通信,0,0,1,0,0,0,0,1,0.125
模拟语音通信,0,0,1,0,0,0,0,1,0.125
簇延迟线模型,0,0,0,4,0,0,0,4,0.5
城市宏小区,0,0,0,4,0,0,0,4,0.5
winneri,0,0,0,3,0,0,0,3,0.375
acro-cell,0,0,0,2,0,0,0,2,0.25
ba,0,0,0,2,0,0,0,2,0.25
winnerii信道,0,0,0,2,0,0,0,2,0.25
乡村宏小区,0,0,0,2,0,0,0,2,0.25
城郊宏小区,0,0,0,2,0,0,0,2,0.25
城市微小区,0,0,0,2,0,0,0,2,0.25
载频,0,0,0,2,0,0,0,2,0.25
winner信道,0,0,0,3,1,0,0,4,0.6166666666666667
后续链路级仿真,0,0,0,1,0,0,0,1,0.125
莱斯因子,0,0,0,1,0,0,0,1,0.125
仿真莱斯信道,0,0,0,1,0,0,0,1,0.125
抽头延迟,0,0,0,1,0,0,0,1,0.125
cdl,0,0,0,1,0,0,0,1,0.125
簇延迟线,0,0,0,1,0,0,0,1,0.125
winner,0,0,0,1,0,0,0,1,0.125
算法性能测试,0,0,0,1,0,0,0,1,0.125
链路级仿真,0,0,0,1,1,0,0,2,0.3666666666666667
参数化,0,0,0,1,0,0,0,1,0.125
天线配置,0,0,0,1,0,0,0,1,0.125
movingnetworks,0,0,0,1,0,0,0,1,0.125
移动网络,0,0,0,1,0,0,0,1,0.125
ruralmacro-cell,0,0,0,1,0,0,0,1,0.125
doortoindoor,0,0,0,1,0,0,0,1,0.125
urbanmacr,0,0,0,1,0,0,0,1,0.125
恶劣城市,0,0,0,1,0,0,0,1,0.125
urbanmacro-cell,0,0,0,1,0,0,0,1,0.125
su,0,0,0,1,0,0,0,1,0.125
stationaryfeeder,0,0,0,1,0,0,0,1,0.125
固定收发机,0,0,0,1,0,0,0,1,0.125
outdoortoindoor,0,0,0,1,0,0,0,1,0.125
indoorhotspot,0,0,0,1,0,0,0,1,0.125
室内热点,0,0,0,1,0,0,0,1,0.125
icro-cell,0,0,0,1,0,0,0,1,0.125
恶劣城市微小区,0,0,0,1,0,0,0,1,0.125
urbanmicro-cell,0,0,0,1,0,0,0,1,0.125
ut,0,0,0,1,0,0,0,1,0.125
ort,0,0,0,1,0,0,0,1,0.125
in,0,0,0,1,2,2,0,5,1.0916666666666668
室内办公室,0,0,0,1,3,1,0,5,1.0916666666666668
覆盖场,0,0,0,1,0,0,0,1,0.125
通用模型,0,0,0,1,0,0,0,1,0.125
winneri信道,0,0,0,1,0,0,0,1,0.125
信道模型带宽,0,0,0,1,0,0,0,1,0.125
80,0,0,0,1,0,0,0,1,0.125
winner信道模型,0,0,0,1,0,0,0,1,0.125
固定收发机链路,0,0,0,1,0,0,0,1,0.125
mimo建模,0,0,0,1,0,0,0,1,0.125
newradio,0,0,0,1,0,0,0,1,0.125
wirelessworld,0,0,0,1,0,0,0,1,0.125
新无线电技术,0,0,0,1,0,0,0,1,0.125
无线领域,0,0,0,1,0,0,0,1,0.125
随机性信道,0,0,0,0,2,0,1,3,0.725
静态系统级仿真,0,0,0,0,1,0,0,1,0.24166666666666667
系统性能,0,0,0,0,2,0,0,2,0.48333333333333334
仿真结果,1,0,0,0,1,0,0,2,1.2416666666666667
通信链路,0,0,0,0,1,0,0,1,0.24166666666666667
通信系统仿真,0,0,0,0,1,0,0,1,0.24166666666666667
建模流程,0,0,0,0,1,0,0,1,0.24166666666666667
低频信道模型,0,0,0,0,1,0,0,1,0.24166666666666667
数理统计,0,0,0,1,0,0,0,1,0.125
常用,0,0,0,1,0,0,0,1,0.125
坐标系,0,0,0,1,9,0,0,10,2.3
lcs,0,0,0,0,5,0,0,5,1.2083333333333333
单位向量,0,0,0,0,4,0,0,4,0.9666666666666667
直角坐标系,0,0,0,0,5,0,0,5,1.2083333333333333
球坐标系,0,0,0,0,5,0,0,5,1.2083333333333333
si,0,0,0,0,4,0,0,4,0.9666666666666667
cosasin,0,0,0,0,3,0,0,3,0.725
旋转矩阵,0,0,0,0,3,0,0,3,0.725
gcs,0,0,0,0,3,0,0,3,0.725
局部坐标系,0,0,0,0,3,0,0,3,0.725
天线坐标系统,0,0,0,0,3,0,0,3,0.725
电子下倾角,0,0,0,0,2,1,0,3,0.725
机械下倾角,0,0,0,0,2,0,0,2,0.48333333333333334
波束,0,0,0,0,2,0,0,2,0.48333333333333334
极化场分量,0,0,0,0,2,0,0,2,0.48333333333333334
co,0,0,0,0,2,1,0,3,0.725
cosacos,0,0,0,0,2,0,0,2,0.48333333333333334
旋转操作,0,0,0,0,2,0,0,2,0.48333333333333334
弧度,0,0,0,0,2,0,0,2,0.48333333333333334
水平角,0,0,0,0,3,0,0,3,0.725
极化,0,0,0,0,2,1,0,3,0.725
全局坐标系,0,0,0,0,3,0,0,3,0.725
调节,0,0,0,0,1,0,0,1,0.24166666666666667
垂直分量,0,0,0,0,1,0,0,1,0.24166666666666667
方向图,0,0,0,0,1,0,0,1,0.24166666666666667
频繁调节,0,0,0,0,1,0,0,1,0.24166666666666667
波束覆盖距离,0,0,0,0,1,0,0,1,0.24166666666666667
天线支架,0,0,0,0,1,0,0,1,0.24166666666666667
基站天线端,0,0,0,0,1,0,0,1,0.24166666666666667
通信体验,0,0,0,0,1,0,0,1,0.24166666666666667
全向天线,0,0,0,0,2,3,0,5,1.2083333333333333
余弦,0,0,0,0,1,0,0,1,0.24166666666666667
正弦,0,0,0,0,1,0,0,1,0.24166666666666667
sincosysin,0,0,0,0,1,0,0,1,0.24166666666666667
球坐标,0,0,0,0,1,0,0,1,0.24166666666666667
机械旋转角度,0,0,0,0,1,0,0,1,0.24166666666666667
角度位移,0,0,0,0,1,0,0,1,0.24166666666666667
转换矩阵,0,0,0,0,1,0,0,1,0.24166666666666667
单位矢量,0,0,0,0,1,0,0,1,0.24166666666666667
板前,0,0,0,0,1,0,0,1,0.24166666666666667
旋转角,0,0,0,0,1,0,0,1,0.24166666666666667
lcs球坐标,0,0,0,0,1,0,0,1,0.24166666666666667
gcs球坐标,0,0,0,0,1,0,0,1,0.24166666666666667
sinycos,0,0,0,0,1,0,0,1,0.24166666666666667
sincos,0,0,0,0,1,0,0,1,0.24166666666666667
sinceos,0,0,0,0,1,0,0,1,0.24166666666666667
acos,0,0,0,0,1,0,0,1,0.24166666666666667
局部角,0,0,0,0,1,0,0,1,0.24166666666666667
外口,0,0,0,0,1,0,0,1,0.24166666666666667
局坐标系,0,0,0,0,1,0,0,1,0.24166666666666667
顶点角,0,0,0,0,2,0,0,2,0.48333333333333334
平面,0,0,0,0,2,0,0,2,0.48333333333333334
顶点,0,0,0,0,1,0,0,1,0.24166666666666667
单位半径,0,0,0,0,1,0,0,1,0.24166666666666667
坐标点,0,0,0,0,1,0,0,1,0.24166666666666667
变换,0,0,0,0,1,0,0,1,0.24166666666666667
asin,0,0,0,0,1,0,0,1,0.24166666666666667
ac,0,0,0,0,1,0,0,1,0.24166666666666667
sinasincoscosasin,0,0,0,0,1,0,0,1,0.24166666666666667
sinacosyssinasiny,0,0,0,0,1,0,0,1,0.24166666666666667
as,0,0,0,0,1,0,0,1,0.24166666666666667
场型,0,0,0,0,1,0,0,1,0.24166666666666667
极化天线,0,0,0,0,1,0,0,1,0.24166666666666667
坐标系统,0,0,0,0,1,0,0,1,0.24166666666666667
倾斜角,0,0,0,0,1,0,0,1,0.24166666666666667
平面旋转,0,0,0,0,1,0,0,1,0.24166666666666667
x轴不动,0,0,0,0,1,0,0,1,0.24166666666666667
v平面旋转,0,0,0,0,1,0,0,1,0.24166666666666667
y轴不动,0,0,0,0,1,0,0,1,0.24166666666666667
平面旋转a弧度,0,0,0,0,1,0,0,1,0.24166666666666667
z轴不动,0,0,0,0,1,0,0,1,0.24166666666666667
绕轴旋转,0,0,0,0,1,0,0,1,0.24166666666666667
向量,0,0,0,0,1,0,0,1,0.24166666666666667
z轴角度,0,0,0,0,1,0,0,1,0.24166666666666667
x轴角度,0,0,0,0,1,0,0,1,0.24166666666666667
传输电磁波,0,0,0,0,1,0,0,1,0.24166666666666667
传输波束,0,0,0,0,1,0,0,1,0.24166666666666667
坐标轴,0,0,0,0,1,0,0,1,0.24166666666666667
机械旋转,0,0,0,0,1,0,0,1,0.24166666666666667
gcs天线,0,0,0,0,1,0,0,1,0.24166666666666667
天线布局,0,0,0,0,1,0,0,1,0.24166666666666667
远场模式,0,0,0,0,1,0,0,1,0.24166666666666667
局部坐标系统,0,0,0,0,1,0,0,1,0.24166666666666667
空间系统,0,0,0,0,1,0,0,1,0.24166666666666667
ogcs,0,0,0,0,1,0,0,1,0.24166666666666667
localcoordinatesystem,0,0,0,0,1,0,0,1,0.24166666666666667
coordinatesystem,0,0,0,0,1,0,0,1,0.24166666666666667
3d天线阵列,0,0,0,2,1,0,0,3,0.4916666666666667
线性,0,0,0,0,1,0,0,1,0.24166666666666667
均匀线性阵列,0,0,0,0,1,0,0,1,0.24166666666666667
inh,0,0,0,0,1,6,0,7,1.6916666666666667
偏移,0,0,0,0,0,2,0,2,0.48333333333333334
仿真次数,0,0,0,0,0,2,0,2,0.48333333333333334
接入小区,0,0,0,0,0,1,0,1,0.24166666666666667
小区,0,0,0,0,1,8,0,9,2.175
定量,0,0,0,0,0,1,0,1,0.24166666666666667
特征值,0,0,0,0,0,4,0,4,0.9666666666666667
矩阵奇异值,0,0,0,0,0,1,0,1,0.24166666666666667
zsd,0,0,0,0,0,1,0,1,0.24166666666666667
延迟扩展校准,0,0,0,0,0,1,0,1,0.24166666666666667
nsec,0,0,0,0,0,1,0,1,0.24166666666666667
delayspread,0,0,0,0,0,1,0,1,0.24166666666666667
高频信道校准,0,0,0,0,0,1,0,1,0.24166666666666667
高损耗模型,0,0,3,0,0,0,0,3,0.375
低损耗模型,0,0,3,0,0,0,0,3,0.375
材料,0,0,2,0,0,0,0,2,0.25
路径损耗棚,0,0,1,0,0,0,0,1,0.125
阻塞建模,0,0,1,0,0,0,0,1,0.125
小尺度衰落参数,0,0,1,0,0,0,0,1,0.125
概率密度函数,0,0,1,0,0,0,0,1,0.125
大尺度衰落参数,0,0,1,0,0,0,0,1,0.125
室内2d距离,0,0,1,0,0,0,0,1,0.125
lconcrete,0,0,1,0,0,0,0,1,0.125
室内损耗,0,0,1,0,0,0,0,1,0.125
外墙,0,0,1,0,0,0,0,1,0.125
外墙平面,0,0,1,0,0,0,0,1,0.125
筑物,0,0,1,0,0,0,0,1,0.125
室外路径损耗,0,0,1,0,0,0,0,1,0.125
建筑,0,0,1,0,0,0,0,1,0.125
模拟信号,0,0,1,0,0,0,0,1,0.125
penetrationloss,0,0,1,0,0,0,0,1,0.125
有效天线,0,0,1,0,0,0,0,1,0.125
基站端,0,0,1,0,2,0,0,3,0.6083333333333334
光速,0,0,1,0,0,0,0,1,0.125
转折点,0,0,1,0,0,0,0,1,0.125
路损公式,0,0,1,0,0,0,0,1,0.125
plinh-nlos,0,0,1,0,0,0,0,1,0.125
inhnlos,0,0,1,0,0,0,0,1,0.125
los传输条件,0,0,0,0,10,0,0,10,2.4166666666666665
延迟偏移,0,0,0,0,3,0,0,3,0.725
位置矢量,0,0,0,0,3,0,0,3,0.725
中束分裂,0,0,0,0,2,0,0,2,0.48333333333333334
球面单位向量,0,0,0,0,2,0,0,2,0.48333333333333334
天线响应,0,0,0,0,2,1,0,3,0.725
信道冲激响应,0,0,0,0,1,0,0,1,0.24166666666666667
线性值,0,0,0,0,2,0,0,2,0.48333333333333334
缩放系数,0,0,0,0,1,0,0,1,0.24166666666666667
视距内传播子径,0,0,0,0,1,0,0,1,0.24166666666666667
expoc,0,0,0,0,1,0,0,1,0.24166666666666667
ex,0,0,0,0,1,0,0,1,0.24166666666666667
信道冲击响应,0,0,0,0,1,0,0,1,0.24166666666666667
多径延迟拓展,0,0,0,0,1,0,0,1,0.24166666666666667
cqs,0,0,0,0,1,0,0,1,0.24166666666666667
弓厂弓,0,0,0,0,1,0,0,1,0.24166666666666667
子径集合,0,0,0,0,1,0,0,1,0.24166666666666667
多径分裂序号,0,0,0,0,1,0,0,1,0.24166666666666667
分裂多径,0,0,0,0,1,0,0,1,0.24166666666666667
參径,0,0,0,0,1,0,0,1,0.24166666666666667
多径数目,0,0,0,0,1,0,0,1,0.24166666666666667
coscossins,0,0,0,0,1,0,0,1,0.24166666666666667
sinsin6,0,0,0,0,1,0,0,1,0.24166666666666667
vnm-rrx,0,0,0,0,1,0,0,1,0.24166666666666667
偏离角度,0,0,0,0,1,0,0,1,0.24166666666666667
垂直速度,0,0,0,0,1,0,0,1,0.24166666666666667
水平速度,0,0,0,0,1,0,0,1,0.24166666666666667
多普勒频移因子,0,0,0,0,1,0,0,1,0.24166666666666667
垂直极化,0,0,0,0,1,2,0,3,0.725
色辨,0,0,0,0,1,0,0,1,0.24166666666666667
标量,0,0,0,0,1,0,0,1,0.24166666666666667
极化矩阵,0,0,0,0,1,0,0,1,0.24166666666666667
天线极化,0,0,0,0,1,2,0,3,0.725
波长,0,0,0,0,3,0,0,3,0.725
cos,0,0,0,0,1,0,0,1,0.24166666666666667
pinsin,0,0,0,0,1,0,0,1,0.24166666666666667
°5,0,0,0,0,1,0,0,1,0.24166666666666667
角虹皿,0,0,0,0,1,0,0,1,0.24166666666666667
sscos,0,0,0,0,1,0,0,1,0.24166666666666667
欢如心,0,0,0,0,1,0,0,1,0.24166666666666667
sm,0,0,0,0,1,0,0,1,0.24166666666666667
玲心,0,0,0,0,1,0,0,1,0.24166666666666667
面板,0,0,0,0,3,0,0,3,0.725
水平维度,0,0,0,0,3,1,0,4,0.9666666666666667
高度,0,0,0,2,4,0,0,6,1.2166666666666668
pathloss,0,0,0,0,2,0,0,2,0.48333333333333334
间隔距离,0,0,0,0,2,0,0,2,0.48333333333333334
面板数,0,0,0,0,2,0,0,2,0.48333333333333334
增益,0,0,0,0,2,0,0,2,0.48333333333333334
室外用户,0,0,0,0,2,0,0,2,0.48333333333333334
垂直维度,0,0,0,0,2,1,0,3,0.725
天花板,0,0,0,0,2,0,0,2,0.48333333333333334
水平方向,0,0,0,0,2,0,0,2,0.48333333333333334
中心距离,0,0,0,0,2,0,0,2,0.48333333333333334
扇区模型,0,0,0,0,2,1,0,3,0.725
六边形蜂窝小区,0,0,0,0,2,0,0,2,0.48333333333333334
uma场景,0,0,0,0,3,0,0,3,0.725
umalospl,0,0,0,0,1,0,0,1,0.24166666666666667
有效距离,0,0,0,0,1,0,0,1,0.24166666666666667
米阴影衰落标准差,0,0,0,0,1,0,0,1,0.24166666666666667
场景路损,0,0,0,0,1,0,0,1,0.24166666666666667
场景信道,0,0,0,0,1,0,0,1,0.24166666666666667
常数,0,0,0,0,2,0,0,2,0.48333333333333334
pz,0,0,0,0,1,0,0,1,0.24166666666666667
室内距离,0,0,0,0,1,0,0,1,0.24166666666666667
室外距离,0,0,0,0,1,0,0,1,0.24166666666666667
维度距离,0,0,0,0,1,0,0,1,0.24166666666666667
nlos场景,0,0,0,0,1,0,0,1,0.24166666666666667
位置坐标,0,0,0,0,1,0,0,1,0.24166666666666667
基站天线模型,0,0,0,0,1,0,0,1,0.24166666666666667
双极化,0,0,0,0,1,0,0,1,0.24166666666666667
单极化,0,0,0,0,1,0,0,1,0.24166666666666667
单元数,0,0,0,0,1,0,0,1,0.24166666666666667
同极化,0,0,0,0,1,0,0,1,0.24166666666666667
天线单元数,0,0,0,0,1,0,0,1,0.24166666666666667
平板,0,0,0,0,1,0,0,1,0.24166666666666667
阵列,0,0,0,0,1,0,0,1,0.24166666666666667
矩形面板阵列,0,0,0,0,1,0,0,1,0.24166666666666667
天线模型,0,0,0,1,1,0,0,2,0.3666666666666667
定向增益,0,0,0,0,1,0,0,1,0.24166666666666667
slav,0,0,0,0,1,0,0,1,0.24166666666666667
slay,0,0,0,0,1,0,0,1,0.24166666666666667
垂直方向增益,0,0,0,0,1,0,0,1,0.24166666666666667
参数增益,0,0,0,0,1,0,0,1,0.24166666666666667
网络拓扑结构,0,0,0,0,1,0,0,1,0.24166666666666667
扇区,0,0,0,0,1,1,0,2,0.48333333333333334
ue端天线,0,0,0,0,1,1,0,2,0.48333333333333334
三维空间,0,0,0,2,1,0,0,3,0.4916666666666667
位置,0,0,0,0,1,0,0,1,0.24166666666666667
垂直高度分布,0,0,0,0,1,0,0,1,0.24166666666666667
室外场景,0,0,0,0,1,1,0,2,0.48333333333333334
用户撒点,0,0,0,0,1,0,0,1,0.24166666666666667
用户坐标,0,0,0,0,1,0,0,1,0.24166666666666667
室内场景基站,0,0,0,0,1,0,0,1,0.24166666666666667
基站高度,0,0,0,0,1,0,0,1,0.24166666666666667
手持终端,0,0,0,0,1,0,0,1,0.24166666666666667
等距离分布,0,0,0,0,1,0,0,1,0.24166666666666667
indoor-office,0,0,0,0,1,0,0,1,0.24166666666666667
室内办公区域,0,0,0,0,1,0,0,1,0.24166666666666667
高频信道场景,0,0,0,0,1,0,0,1,0.24166666666666667
3dmim0信道,0,0,0,0,1,0,0,1,0.24166666666666667
ue比,0,0,0,0,1,0,0,1,0.24166666666666667
umi街谷,0,0,0,0,1,0,0,1,0.24166666666666667
室内基站,0,0,0,0,1,0,0,1,0.24166666666666667
小区基站信号,0,0,0,0,1,0,0,1,0.24166666666666667
干扰信号,0,0,0,0,1,4,0,5,1.2083333333333333
室内办公室环境,0,0,0,0,1,0,0,1,0.24166666666666667
都市宏小区环境,0,0,0,0,1,0,0,1,0.24166666666666667
umi-streetcanyon,0,0,0,0,1,0,0,1,0.24166666666666667
街谷环境,0,0,0,0,1,0,0,1,0.24166666666666667
都市,0,0,0,0,1,0,0,1,0.24166666666666667
场景布局,0,0,0,0,2,0,0,2,0.48333333333333334
通用参数,0,0,0,0,1,0,0,1,0.24166666666666667
二维平面,0,0,0,2,0,0,0,2,0.25
天线场,0,0,0,1,0,0,0,1,0.125
天线结构,0,0,0,1,0,0,0,1,0.125
传输距离,0,0,0,1,0,0,0,1,0.125
dmimo信道,0,0,0,1,0,0,0,1,0.125
bs,0,0,0,1,0,0,0,1,0.125
统计型信道模型,0,0,0,1,0,0,0,1,0.125
tr36,0,0,0,1,0,0,0,1,0.125
传播子径,0,0,0,1,0,0,0,1,0.125
障碍物,0,0,0,1,1,0,0,2,0.3666666666666667
传播路径,0,0,0,1,0,0,0,1,0.125
折射,0,0,0,1,0,0,0,1,0.125
绕射,0,0,0,1,0,0,0,1,0.125
垂直空间,0,0,0,1,0,0,0,1,0.125
传输场景,0,0,0,1,0,0,0,1,0.125
无线传输,0,0,0,1,0,0,0,1,0.125
mim0信道,0,0,0,1,0,0,0,1,0.125
imt-a信道,0,0,0,6,0,0,0,6,0.75
无线通信,0,0,0,0,0,0,2,2,0.48333333333333334
数据,0,0,0,0,0,0,1,1,0.24166666666666667
标准化,0,0,0,0,0,0,1,1,0.24166666666666667
信道参量,0,0,0,0,0,0,1,1,0.24166666666666667
额外阻塞模型,0,0,0,0,0,0,1,1,0.24166666666666667
新传输特性,0,0,0,0,0,0,1,1,0.24166666666666667
高频条,0,0,0,0,0,0,1,1,0.24166666666666667
低频,1,0,0,0,1,0,1,3,1.4833333333333334
集中信道模型,0,0,0,0,0,0,1,1,0.24166666666666667
3dmtm,0,0,0,0,0,0,1,1,0.24166666666666667
电信,0,0,0,0,0,0,1,1,0.24166666666666667
工信部,0,0,0,0,0,0,1,1,0.24166666666666667
sinr曲线,0,0,0,0,0,4,0,4,0.9666666666666667
ling,0,0,0,0,0,3,0,3,0.725
70ghz,0,0,0,0,0,3,0,3,0.725
有用信号,0,0,0,0,0,2,0,2,0.48333333333333334
馈电损耗,0,0,0,0,0,2,0,2,0.48333333333333334
geometrysir,0,0,0,0,0,2,0,2,0.48333333333333334
平台仿真,0,0,0,0,0,1,0,1,0.24166666666666667
校准结果,0,0,0,0,0,1,0,1,0.24166666666666667
英特尔,0,0,0,0,0,1,0,1,0.24166666666666667
sin,0,0,0,0,0,1,0,1,0.24166666666666667
绝对数值,0,0,0,0,0,1,0,1,0.24166666666666667
indoor,0,0,0,1,0,1,0,2,0.3666666666666667
比率,0,0,0,0,0,1,0,1,0.24166666666666667
信干比曲线,0,0,0,0,0,1,0,1,0.24166666666666667
oo,0,0,0,0,0,1,0,1,0.24166666666666667
頻率信干比曲线,0,0,0,0,0,1,0,1,0.24166666666666667
ljmi,0,0,0,0,0,1,0,1,0.24166666666666667
geometrysinr,0,0,0,0,0,1,0,1,0.24166666666666667
频率信干噪比曲线,0,0,0,0,0,1,0,1,0.24166666666666667
um,0,0,0,0,0,1,0,1,0.24166666666666667
频率耦合损耗曲线,0,0,0,0,0,1,0,1,0.24166666666666667
校准参量曲线,0,0,0,0,0,1,0,1,0.24166666666666667
仿真测,0,0,0,0,0,1,0,1,0.24166666666666667
30ghz,0,0,0,0,0,1,0,1,0.24166666666666667
6ghz,0,0,0,0,0,2,0,2,0.48333333333333334
大尺度校准度量,0,0,0,0,0,1,0,1,0.24166666666666667
发射功率,0,0,0,0,0,6,0,6,1.45
ghz,0,0,0,0,0,7,0,7,1.6916666666666667
阵子数,0,0,0,0,0,2,0,2,0.48333333333333334
白噪,0,0,0,0,0,1,0,1,0.24166666666666667
噪声系数,0,0,0,0,0,1,0,1,0.24166666666666667
接入,0,0,0,0,0,2,0,2,0.48333333333333334
patfiloss,0,0,0,0,0,1,0,1,0.24166666666666667
数据传输,0,0,0,0,0,1,0,1,0.24166666666666667
用户接入,0,0,0,0,0,2,0,2,0.48333333333333334
撒点,0,0,0,0,0,1,0,1,0.24166666666666667
夭线发射功率,0,0,0,0,0,1,0,1,0.24166666666666667
天线发射功率,0,0,0,0,0,2,0,2,0.48333333333333334
天线端口,0,0,0,0,0,2,0,2,0.48333333333333334
豪下天线,0,0,0,0,0,1,0,1,0.24166666666666667
矢线数,0,0,0,0,0,1,0,1,0.24166666666666667
发射天线端口,0,0,0,0,0,1,0,1,0.24166666666666667
间距,0,0,0,0,0,1,0,1,0.24166666666666667
垂直维天线,0,0,0,0,0,1,0,1,0.24166666666666667
无线距离,0,0,0,0,0,1,0,1,0.24166666666666667
环绕,0,0,0,0,0,1,0,1,0.24166666666666667
小区环绕,0,0,0,0,0,1,0,1,0.24166666666666667
测试频点,0,0,0,0,0,1,0,1,0.24166666666666667
高穿透损耗,0,0,0,0,0,1,0,1,0.24166666666666667
低穿透损耗,0,0,0,0,0,1,0,1,0.24166666666666667
ue噪声参数,0,0,0,0,0,1,0,1,0.24166666666666667
路损接入,0,0,0,0,0,1,0,1,0.24166666666666667
ue接入,0,0,0,0,0,2,0,2,0.48333333333333334
ue天线,0,0,0,0,0,2,0,2,0.48333333333333334
gh,0,0,0,0,0,1,0,1,0.24166666666666667
r3,0,0,0,0,0,1,0,1,0.24166666666666667
mhz,0,0,0,0,0,1,0,1,0.24166666666666667
频点,0,0,0,0,0,2,0,2,0.48333333333333334
天线虚拟化,0,0,0,0,0,1,0,1,0.24166666666666667
扇区天线,0,0,0,0,0,1,0,1,0.24166666666666667
ma,0,0,0,0,0,1,0,1,0.24166666666666667
校准度量,0,0,0,0,0,1,0,1,0.24166666666666667
功率带宽,0,0,0,0,0,1,0,1,0.24166666666666667
仿真假设,0,0,0,0,0,1,0,1,0.24166666666666667
大尺度步骤,0,0,0,0,0,1,0,1,0.24166666666666667
主模块,0,0,0,2,0,0,0,2,0.25
imt-a,0,0,0,2,0,0,0,2,0.25
扩展模块,0,0,0,1,0,0,0,1,0.125
仿真场,0,0,0,1,0,0,0,1,0.125
拓展模块,0,0,0,1,0,0,0,1,0.125
子径参数,0,0,0,1,0,0,0,1,0.125
路径,0,0,0,1,3,0,0,4,0.85
空间传播,0,0,0,1,0,0,0,1,0.125
多天线技术,0,0,0,1,0,0,0,1,0.125
评估信道,0,0,0,1,0,0,0,1,0.125
highspeed,0,0,0,1,0,0,0,1,0.125
高速环境,0,0,0,1,0,0,0,1,0.125
ban,0,0,0,1,0,0,0,1,0.125
basecoverage,0,0,0,1,0,0,0,1,0.125
microcellular,0,0,0,1,0,0,0,1,0.125
微蜂窝小区,0,0,0,1,0,0,0,1,0.125
loomhzoitu,0,0,0,1,0,0,0,1,0.125
itu,0,0,0,1,0,0,0,1,0.125
imt-advanced,0,0,0,1,0,0,0,1,0.125
imt,0,0,0,1,0,0,0,1,0.125
缩放因子,0,0,0,0,3,0,0,3,0.725
初始相位,0,0,0,0,2,1,0,3,0.725
正态分布,0,0,0,0,2,0,0,2,0.48333333333333334
los角度,0,0,0,0,2,0,0,2,0.48333333333333334
等概率,0,0,0,0,2,0,0,2,0.48333333333333334
随机正负号,0,0,0,0,2,0,0,2,0.48333333333333334
正负角,0,0,0,0,2,0,0,2,0.48333333333333334
偏移角度,0,0,0,0,2,0,0,2,0.48333333333333334
莱斯k因子补偿,0,0,0,0,2,0,0,2,0.48333333333333334
指数分布,0,0,0,0,2,0,0,2,0.48333333333333334
oloso,0,0,0,0,1,0,0,1,0.24166666666666667
随机初始相位,0,0,0,0,1,0,0,1,0.24166666666666667
會极化,0,0,0,0,1,0,0,1,0.24166666666666667
上服从,0,0,0,0,1,0,0,1,0.24166666666666667
初始随机相位,0,0,0,0,1,0,0,1,0.24166666666666667
岡彼,0,0,0,0,1,0,0,1,0.24166666666666667
对数,0,0,0,0,1,0,0,1,0.24166666666666667
传输径,0,0,0,0,1,0,0,1,0.24166666666666667
los传输条,0,0,0,0,1,0,0,1,0.24166666666666667
阳g细,0,0,0,0,1,0,0,1,0.24166666666666667
子径偏移角,0,0,0,0,1,0,0,1,0.24166666666666667
偏移系数,0,0,0,0,1,0,0,1,0.24166666666666667
生成,0,0,0,0,1,0,0,1,0.24166666666666667
位心,0,0,0,0,1,0,0,1,0.24166666666666667
凡凯,0,0,0,0,1,0,0,1,0.24166666666666667
径数量,0,0,0,0,1,0,0,1,0.24166666666666667
拉普拉斯函数,0,0,0,0,1,0,0,1,0.24166666666666667
4god,0,0,0,0,1,0,0,1,0.24166666666666667
基础偏移角度,0,0,0,0,1,0,0,1,0.24166666666666667
子径序号,0,0,0,0,1,0,0,1,0.24166666666666667
偏移角,0,0,0,0,1,0,0,1,0.24166666666666667
7子径,0,0,0,0,1,0,0,1,0.24166666666666667
aoa角度扩,0,0,0,0,1,0,0,1,0.24166666666666667
casa,0,0,0,0,1,0,0,1,0.24166666666666667
常量,0,0,0,0,1,0,0,1,0.24166666666666667
布局,0,0,0,0,1,0,0,1,0.24166666666666667
los径,0,0,0,0,1,0,0,1,0.24166666666666667
多径数,0,0,0,0,1,0,0,1,0.24166666666666667
信道多径总数,0,0,0,0,1,0,0,1,0.24166666666666667
rms角度,0,0,0,0,1,0,0,1,0.24166666666666667
截断高斯分布,0,0,0,0,1,0,0,1,0.24166666666666667
角度功率谱,0,0,0,0,1,0,0,1,0.24166666666666667
垂直角,0,0,0,0,1,0,0,1,0.24166666666666667
狄拉克8函数,0,0,0,0,1,0,0,1,0.24166666666666667
反射系数,0,0,0,0,1,0,0,1,0.24166666666666667
总功率,0,0,0,0,1,0,0,1,0.24166666666666667
rtfr-ds,0,0,0,0,1,0,0,1,0.24166666666666667
多径功率分布,0,0,0,0,1,0,0,1,0.24166666666666667
幅值,0,0,0,0,1,0,0,1,0.24166666666666667
延迟弥补,0,0,0,0,1,0,0,1,0.24166666666666667
概率因子,0,0,0,0,1,0,0,1,0.24166666666666667
多径序号,0,0,0,0,1,0,0,1,0.24166666666666667
延退分布函数,0,0,0,0,1,0,0,1,0.24166666666666667
多径延退,0,0,0,0,1,0,0,1,0.24166666666666667
生成延迟,0,0,0,0,1,0,0,1,0.24166666666666667
时间间隔,0,0,0,0,1,0,0,1,0.24166666666666667
od,0,0,0,0,0,3,0,3,0.725
prb,0,0,0,0,0,3,0,3,0.725
奇异值,0,0,0,0,0,3,0,3,0.725
oa,0,0,0,0,0,2,0,2,0.48333333333333334
时刻,0,0,0,0,0,2,0,2,0.48333333333333334
权重,0,0,0,0,0,1,0,1,0.24166666666666667
映射,0,0,0,0,0,1,0,1,0.24166666666666667
矢线端口,0,0,0,0,0,1,0,1,0.24166666666666667
响应,0,0,0,0,0,1,0,1,0.24166666666666667
天线阵,0,0,0,0,0,1,0,1,0.24166666666666667
端口,0,0,0,0,0,1,0,1,0.24166666666666667
子载波数,0,0,0,0,0,1,0,1,0.24166666666666667
信道特征矩阵,0,0,0,0,0,1,0,1,0.24166666666666667
线性偏移,0,0,0,0,0,1,0,1,0.24166666666666667
ynymep,0,0,0,0,0,1,0,1,0.24166666666666667
开角角度,0,0,0,0,0,1,0,1,0.24166666666666667
到达角角度,0,0,0,0,0,1,0,1,0.24166666666666667
rp,0,0,0,0,0,1,0,1,0.24166666666666667
widebandsir,0,0,0,0,0,1,0,1,0.24166666666666667
度量,0,0,0,0,0,1,0,1,0.24166666666666667
数值,0,0,0,0,0,1,0,1,0.24166666666666667
ving,0,0,0,0,0,1,0,1,0.24166666666666667
ce,0,0,0,0,0,1,0,1,0.24166666666666667
gnal,0,0,0,0,0,1,0,1,0.24166666666666667
reference,0,0,0,0,0,1,0,1,0.24166666666666667
接收功率,0,0,0,0,0,1,0,1,0.24166666666666667
参考信号,0,0,0,0,0,1,0,1,0.24166666666666667
60ghz,0,0,0,0,0,1,0,1,0.24166666666666667
垂直方向,0,0,0,0,0,1,0,1,0.24166666666666667
交叉极化,0,0,0,0,0,1,0,1,0.24166666666666667
天线间距,0,0,0,0,0,1,0,1,0.24166666666666667
校准表,0,0,0,0,0,1,0,1,0.24166666666666667
特征,0,0,0,0,0,1,0,1,0.24166666666666667
平均协方差矩阵,0,0,0,0,0,1,0,1,0.24166666666666667
服务小区时延,0,0,0,0,0,1,0,1,0.24166666666666667
信干,0,0,0,0,0,1,0,1,0.24166666666666667
耦合路,0,0,0,0,0,1,0,1,0.24166666666666667
rsrp接入,0,0,0,0,0,1,0,1,0.24166666666666667
不诲端口,0,0,0,0,0,1,0,1,0.24166666666666667
端口映射,0,0,0,0,0,1,0,1,0.24166666666666667
基站天线功率,0,0,0,0,0,1,0,1,0.24166666666666667
for30ghz,0,0,0,0,0,1,0,1,0.24166666666666667
100mhz,0,0,0,0,0,1,0,1,0.24166666666666667
仿真频率,0,0,0,0,0,1,0,1,0.24166666666666667
3d-uma,0,0,0,0,0,1,0,1,0.24166666666666667
校准仿箕,0,0,0,0,0,1,0,1,0.24166666666666667
検准参量,0,0,0,0,0,1,0,1,0.24166666666666667
随机,0,0,0,0,0,1,0,1,0.24166666666666667
快速衰落特性,0,0,0,0,0,1,0,1,0.24166666666666667
小尺度参数参数,0,0,0,0,0,1,0,1,0.24166666666666667
阻塞体,0,0,0,0,37,0,0,37,8.941666666666666
正负号,0,0,0,0,5,0,0,5,1.2083333333333333
远场阻塞,0,0,0,0,3,0,0,3,0.725
锐角,0,0,0,0,2,0,0,2,0.48333333333333334
内角,0,0,0,0,2,0,0,2,0.48333333333333334
阻塞体平面,0,0,0,0,2,0,0,2,0.48333333333333334
边缘,0,0,0,0,2,0,0,2,0.48333333333333334
密度,0,0,0,0,2,0,0,2,0.48333333333333334
宽度,0,0,0,0,2,0,0,2,0.48333333333333334
阻塞体编号,0,0,0,0,2,0,0,2,0.48333333333333334
阻塞参数,0,0,0,0,2,0,0,2,0.48333333333333334
自阻塞模型,0,0,0,0,2,0,0,2,0.48333333333333334
近场阻塞,0,0,0,0,2,0,0,2,0.48333333333333334
几何建模,0,0,0,0,1,0,0,1,0.24166666666666667
上阻塞体,0,0,0,0,1,0,0,1,0.24166666666666667
非直射径径,0,0,0,0,1,0,0,1,0.24166666666666667
直射径径上阻塞体,0,0,0,0,1,0,0,1,0.24166666666666667
宽度边哋,0,0,0,0,1,0,0,1,0.24166666666666667
高度边験,0,0,0,0,1,0,0,1,0.24166666666666667
弓堆,0,0,0,0,1,0,0,1,0.24166666666666667
垂直距离,0,0,0,0,1,0,0,1,0.24166666666666667
直线距离,0,0,0,0,1,0,0,1,0.24166666666666667
子径旋转,0,0,0,0,1,0,0,1,0.24166666666666667
网网,0,0,0,0,1,0,0,1,0.24166666666666667
path,0,0,0,0,1,0,0,1,0.24166666666666667
初网邮帽,0,0,0,0,1,0,0,1,0.24166666666666667
刀锋边缘衍射,0,0,0,0,1,0,0,1,0.24166666666666667
刀刃边缘衍射模型,0,0,0,0,1,0,0,1,0.24166666666666667
阻塞体参数,0,0,0,0,1,0,0,1,0.24166666666666667
阻塞体中心,0,0,0,0,1,0,0,1,0.24166666666666667
厚度,0,0,0,0,1,0,0,1,0.24166666666666667
屏幕,0,0,0,0,1,0,0,1,0.24166666666666667
中心,0,0,0,0,1,0,0,1,0.24166666666666667
stepb,0,0,0,0,1,0,0,1,0.24166666666666667
stepa,0,0,0,0,1,0,0,1,0.24166666666666667
fbr,0,0,0,0,1,0,0,1,0.24166666666666667
zpz2,0,0,0,0,1,0,0,1,0.24166666666666667
tail函数,0,0,0,0,1,0,0,1,0.24166666666666667
2v2coscos,0,0,0,0,1,0,0,1,0.24166666666666667
水平方,0,0,0,0,1,0,0,1,0.24166666666666667
横向模式,0,0,0,0,1,0,0,1,0.24166666666666667
纵向模式,0,0,0,0,1,0,0,1,0.24166666666666667
顶点角跨度,0,0,0,0,1,0,0,1,0.24166666666666667
方位角跨度,0,0,0,0,1,0,0,1,0.24166666666666667
空间一,0,0,0,0,1,0,0,1,0.24166666666666667
角度跨度,0,0,0,0,1,0,0,1,0.24166666666666667
垂直顶点角,0,0,0,0,1,0,0,1,0.24166666666666667
水平方位角,0,0,0,0,1,0,0,1,0.24166666666666667
跨度,0,0,0,0,1,0,0,1,0.24166666666666667
数量,0,0,0,0,1,0,0,1,0.24166666666666667
泛用性,0,0,0,0,1,0,0,1,0.24166666666666667
接收方,0,0,0,0,1,0,0,1,0.24166666666666667
阻塞生成步骤,0,0,0,0,1,0,0,1,0.24166666666666667
小六度参数,0,0,0,0,1,0,0,1,0.24166666666666667
nlos传播场,0,0,0,0,1,0,0,1,0.24166666666666667
网塞模型,0,0,0,0,1,0,0,1,0.24166666666666667
无线传输信号,0,0,0,0,1,0,0,1,0.24166666666666667
绕射能力,0,0,0,0,1,0,0,1,0.24166666666666667
blockage,0,0,0,0,1,0,0,1,0.24166666666666667
阻塞特性,0,0,0,0,1,0,0,1,0.24166666666666667
MIMO,0,1,0,0,0,0,0,1,2.0
校准分析,0,1,0,0,0,0,0,1,2.0
物理特性,1,0,0,0,0,0,0,1,1.0
传输机制,1,0,0,0,0,0,0,1,1.0
无线技术性能,1,0,0,0,0,0,0,1,1.0
高频特性参数,1,0,0,0,0,0,0,1,1.0
几何,1,0,0,0,0,0,0,1,1.0
