,摘要,关键词,第一章,第二章,第三章,第四章,第五章,总词频,加权得分
vdmm,3,0,4,0,40,39,3,89,23.316666666666666
切换时延,3,0,5,0,5,2,0,15,5.316666666666666
移动性管理,1,0,15,15,4,0,0,35,5.716666666666667
ap负载,1,0,6,0,10,0,0,17,4.166666666666666
虚拟ap,3,0,3,0,84,8,7,105,27.3
分布式移动性管理,1,1,8,29,26,2,4,71,15.358333333333334
网络,2,0,8,30,11,5,3,59,11.341666666666667
算法,0,0,4,0,4,1,2,11,2.1916666666666664
负载,1,0,3,2,51,2,1,60,14.675
信号强度,1,0,2,0,1,0,0,4,1.4916666666666667
丢包率,0,0,2,2,15,32,2,53,12.341666666666667
ietfdmm,0,0,5,1,15,20,1,42,9.45
信令流程,0,0,3,2,9,1,0,15,3.0416666666666665
虚拟化,0,1,3,8,10,0,1,23,6.033333333333333
隧道,2,0,10,14,24,2,0,52,11.283333333333333
分布式,0,0,2,14,1,0,0,17,2.2416666666666667
网络吞吐量,0,0,1,0,4,0,0,5,1.0916666666666668
ap间负载,0,0,1,0,0,0,0,1,0.125
性能,2,0,4,2,2,12,0,22,6.133333333333333
仿真,0,0,3,0,0,0,0,3,0.375
代码,0,0,1,0,1,2,1,5,1.0916666666666668
ap负载均衡,0,0,1,0,3,0,0,4,0.85
网络架构,0,0,2,3,1,0,0,6,0.8666666666666667
自适应负载均衡算法,1,0,3,0,7,0,1,12,3.3083333333333336
wlam网络,0,0,1,0,0,0,0,1,0.125
vdmm方案,0,0,1,0,7,4,0,12,2.783333333333333
数学公式,0,0,1,0,0,0,0,1,0.125
性能分析,0,0,1,0,0,0,0,1,0.125
数学建模,0,0,2,0,1,1,0,4,0.7333333333333334
数据通信流程,0,0,4,0,3,1,0,8,1.4666666666666668
信令潦,0,0,1,0,0,0,0,1,0.125
双向隧道,0,0,9,4,10,3,0,26,4.766666666666667
连接,1,0,1,0,5,0,0,7,2.333333333333333
状态信息,1,0,1,0,12,0,0,14,4.025
网络层,1,0,1,1,8,0,0,11,3.1833333333333336
链路层,1,0,1,0,10,0,0,12,3.5416666666666665
用户,0,0,1,2,22,1,3,29,6.658333333333333
接入用户,0,0,1,0,0,0,0,1,0.125
转发路径,1,0,4,0,5,0,1,11,2.95
nfv,0,0,1,16,0,0,0,17,2.125
功能虚拟化,0,0,1,3,0,0,0,4,0.5
sdn,0,0,1,26,4,0,0,31,4.341666666666667
pmipv6,0,0,8,6,0,0,0,14,1.75
mipv6,0,0,6,0,0,0,0,6,0.75
移动性管理协议,0,0,4,2,0,0,0,6,0.75
切换优化,1,0,0,0,2,0,0,3,1.4833333333333334
控制器,0,0,0,16,88,8,5,117,26.408333333333335
消息处理模块,0,0,0,0,0,6,0,6,1.45
mn,0,0,27,43,6,11,0,87,12.858333333333334
bytesequence,0,0,0,0,0,4,0,4,0.9666666666666667
数据,0,0,16,8,17,4,0,45,8.075
接入,0,0,0,1,5,4,0,10,2.3
位置管理模块,0,0,0,0,0,4,0,4,0.9666666666666667
接入处理模块,0,0,0,0,0,4,0,4,0.9666666666666667
ap2,0,0,0,0,53,4,0,57,13.775
headers,0,0,0,0,0,3,0,3,0.725
消息,0,0,0,1,0,3,0,4,0.85
ap3,0,0,0,0,17,4,0,21,5.075
pipeline,0,0,0,0,0,2,0,2,0.48333333333333334
init,0,0,0,0,0,2,0,2,0.48333333333333334
ush,0,0,0,0,0,2,0,2,0.48333333333333334
response,0,0,0,0,0,2,0,2,0.48333333333333334
leaseid,0,0,0,0,0,2,0,2,0.48333333333333334
th,0,0,0,0,0,2,0,2,0.48333333333333334
strkey,0,0,0,0,0,2,0,2,0.48333333333333334
地址,0,0,1,2,7,2,0,12,2.55
ip地址,0,0,5,4,13,2,2,26,5.233333333333333
id,0,0,0,0,0,2,0,2,0.48333333333333334
映射表,0,0,0,1,33,2,2,38,9.066666666666666
register,0,0,0,0,0,2,0,2,0.48333333333333334
函数,0,0,0,0,0,2,0,2,0.48333333333333334
模块,0,0,0,0,0,2,0,2,0.48333333333333334
解密模块,0,0,0,0,0,2,0,2,0.48333333333333334
加密/,0,0,0,0,0,2,0,2,0.48333333333333334
vap3,0,0,0,0,15,2,0,17,4.108333333333333
vap2,0,0,0,0,2,3,0,5,1.2083333333333333
平台,1,0,0,0,0,4,1,6,2.208333333333333
executorservice,0,0,0,0,0,1,0,1,0.24166666666666667
consumerclient,0,0,0,0,0,1,0,1,0.24166666666666667
httpserverhandler,0,0,0,0,0,1,0,1,0.24166666666666667
consumeragent,0,0,0,0,0,1,0,1,0.24166666666666667
aggregator,0,0,0,0,0,1,0,1,0.24166666666666667
httpobject,0,0,0,0,0,1,0,1,0.24166666666666667
naggregator,0,0,0,0,0,1,0,1,0.24166666666666667
newhttprequestdecoder,0,0,0,0,0,1,0,1,0.24166666666666667
addlast,0,0,0,0,0,1,0,1,0.24166666666666667
httpresponseencoder,0,0,0,0,0,1,0,1,0.24166666666666667
new,0,0,0,0,0,1,0,1,0.24166666666666667
addlastc,0,0,0,0,0,1,0,1,0.24166666666666667
channel,0,0,0,0,0,1,0,1,0.24166666666666667
socketchannelch,0,0,0,0,0,1,0,1,0.24166666666666667
初始化函数,0,0,0,0,0,1,0,1,0.24166666666666667
缓存节点,0,0,1,1,0,1,0,3,0.4916666666666667
初始化缓存映射表信息,0,0,0,0,0,1,0,1,0.24166666666666667
relistener,0,0,0,0,0,1,0,1,0.24166666666666667
addlistener,0,0,0,0,0,1,0,1,0.24166666666666667
readablebytes,0,0,0,0,0,1,0,1,0.24166666666666667
sp,0,0,0,0,0,1,0,1,0.24166666666666667
le,0,0,0,0,0,1,0,1,0.24166666666666667
plainh,0,0,0,0,0,1,0,1,0.24166666666666667
bytes,0,0,0,0,0,1,0,1,0.24166666666666667
ue,0,0,0,0,0,1,0,1,0.24166666666666667
ture,0,0,0,0,0,1,0,1,0.24166666666666667
rpc,0,0,0,0,0,1,0,1,0.24166666666666667
er,0,0,0,0,0,1,0,1,0.24166666666666667
rappedbu,0,0,0,0,0,1,0,1,0.24166666666666667
unpooled,0,0,0,0,0,1,0,1,0.24166666666666667
fullhttpresponse,0,0,0,0,0,1,0,1,0.24166666666666667
httpresponse,0,0,0,0,0,1,0,1,0.24166666666666667
messageprocess,0,0,0,0,0,1,0,1,0.24166666666666667
消息处理函数,0,0,0,0,0,1,0,1,0.24166666666666667
上下文信息,0,0,1,3,1,1,0,6,0.9833333333333334
移动,0,0,0,0,0,1,0,1,0.24166666666666667
egisteranewser,0,0,0,0,0,1,0,1,0.24166666666666667
iogger,0,0,0,0,0,1,0,1,0.24166666666666667
putoption,0,0,0,0,0,1,0,1,0.24166666666666667
systeml,0,0,0,0,0,1,0,1,0.24166666666666667
rm,0,0,0,0,0,1,0,1,0.24166666666666667
iphelper,0,0,0,0,0,1,0,1,0.24166666666666667
root,0,0,0,0,0,1,0,1,0.24166666666666667
messageformat,0,0,0,0,0,1,0,1,0.24166666666666667
throwsexception,0,0,0,0,0,1,0,1,0.24166666666666667
service,0,0,0,0,0,1,0,1,0.24166666666666667
register函数,0,0,0,0,0,1,0,1,0.24166666666666667
移动上下文信息,0,0,0,4,1,1,0,6,0.9833333333333334
存储网络,0,0,0,1,0,1,0,2,0.3666666666666667
用户接入请,0,0,0,0,0,1,0,1,0.24166666666666667
请求,0,0,1,0,4,1,0,6,1.3333333333333333
防火墙,0,0,0,1,0,1,0,2,0.3666666666666667
dhcp服务器,0,0,0,0,0,1,0,1,0.24166666666666667
管理功能,0,0,0,0,0,1,0,1,0.24166666666666667
基本,0,0,0,0,0,1,0,1,0.24166666666666667
虚拟ap功能模块,0,0,0,0,0,1,0,1,0.24166666666666667
networkstorage,0,0,0,0,0,1,0,1,0.24166666666666667
atform,0,0,0,0,0,1,0,1,0.24166666666666667
virtualization,0,0,0,0,0,1,0,1,0.24166666666666667
密模块,0,0,0,0,0,1,0,1,0.24166666666666667
理模塊,0,0,0,0,0,1,0,1,0.24166666666666667
解析,0,0,0,0,0,1,0,1,0.24166666666666667
用户信息,0,0,0,0,4,1,0,5,1.2083333333333333
用户请求,0,0,0,0,0,1,0,1,0.24166666666666667
5vdmm,0,0,0,0,0,1,0,1,0.24166666666666667
controller,0,0,0,0,5,4,0,9,2.175
mn接入,0,0,1,0,0,1,0,2,0.3666666666666667
vap,0,0,0,0,15,2,0,17,4.108333333333333
cn接入api,0,0,0,0,0,1,0,1,0.24166666666666667
功能,0,0,0,1,0,1,0,2,0.3666666666666667
元件,0,0,0,0,0,1,0,1,0.24166666666666667
模拟网络,0,0,0,0,0,1,0,1,0.24166666666666667
docker容器,0,0,0,0,0,2,0,2,0.48333333333333334
虚线内,0,0,0,0,0,1,0,1,0.24166666666666667
模拟vdmm网络,0,0,0,0,0,1,0,1,0.24166666666666667
终端,0,0,3,0,5,1,0,9,1.825
实验平台,0,0,0,0,0,1,0,1,0.24166666666666667
拓扑,0,0,0,0,0,1,0,1,0.24166666666666667
功能模块,0,0,0,0,0,2,1,3,0.725
虚拟机,0,0,0,7,0,2,0,9,1.3583333333333334
5g架构,0,0,0,6,0,0,0,6,0.75
网络功能,0,0,0,4,0,0,0,4,0.5
业务,0,0,0,4,0,0,0,4,0.5
5g网络,0,0,0,3,0,0,0,3,0.375
nfvi,0,0,0,3,0,0,0,3,0.375
移动通信网络,0,0,0,3,0,0,0,3,0.375
it业务,0,0,0,3,0,0,0,3,0.375
虚拟网络,0,0,0,2,0,0,0,2,0.25
网络切片,0,0,0,2,0,0,0,2,0.25
nfv技术,0,0,0,3,0,0,0,3,0.375
lte网络,0,0,0,2,0,0,0,2,0.25
nfv技,0,0,0,2,0,0,0,2,0.25
物理资源,0,0,0,2,0,0,0,2,0.25
vnf,0,0,0,2,0,0,0,2,0.25
物理设备,0,0,0,2,0,0,0,2,0.25
在线迁移,0,0,0,2,0,0,0,2,0.25
主机,0,0,9,2,2,3,0,16,2.583333333333333
硬件,0,0,0,3,0,0,0,3,0.375
软件,0,0,1,3,0,0,0,4,0.5
虚拟化机制,0,0,0,2,0,0,0,2,0.25
网络服务,0,0,1,3,0,0,0,4,0.5
网络功能虚拟化,0,0,0,2,0,0,0,2,0.25
网络资源,0,0,0,2,0,0,0,2,0.25
5g网络架构,0,0,0,2,0,0,0,2,0.25
延迟,0,0,0,2,8,1,1,12,2.6666666666666665
网络环境,0,0,0,1,0,0,0,1,0.125
网络编排,0,0,0,1,0,0,0,1,0.125
网络管理,0,0,0,1,1,0,0,2,0.3666666666666667
可靠性,0,0,0,1,0,0,0,1,0.125
安全性,0,0,0,1,0,0,0,1,0.125
带宽,0,0,0,1,3,0,0,4,0.85
时延,0,0,0,1,2,0,0,3,0.6083333333333334
服务,0,0,0,2,0,0,0,2,0.25
物理网络,0,0,0,1,0,0,0,1,0.125
apio,0,0,0,1,0,0,0,1,0.125
虚拟实体,0,0,0,1,0,0,0,1,0.125
增值业务,0,0,0,1,0,0,0,1,0.125
物理资源层,0,0,0,1,0,0,0,1,0.125
分层,0,0,0,1,0,0,0,1,0.125
软件定义网络,0,0,0,4,0,0,0,4,0.5
网络平台,0,0,0,1,0,0,0,1,0.125
可编程的,0,0,0,1,0,0,0,1,0.125
可扩张,0,0,0,1,0,0,0,1,0.125
通信网络,0,0,1,1,0,0,0,2,0.25
sdn/,0,0,0,1,0,0,0,1,0.125
sdn/nfv技术,0,0,0,1,0,0,0,1,0.125
移动网络架构,0,0,1,1,0,0,0,2,0.25
切换机制,0,0,0,1,0,0,0,1,0.125
软件控制,0,0,0,1,0,0,0,1,0.125
服务器,0,0,0,1,6,0,0,7,1.575
控制,0,0,0,1,0,0,0,1,0.125
虚拟层,0,0,0,1,0,0,0,1,0.125
操控,0,0,0,1,0,0,0,1,0.125
mme,0,0,0,1,0,0,0,1,0.125
移动性管理实体,0,0,0,1,0,0,0,1,0.125
s-gw,0,0,0,1,0,0,0,1,0.125
服务网关,0,0,0,1,0,0,0,1,0.125
切换延迟,0,0,0,2,10,34,1,47,11.125
3gpp,0,0,0,1,0,0,0,1,0.125
ip移动性管理,0,0,0,2,0,0,0,2,0.25
5g,0,0,0,2,0,0,0,2,0.25
vnfs,0,0,0,1,0,0,0,1,0.125
虚拟隆,0,0,0,1,0,0,0,1,0.125
vnf生命周期,0,0,0,1,0,0,0,1,0.125
生命周期,0,0,0,1,0,0,0,1,0.125
业务流程,0,0,0,1,0,0,0,1,0.125
软件资源,0,0,0,1,0,0,0,1,0.125
物理基础设施,0,0,0,1,0,0,0,1,0.125
基拙设施,0,0,0,1,0,0,0,1,0.125
虚拟化基础设施,0,0,0,1,0,0,0,1,0.125
虚拟网络功能,0,0,0,1,0,0,0,1,0.125
nfv架构,0,0,0,1,0,0,0,1,0.125
nfv网络,0,0,0,1,0,0,0,1,0.125
网网,0,0,0,1,0,0,0,1,0.125
软件加载过程,0,0,0,1,0,0,0,1,0.125
设备更新,0,0,0,1,0,0,0,1,0.125
硬件设备网,0,0,0,1,0,0,0,1,0.125
x86通用硬件,0,0,0,1,0,0,0,1,0.125
网元设备,0,0,0,1,0,0,0,1,0.125
虚拟机迁,0,0,0,1,0,0,0,1,0.125
资源,0,0,0,4,2,1,0,7,1.225
虚拟化数据中心,0,0,0,1,0,0,0,1,0.125
物理主机,0,0,0,1,0,0,0,1,0.125
虚拟设备,0,0,0,1,0,0,0,1,0.125
网络硬件,0,0,0,1,0,0,0,1,0.125
路由器,0,0,2,7,4,0,0,13,2.091666666666667
软件定义网络技术,0,0,0,1,0,0,0,1,0.125
云计算技术,0,0,0,1,0,0,0,1,0.125
硬件技,0,0,0,1,0,0,0,1,0.125
云服务,0,0,0,1,0,0,0,1,0.125
数据中心网络,0,0,0,1,0,0,0,1,0.125
网络虚拟化技术,0,0,0,1,0,0,0,1,0.125
运营商,0,0,0,1,1,0,0,2,0.3666666666666667
网络管理架构,0,0,0,1,0,0,0,1,0.125
5g架,0,0,0,1,0,0,0,1,0.125
抖动,0,0,0,1,0,0,0,1,0.125
恢复能力,0,0,0,1,0,0,0,1,0.125
质量,0,0,0,1,0,0,0,1,0.125
智能设备,0,0,0,1,0,0,0,1,0.125
节点,0,0,27,34,21,1,1,84,13.183333333333334
锚点,0,0,11,23,12,2,2,50,8.116666666666667
smaar,0,0,6,0,13,1,0,20,4.133333333333333
集中式移动性管理,1,0,9,4,1,0,2,17,3.35
无线网络,0,0,3,0,3,0,0,6,1.1
nmaar,0,0,3,3,10,1,0,17,3.408333333333333
dmm,3,0,3,4,0,0,1,11,4.116666666666667
吞吐量,0,0,2,0,3,0,0,5,0.975
ap过载,0,0,2,0,2,0,0,4,0.7333333333333334
wlan,0,0,2,0,4,0,0,6,1.2166666666666668
数据包,0,0,2,11,29,2,0,44,9.116666666666667
cmd,0,0,2,13,11,0,0,26,4.533333333333333
三角路由,0,0,6,1,0,0,2,9,1.3583333333333334
移动节点,1,0,17,10,6,0,0,34,5.825
集中式移动锚点,0,0,4,0,0,0,0,4,0.5
单点,0,0,4,0,2,0,1,7,1.225
移动锚点,1,0,14,13,1,0,3,32,5.341666666666667
仿真模拟,0,0,1,0,0,0,0,1,0.125
负载均衡,1,1,1,0,18,0,0,21,7.475
ap,1,0,1,0,17,1,2,22,5.958333333333333
无线设备,0,0,1,0,1,0,0,2,0.3666666666666667
会议,0,0,1,0,1,0,0,2,0.3666666666666667
流量负载,0,0,1,0,2,0,0,3,0.6083333333333334
渗透率,0,0,1,0,1,0,0,2,0.3666666666666667
智能移动终端,0,0,1,0,1,0,0,2,0.3666666666666667
互联网络,0,0,1,0,1,0,0,2,0.3666666666666667
wlan网络,0,0,1,0,2,0,0,3,0.6083333333333334
资源优化,0,0,1,0,0,0,0,1,0.125
性能分,0,0,1,0,0,1,0,2,0.3666666666666667
移动终端,0,0,2,0,1,0,1,4,0.7333333333333334
转发,0,0,1,1,2,0,0,4,0.7333333333333334
会话,0,0,1,3,4,0,0,8,1.4666666666666668
通信,0,0,5,8,5,0,1,19,3.075
绑定缓存条,0,0,2,0,1,0,0,3,0.4916666666666667
实时性,1,0,1,0,0,0,0,2,1.125
位置管理实体,0,0,1,0,1,0,0,2,0.3666666666666667
信令,0,0,3,7,18,2,0,30,6.083333333333333
分布式部署,0,0,2,0,1,0,1,4,0.7333333333333334
ip网络架构,1,0,1,0,0,0,0,2,1.125
转交地址,0,0,8,0,0,0,0,8,1.0
家乡地址,0,0,5,0,4,0,0,9,1.5916666666666668
端到端通信,0,0,2,0,0,0,0,2,0.25
次优路由,0,0,2,2,0,0,0,4,0.5
注册节点,0,0,2,0,0,0,0,2,0.25
集中式,0,0,1,2,0,0,0,3,0.375
路由,0,0,6,1,0,0,0,7,0.875
移动上下文,0,0,3,0,1,0,0,4,0.6166666666666667
通信流量,0,0,2,0,0,0,0,2,0.25
传统网络,0,0,1,0,0,0,0,1,0.125
hoa,0,0,3,0,1,0,0,4,0.6166666666666667
外地链路,0,0,3,0,0,0,0,3,0.375
mipv6协议,0,0,6,0,0,0,0,6,0.75
移动ipv6协议,0,0,5,0,0,0,0,5,0.625
数据通信,0,0,3,2,19,0,0,24,5.216666666666667
coa,0,0,2,0,0,0,0,2,0.25
协议栈,0,0,3,0,1,0,0,4,0.6166666666666667
绑定信息,0,0,1,0,0,0,0,1,0.125
缓存mn,0,0,1,0,0,0,0,1,0.125
路由优化机制,0,0,1,0,0,0,0,1,0.125
通信过程,0,0,1,1,0,0,0,2,0.25
ipv6协议,0,0,1,0,0,0,0,1,0.125
ar2,0,0,1,0,0,0,0,1,0.125
对端节点,0,0,3,0,0,0,0,3,0.375
ao,0,0,1,0,0,0,0,1,0.125
家乡链路,0,0,1,0,0,0,0,1,0.125
协议,0,0,1,0,1,0,0,2,0.3666666666666667
移动性管理架构,0,0,1,3,0,0,0,4,0.5
链路,0,0,1,0,0,0,0,1,0.125
家乡代理,0,0,3,1,0,0,0,4,0.5
tf,0,0,1,1,0,0,1,3,0.4916666666666667
pmaar,0,0,0,8,0,0,0,8,1.0
cn1,0,0,0,4,0,0,0,4,0.5
节点信息,0,0,0,4,0,0,0,4,0.5
maar,0,0,0,23,8,0,0,31,4.808333333333334
信息,0,0,0,4,2,0,0,6,0.9833333333333334
数据层,0,0,0,6,0,0,0,6,0.75
控制层,0,0,0,7,0,0,0,7,0.875
信令开销,0,0,0,1,9,7,2,19,4.475
路由前缀,0,0,0,1,0,0,0,1,0.125
广播,0,0,0,1,0,0,0,1,0.125
nma,0,0,0,1,1,0,0,2,0.3666666666666667
traffic,0,0,0,4,0,0,0,4,0.5
cn2,0,0,0,1,0,0,0,1,0.125
nmaaro节点,0,0,0,1,0,0,0,1,0.125
aa,0,0,0,1,0,0,0,1,0.125
ic,0,0,0,1,0,0,0,1,0.125
ra,0,0,0,1,2,0,0,3,0.6083333333333334
新节点,0,0,0,1,0,0,0,1,0.125
位置信息,0,0,1,2,2,0,0,5,0.8583333333333334
onmaar,0,0,0,1,0,0,0,1,0.125
n2,0,0,0,1,0,0,0,1,0.125
实线traffic,0,0,0,1,0,0,0,1,0.125
数据流,0,0,0,4,1,0,0,5,0.7416666666666667
实线,0,0,0,2,0,0,0,2,0.25
信令流,0,0,1,2,1,0,0,4,0.6166666666666667
虚线,0,0,0,2,0,0,0,2,0.25
控制实体,0,0,0,1,0,0,0,1,0.125
移动性,0,0,4,2,4,0,2,12,2.2
路由优化,0,0,0,1,0,0,0,1,0.125
信令过载,0,0,0,1,0,0,0,1,0.125
实体,0,0,2,1,0,0,0,3,0.375
自适应负载均衡alb算法,0,0,0,0,1,1,0,2,0.48333333333333334
流量分配,0,0,0,0,0,1,0,1,0.24166666666666667
切换,0,0,0,1,11,1,0,13,3.025
隧道开销,0,0,1,0,1,1,1,4,0.85
切换时延长,0,0,0,0,2,1,0,3,0.725
rssi,0,0,0,0,14,0,0,14,3.3833333333333333
负载均衡算法,0,0,0,0,11,0,0,11,2.658333333333333
信号,1,0,0,0,8,0,0,9,2.9333333333333336
rssi值,0,0,0,0,4,0,0,4,0.9666666666666667
用户体验,0,0,0,0,4,0,1,5,1.2083333333333333
无线用户,0,0,0,0,3,0,0,3,0.725
集中视角,0,0,0,0,1,0,0,1,0.24166666666666667
负载度量,0,0,0,0,1,0,0,1,0.24166666666666667
负载状况,0,0,0,0,1,0,0,1,0.24166666666666667
负载不均衡,0,0,0,0,7,0,0,7,1.6916666666666667
16vdmm,0,0,0,0,1,0,0,1,0.24166666666666667
mn3,0,0,0,0,95,0,0,95,22.958333333333332
负载不,0,0,0,0,1,0,0,1,0.24166666666666667
api,0,0,0,1,8,0,0,9,2.0583333333333336
mn3o,0,0,0,0,1,0,0,1,0.24166666666666667
mn1,0,0,0,0,3,0,0,3,0.725
负载状,0,0,0,0,1,0,0,1,0.24166666666666667
负载状态,0,0,0,0,2,0,0,2,0.48333333333333334
强度,0,0,0,0,2,0,0,2,0.48333333333333334
低负载ap,0,0,0,0,1,0,0,1,0.24166666666666667
高负载ap,0,0,0,0,1,0,0,1,0.24166666666666667
算法思想,0,0,0,0,1,0,0,1,0.24166666666666667
控制包,0,0,0,1,5,1,0,7,1.575
有线链路,0,0,0,0,5,0,0,5,1.2083333333333333
距离,0,0,0,0,4,0,0,4,0.9666666666666667
会话恢复时间,0,0,0,0,4,0,0,4,0.9666666666666667
数据包缓存机制,0,0,0,0,4,1,0,5,1.2083333333333333
时间间隔,0,0,0,0,5,0,0,5,1.2083333333333333
时刻,0,0,0,0,4,0,0,4,0.9666666666666667
无线链路,0,0,0,0,4,16,0,20,4.833333333333333
vapmoverequest,0,0,0,0,5,0,0,5,1.2083333333333333
ar,0,0,0,4,3,0,0,7,1.225
传输延迟,0,0,0,0,3,0,0,3,0.725
符号,0,0,0,0,3,0,0,3,0.725
传输,0,0,0,0,3,0,0,3,0.725
pbu/pba信令,0,0,0,0,2,0,0,2,0.48333333333333334
mn5,0,0,0,0,10,0,0,10,2.4166666666666665
丢包,0,0,0,0,2,0,0,2,0.48333333333333334
缓存,0,0,1,0,3,0,0,4,0.85
迁移,0,0,0,0,3,1,0,4,0.9666666666666667
vapduplication,0,0,0,0,3,0,0,3,0.725
ietf,0,0,0,0,3,16,0,19,4.591666666666667
物理ap,0,0,0,0,36,0,2,38,9.183333333333334
切换过程,0,0,0,0,6,1,0,7,1.6916666666666667
数据传输率,0,0,0,0,2,0,0,2,0.48333333333333334
会话恢复间隔,0,0,0,0,2,0,0,2,0.48333333333333334
packetloss,0,0,0,0,2,0,0,2,0.48333333333333334
时间延迟,0,0,0,0,2,0,0,2,0.48333333333333334
hl,0,0,0,0,2,0,0,2,0.48333333333333334
确认消息,0,0,2,1,5,0,0,8,1.5833333333333333
切换流程,0,0,0,0,3,0,0,3,0.725
传播延迟,0,0,0,0,2,0,0,2,0.48333333333333334
延迟表达式,0,0,0,0,2,0,0,2,0.48333333333333334
切换延迟模型,0,0,0,0,3,0,0,3,0.725
da,0,0,0,0,1,0,0,1,0.24166666666666667
vapmovecon,0,0,0,0,2,0,0,2,0.48333333333333334
pbu/pba消息,0,0,0,2,2,0,0,4,0.7333333333333334
位置,0,0,0,0,1,0,0,1,0.24166666666666667
信令发送,0,0,0,0,1,0,0,1,0.24166666666666667
信令消息,0,0,0,2,1,0,0,3,0.4916666666666667
路由器跳数,0,0,0,0,1,0,0,1,0.24166666666666667
移动性管理信令,0,0,1,0,1,0,0,2,0.3666666666666667
数据包缓存机,0,0,0,0,1,1,0,2,0.48333333333333334
重传数据包,0,0,0,0,1,0,0,1,0.24166666666666667
tcp重传机制,0,0,0,0,1,0,0,1,0.24166666666666667
确认帧,0,0,0,0,1,0,0,1,0.24166666666666667
指令,0,0,0,0,1,0,0,1,0.24166666666666667
api缓存,0,0,0,0,1,0,0,1,0.24166666666666667
数据包缓存,0,0,0,0,1,0,0,1,0.24166666666666667
无线链路传输延迟,0,0,0,0,1,1,0,2,0.48333333333333334
无线链路带宽,0,0,0,0,1,1,0,2,0.48333333333333334
mn-ap,0,0,0,0,1,0,0,1,0.24166666666666667
处理时间,0,0,0,0,1,1,0,2,0.48333333333333334
处理消息,0,0,0,0,3,0,0,3,0.725
连接过程,0,0,0,0,2,0,0,2,0.48333333333333334
rs消息,0,0,0,3,4,0,0,7,1.3416666666666668
接入请求消息,0,0,0,0,2,0,0,2,0.48333333333333334
注册,0,0,1,0,1,0,0,2,0.3666666666666667
常量,0,0,0,0,1,0,0,1,0.24166666666666667
用户身份验证,0,0,0,0,1,0,0,1,0.24166666666666667
注册过程,0,0,0,0,1,0,0,1,0.24166666666666667
mm,0,0,0,0,5,0,0,5,1.2083333333333333
rt,0,0,0,0,1,0,0,1,0.24166666666666667
rpvdmbd,0,0,0,0,1,0,0,1,0.24166666666666667
14,0,0,0,0,1,0,0,1,0.24166666666666667
vaprelease,0,0,0,0,2,0,0,2,0.48333333333333334
confirm0控制器,0,0,0,0,1,0,0,1,0.24166666666666667
vapmove,0,0,0,0,1,0,0,1,0.24166666666666667
ap2-ip,0,0,0,0,4,0,0,4,0.9666666666666667
oap2,0,0,0,0,1,0,0,1,0.24166666666666667
操作信道,0,0,0,0,3,0,0,3,0.725
bssid,0,0,0,0,3,0,0,3,0.725
vapduplication消息,0,0,0,0,2,0,0,2,0.48333333333333334
ip,0,0,0,1,7,0,0,8,1.8166666666666667
ap信息,0,0,0,0,2,0,0,2,0.48333333333333334
时间轴,0,0,0,0,1,0,0,1,0.24166666666666667
准备阶段,0,0,0,0,1,0,0,1,0.24166666666666667
切换预测,0,0,0,0,1,0,0,1,0.24166666666666667
虚拟apo,0,0,0,0,1,0,0,1,0.24166666666666667
pl,0,0,0,0,1,0,0,1,0.24166666666666667
切换性能,0,0,0,0,2,0,0,2,0.48333333333333334
临迅,0,0,0,0,1,0,0,1,0.24166666666666667
有线链路带宽,0,0,0,0,1,1,0,2,0.48333333333333334
wmaar,0,0,0,0,1,0,0,1,0.24166666666666667
mymd,0,0,0,0,1,0,0,1,0.24166666666666667
移动性管理协议信令,0,0,0,0,1,0,0,1,0.24166666666666667
路径,0,0,0,0,1,0,0,1,0.24166666666666667
接入ap,0,0,0,0,2,0,0,2,0.48333333333333334
会话流,0,0,0,0,1,0,0,1,0.24166666666666667
通信延迟,0,0,0,0,1,0,0,1,0.24166666666666667
集中锚点,1,0,0,0,1,0,0,2,1.2416666666666667
接入层,0,0,0,0,1,0,0,1,0.24166666666666667
数据流量,0,0,1,0,1,0,0,2,0.3666666666666667
分布式移动性管理架构,0,0,0,2,1,0,0,3,0.4916666666666667
核心网,0,0,0,1,1,0,0,2,0.3666666666666667
r子网半径,0,0,0,0,1,0,0,1,0.24166666666666667
pf无线链路,0,0,0,0,1,0,0,1,0.24166666666666667
i有线链路,0,0,0,0,1,0,0,1,0.24166666666666667
bw有线链路带宽,0,0,0,0,1,0,0,1,0.24166666666666667
bww无线链路带宽,0,0,0,0,1,0,0,1,0.24166666666666667
ld数据包,0,0,0,0,1,0,0,1,0.24166666666666667
auth身份认证,0,0,0,0,1,0,0,1,0.24166666666666667
切换延退,0,0,0,0,1,1,0,2,0.48333333333333334
发送,0,0,0,0,1,0,0,1,0.24166666666666667
无线,0,0,0,0,1,0,0,1,0.24166666666666667
无线链路传输,0,0,0,0,1,0,0,1,0.24166666666666667
数据包传输,0,0,0,0,1,0,0,1,0.24166666666666667
平均跳数,0,0,0,0,1,4,0,5,1.2083333333333333
时间,0,0,0,0,1,0,0,1,0.24166666666666667
有线线路,0,0,0,0,1,0,0,1,0.24166666666666667
无线线路,0,0,0,0,1,0,0,1,0.24166666666666667
延时,0,0,0,0,1,0,0,1,0.24166666666666667
ietf-dmm,0,0,0,0,1,0,0,1,0.24166666666666667
lma,0,0,17,8,0,0,0,25,3.125
n-mag,0,0,9,0,0,0,0,9,1.125
p-mag,0,0,7,0,0,0,0,7,0.875
mag1,0,0,7,0,0,0,0,7,0.875
pmipv6协议,0,0,4,1,0,0,0,5,0.625
家乡网络,0,0,3,0,0,0,0,3,0.375
绑定缓存,0,0,3,0,0,0,0,3,0.375
呼叫流程,0,0,2,0,0,0,0,2,0.25
移动接入网关,0,0,2,1,0,0,0,3,0.375
映射信息,0,0,2,0,0,0,0,2,0.25
pbu消息,0,0,2,1,1,0,0,4,0.6166666666666667
接入链路,0,0,2,1,0,0,0,3,0.375
接入请求,0,0,2,0,0,0,0,2,0.25
mag,0,0,2,7,0,0,0,9,1.125
ip移动性,0,0,2,2,0,0,0,4,0.5
关信令,0,0,2,0,0,0,0,2,0.25
-mag,0,0,1,0,0,0,0,1,0.125
ma,0,0,1,0,0,0,0,1,0.125
接入接口,0,0,1,0,0,0,0,1,0.125
路由确认消息,0,0,1,0,0,0,0,1,0.125
绑定路由状态,0,0,1,0,0,0,0,1,0.125
信息次序,0,0,1,0,0,0,0,1,0.125
节点切换流程,0,0,1,0,0,0,0,1,0.125
ipv6网络,0,0,1,0,0,0,0,1,0.125
pm,0,0,1,0,0,0,0,1,0.125
p-magop-mag,0,0,1,0,0,0,0,1,0.125
mn接,0,0,1,0,0,0,0,1,0.125
地址配置协议,0,0,1,0,0,0,0,1,0.125
公告节点,0,0,1,0,0,0,0,1,0.125
代理绑定,0,0,1,0,0,0,0,1,0.125
绑定缓存条目,0,0,1,1,0,0,0,2,0.25
确认,0,0,1,0,0,0,0,1,0.125
mn身份验证,0,0,1,0,0,0,0,1,0.125
magi,0,0,1,0,0,0,0,1,0.125
初始接入网络,0,0,1,0,0,0,0,1,0.125
接入流程,0,0,1,0,0,0,0,1,0.125
移动性相关信令,0,0,1,1,0,0,0,2,0.25
身份验证,0,0,1,0,6,0,0,7,1.575
直接接入锚点,0,0,1,0,0,0,0,1,0.125
维护,0,0,1,0,0,0,0,1,0.125
mag°lma,0,0,1,0,0,0,0,1,0.125
代理,0,0,1,0,0,0,0,1,0.125
代理移动ipv6协议,0,0,2,0,0,0,0,2,0.25
检测机制,0,0,0,0,1,0,0,1,0.24166666666666667
流量优化,0,0,0,0,1,0,0,1,0.24166666666666667
数据通信过程,0,0,0,0,2,0,0,2,0.48333333333333334
时延长,0,0,0,0,1,0,0,1,0.24166666666666667
移动性支持,0,0,2,0,0,0,0,2,0.25
移动性管理技术,0,0,2,1,0,0,0,3,0.375
互联网,1,0,2,0,0,0,2,5,1.7333333333333334
流量,0,0,2,0,0,0,0,2,0.25
传统网络架构,0,0,1,0,0,0,0,1,0.125
sdn/nfv,0,0,1,0,0,0,0,1,0.125
网络功能虚拟化技术,0,0,1,0,0,0,0,1,0.125
网络技术,0,0,1,0,0,0,0,1,0.125
接入网络,0,0,1,1,1,0,0,3,0.4916666666666667
移动锚点分布,0,0,1,0,0,0,0,1,0.125
分布式移动管理架构,0,0,1,0,0,0,0,1,0.125
网络协会,0,0,1,0,0,0,0,1,0.125
通信和,0,0,1,0,0,0,0,1,0.125
分布式移动管理,0,0,1,0,0,0,0,1,0.125
扁平化移动网络架构,0,0,1,0,0,0,0,1,0.125
移动网络,0,0,1,2,0,0,0,3,0.375
互联网通信流量,0,0,1,0,0,0,0,1,0.125
语音通信,0,0,1,0,0,0,0,1,0.125
语音通话,0,0,1,0,0,0,0,1,0.125
上下文,0,0,1,0,0,0,0,1,0.125
集中式移动性管理协议,0,0,1,0,0,0,0,1,0.125
接入节点,0,0,1,0,0,0,0,1,0.125
本地移动锚点,0,0,1,0,0,0,0,1,0.125
ip移动性协议,0,0,1,0,0,0,0,1,0.125
pc端,0,0,1,0,0,0,0,1,0.125
台式机,0,0,1,0,0,0,0,1,0.125
移动流量,0,0,1,0,0,0,0,1,0.125
平板电脑,0,0,1,0,0,0,0,1,0.125
智能手机,0,0,1,0,0,0,0,1,0.125
智能终端,0,0,1,0,0,0,0,1,0.125
移动互联网技术,0,0,1,0,0,0,0,1,0.125
子网半径,0,0,0,0,0,19,0,19,4.591666666666667
失败率,0,0,0,0,0,14,0,14,3.3833333333333333
参数,0,0,0,0,1,7,1,9,2.175
网元,0,0,0,0,0,4,0,4,0.9666666666666667
绿色曲线,0,0,0,0,0,4,0,4,0.9666666666666667
粉色曲线,0,0,0,0,0,4,0,4,0.9666666666666667
纵坐标,0,0,0,0,0,4,0,4,0.9666666666666667
横坐标,0,0,0,0,0,4,0,4,0.9666666666666667
try,0,0,0,0,0,3,0,3,0.725
互通性,0,0,0,0,0,3,0,3,0.725
ra信令,0,0,0,0,0,2,0,2,0.48333333333333334
信令交换,0,0,0,0,0,2,0,2,0.48333333333333334
参考数,0,0,0,0,0,2,0,2,0.48333333333333334
mn端,0,0,0,0,0,2,0,2,0.48333333333333334
视频流,0,0,0,0,0,2,0,2,0.48333333333333334
docker镜像,0,0,0,0,0,2,0,2,0.48333333333333334
网络元件,0,0,0,0,0,2,0,2,0.48333333333333334
vapl,0,0,0,0,0,2,0,2,0.48333333333333334
ler,0,0,0,0,0,1,0,1,0.24166666666666667
cletf,0,0,0,0,0,1,0,1,0.24166666666666667
功能实体,0,0,0,0,0,1,0,1,0.24166666666666667
信令开,0,0,0,0,0,2,0,2,0.48333333333333334
apo,0,0,0,0,0,1,0,1,0.24166666666666667
ap缓存,0,0,0,0,0,1,0,1,0.24166666666666667
波动幅度,0,0,0,0,0,1,0,1,0.24166666666666667
幅度,0,0,0,0,0,1,0,1,0.24166666666666667
wirelesslink,0,0,0,0,0,1,0,1,0.24166666666666667
丟包率,0,0,0,0,0,1,0,1,0.24166666666666667
切换延迟波动幅度,0,0,0,0,0,1,0,1,0.24166666666666667
信令传输时间,0,0,0,0,0,1,0,1,0.24166666666666667
radusofcells,0,0,0,0,0,1,0,1,0.24166666666666667
有线链路传输延迟,0,0,0,0,0,1,0,1,0.24166666666666667
bww,0,0,0,0,0,1,0,1,0.24166666666666667
bw,0,0,0,0,0,1,0,1,0.24166666666666667
身份认证延迟,0,0,0,0,0,1,0,1,0.24166666666666667
二层切换延迟,0,0,0,0,0,1,0,1,0.24166666666666667
tl2,0,0,0,0,0,1,0,1,0.24166666666666667
默认参数,0,0,0,0,0,1,0,1,0.24166666666666667
定量,0,0,0,0,0,1,0,1,0.24166666666666667
仿真验,0,0,0,0,0,1,0,1,0.24166666666666667
信令交互流程,0,0,0,0,0,1,0,1,0.24166666666666667
tcpcontroller,0,0,0,0,0,1,0,1,0.24166666666666667
up8ninute,0,0,0,0,0,1,0,1,0.24166666666666667
apl,0,0,0,0,1,1,0,2,0.48333333333333334
up4minutes,0,0,0,0,0,1,0,1,0.24166666666666667
up4ninute,0,0,0,0,0,1,0,1,0.24166666666666667
con,0,0,0,0,0,1,0,1,0.24166666666666667
up27,0,0,0,0,0,1,0,1,0.24166666666666667
ports,0,0,0,0,0,1,0,1,0.24166666666666667
containeridimage,0,0,0,0,0,1,0,1,0.24166666666666667
曇涉樓,0,0,0,0,0,1,0,1,0.24166666666666667
mn克隆,0,0,0,0,0,1,0,1,0.24166666666666667
视频,0,0,0,0,0,1,0,1,0.24166666666666667
vlc视频,0,0,0,0,0,1,0,1,0.24166666666666667
客户端,0,0,0,0,0,1,0,1,0.24166666666666667
vlc服务端,0,0,0,0,0,1,0,1,0.24166666666666667
cn端,0,0,0,0,0,1,0,1,0.24166666666666667
vlc视频流,0,0,0,0,0,1,0,1,0.24166666666666667
初始化,0,0,0,0,0,1,0,1,0.24166666666666667
容器,0,0,0,0,0,9,0,9,2.175
初始化网络元件,0,0,0,0,0,1,0,1,0.24166666666666667
cn接入网络,0,0,0,0,0,1,0,1,0.24166666666666667
模拟网络元件,0,0,0,0,0,1,0,1,0.24166666666666667
docker平台,0,0,0,0,0,4,0,4,0.9666666666666667
cellbreathing,0,0,0,0,3,0,0,3,0.725
接入机制,0,0,0,0,3,0,0,3,0.725
ewlan,0,0,0,0,2,0,0,2,0.48333333333333334
ewlan网络,0,0,0,0,2,0,0,2,0.48333333333333334
接入控制,0,0,0,0,2,0,0,2,0.48333333333333334
用户数,0,0,0,0,2,0,0,2,0.48333333333333334
ap接入,0,0,0,0,2,0,0,2,0.48333333333333334
仿真验证,0,0,0,0,1,0,0,1,0.24166666666666667
信道负载,0,0,0,0,1,0,0,1,0.24166666666666667
可编程性,0,0,0,0,1,0,0,1,0.24166666666666667
编程接口,0,0,0,0,1,0,0,1,0.24166666666666667
无线信道,0,0,0,0,1,0,0,1,0.24166666666666667
用户吞吐量,0,0,0,0,1,0,0,1,0.24166666666666667
用户带宽,0,0,0,0,1,0,0,1,0.24166666666666667
仿真实验,0,0,0,0,1,0,0,1,0.24166666666666667
strongpower,0,0,0,0,1,0,0,1,0.24166666666666667
weakpower,0,0,0,0,1,0,0,1,0.24166666666666667
beaconpowero,0,0,0,0,1,0,0,1,0.24166666666666667
用户连接状态,0,0,0,0,1,0,0,1,0.24166666666666667
时间监测机制,0,0,0,0,1,0,0,1,0.24166666666666667
beaconpower,0,0,0,0,1,0,0,1,0.24166666666666667
cdma蜂窝网络,0,0,0,0,1,0,0,1,0.24166666666666667
小区呼吸,0,0,0,0,1,0,0,1,0.24166666666666667
leastloadfirst,0,0,0,0,1,0,0,1,0.24166666666666667
strongestsignalfirst,0,0,0,0,1,0,0,1,0.24166666666666667
ssf,0,0,0,0,1,0,0,1,0.24166666666666667
接入控制协议,0,0,0,0,1,0,0,1,0.24166666666666667
网络架构网,0,0,0,0,1,0,0,1,0.24166666666666667
控制协议,0,0,0,0,1,0,0,1,0.24166666666666667
无线架构,0,0,0,0,1,0,0,1,0.24166666666666667
无缝切换,0,0,0,0,1,0,1,2,0.48333333333333334
交换机,0,0,0,5,0,0,0,5,0.625
sdn控制器,0,0,0,5,0,0,0,5,0.625
sdn架构,0,0,0,5,0,0,0,5,0.625
流表,0,0,0,5,0,0,0,5,0.625
dmm协议,0,0,0,4,0,0,0,4,0.5
openflow交换机,0,0,0,3,0,0,0,3,0.375
南向接口,0,0,0,3,0,0,0,3,0.375
北向接口,0,0,0,3,0,0,0,3,0.375
openflow协议,0,0,0,2,0,0,0,2,0.25
网络设备,0,0,0,2,0,0,0,2,0.25
sdn技术,0,0,0,1,0,0,0,1,0.125
信令消耗,0,0,0,2,0,0,0,2,0.25
路由优,0,0,0,1,0,0,0,1,0.125
网络层转发数据,0,0,0,1,0,0,0,1,0.125
电信,0,0,0,1,0,0,0,1,0.125
数据包转发,0,0,0,1,0,0,0,1,0.125
openflow协议网,0,0,0,1,0,0,0,1,0.125
转发设备,0,0,0,1,0,0,0,1,0.125
南向应用程序接口,0,0,0,1,0,0,0,1,0.125
体系,0,0,0,1,0,0,0,1,0.125
控制数据流,0,0,0,1,0,0,0,1,0.125
发流表,0,0,0,1,0,0,0,1,0.125
缓存条,0,0,0,1,0,0,0,1,0.125
maar2,0,0,0,5,0,0,0,5,0.625
maar1,0,0,0,8,0,0,0,8,1.0
mn接入网络,0,0,0,2,0,0,0,2,0.25
初始接入锚点,0,0,0,1,0,0,0,1,0.125
资源状态,0,0,0,1,0,0,0,1,0.125
授权应用,0,0,0,1,0,0,0,1,0.125
应用,0,0,0,1,0,0,0,1,0.125
接口,0,0,0,1,0,0,0,1,0.125
网络设备供应商,0,0,0,1,0,0,0,1,0.125
onf,0,0,0,1,0,0,0,1,0.125
openflow,0,0,0,1,0,0,0,1,0.125
络控制层实体,0,0,0,1,0,0,0,1,0.125
基础架构元件,0,0,0,1,0,0,0,1,0.125
专有设备,0,0,0,1,0,0,0,1,0.125
服务升级,0,0,0,1,0,0,0,1,0.125
设备维护,0,0,0,1,0,0,0,1,0.125
网络运营商,0,0,0,1,0,0,0,1,0.125
路由协议,0,0,0,1,1,0,0,2,0.3666666666666667
转发硬件,0,0,0,1,0,0,0,1,0.125
逻辑控制器,0,0,0,1,0,0,0,1,0.125
网络协议,0,0,0,1,0,0,0,1,0.125
集中控制,0,0,0,1,0,0,0,1,0.125
可编程网络设备,0,0,0,1,0,0,0,1,0.125
物理站点,0,0,0,1,0,0,0,1,0.125
接入网,0,0,0,1,1,0,0,2,0.3666666666666667
单点失败,0,0,0,1,0,0,1,2,0.3666666666666667
可扩展性差,0,0,0,1,0,0,0,1,0.125
动态移动性支持,0,0,0,1,0,0,0,1,0.125
移动性数据,0,0,0,1,0,0,0,1,0.125
本地,0,0,0,1,0,0,0,1,0.125
代理移动ipv6,0,0,0,1,0,0,0,1,0.125
处理压力,0,0,0,1,0,0,0,1,0.125
位置管理,0,0,0,1,0,0,0,1,0.125
移动ipv6网络,0,0,0,1,0,0,0,1,0.125
移动性环境,0,0,0,1,0,0,0,1,0.125
移动数据,0,0,0,1,0,0,0,1,0.125
可扩展性,0,0,0,1,0,0,0,1,0.125
数据量,0,0,0,1,0,0,0,1,0.125
移动通信,0,0,0,1,0,0,0,1,0.125
sdn移动性管理,0,0,0,1,0,0,0,1,0.125
映射,0,0,0,0,4,0,0,4,0.9666666666666667
vapo,0,0,0,0,1,0,0,1,0.24166666666666667
无线访问接入点,0,0,0,0,1,0,0,1,0.24166666666666667
映射关系,0,0,0,0,1,0,0,1,0.24166666666666667
mn4,0,0,0,0,2,0,0,2,0.48333333333333334
1vdmm,0,0,0,0,1,0,0,1,0.24166666666666667
前缀,0,0,0,5,0,0,0,5,0.625
地址池,0,0,0,3,0,0,0,3,0.375
接入点,0,0,0,2,0,0,0,2,0.25
ipv6地址,0,0,0,1,0,0,0,1,0.125
ra消息,0,0,0,1,0,0,0,1,0.125
ipv6前缀,0,0,0,1,0,0,0,1,0.125
动态控制,0,0,0,1,0,0,0,1,0.125
分布式移动性管理方案,0,0,0,1,1,0,0,2,0.3666666666666667
maarl,0,0,0,1,0,0,0,1,0.125
mn切换,0,0,0,1,0,0,0,1,0.125
prefixl,0,0,0,1,0,0,0,1,0.125
通信会话,0,0,0,1,0,0,0,1,0.125
数据库表,0,0,0,1,0,0,0,1,0.125
网络地址,0,0,0,1,0,0,0,1,0.125
接入过程,0,0,0,1,2,0,0,3,0.6083333333333334
maaar1,0,0,0,1,0,0,0,1,0.125
初始接入,0,0,0,1,0,0,0,1,0.125
注册信息,0,0,0,1,0,0,0,1,0.125
接入信息,0,0,0,1,1,0,0,2,0.3666666666666667
pba,0,0,0,1,0,0,0,1,0.125
pbu/,0,0,0,1,0,0,0,1,0.125
移动切换流程,0,0,0,1,0,0,0,1,0.125
节点接入网络,0,0,0,1,0,0,0,1,0.125
cmdomn,0,0,0,1,0,0,0,1,0.125
集中管理数据库,0,0,0,1,0,0,0,1,0.125
maaro,0,0,0,1,0,0,0,1,0.125
移动锚定,0,0,0,1,0,0,0,1,0.125
接入路由器,0,0,0,1,0,0,0,1,0.125
状态,0,0,0,1,0,0,0,1,0.125
pba消息,0,0,0,1,0,0,0,1,0.125
pbu,0,0,0,1,1,0,0,2,0.3666666666666667
下行数据,0,0,0,1,0,0,0,1,0.125
上行数据,0,0,0,1,0,0,0,1,0.125
信令交互,0,0,0,1,0,0,0,1,0.125
数据库,0,0,0,1,0,0,0,1,0.125
分布式管理,0,0,0,1,0,0,0,1,0.125
集中式管理,0,0,0,1,1,0,0,2,0.3666666666666667
分布式移动性,0,0,0,1,0,0,0,1,0.125
移动性工,0,0,0,1,0,0,0,1,0.125
ip会话,0,0,0,1,0,0,0,1,0.125
通?信,0,0,0,1,0,0,0,1,0.125
通信量,0,0,0,1,0,0,0,1,0.125
运营商网络,0,0,0,1,0,0,0,1,0.125
动态路由,0,0,0,1,0,0,0,1,0.125
分布式移动性管理协议,0,0,0,1,0,0,0,1,0.125
数学分析,0,0,0,0,0,1,1,2,0.48333333333333334
vdmm方,0,0,0,0,0,0,1,1,0.24166666666666667
锚点接入,0,0,0,0,0,0,1,1,0.24166666666666667
pmip,0,0,0,0,0,0,1,1,0.24166666666666667
mip,0,0,0,0,0,0,1,1,0.24166666666666667
网络性能,1,0,0,0,0,0,1,2,1.2416666666666667
中心管理模块,0,0,0,0,5,0,0,5,1.2083333333333333
负载值,0,0,0,0,5,0,0,5,1.2083333333333333
nap,0,0,0,0,4,0,0,4,0.9666666666666667
alb算法,0,0,0,0,3,0,0,3,0.725
切换指令,0,0,0,0,2,0,0,2,0.48333333333333334
mnj,0,0,0,0,2,0,0,2,0.48333333333333334
apfmm,0,0,0,0,2,0,0,2,0.48333333333333334
关联用户,0,0,0,0,2,0,0,2,0.48333333333333334
物理ap地址,0,0,0,0,2,0,0,2,0.48333333333333334
虚拟ap标识,0,0,0,0,2,0,0,2,0.48333333333333334
中心信息管理模块,0,0,0,0,2,0,0,2,0.48333333333333334
forward,0,0,0,0,2,0,0,2,0.48333333333333334
典妈,0,0,0,0,1,0,0,1,0.24166666666666667
tiene,0,0,0,0,1,0,0,1,0.24166666666666667
oi,0,0,0,0,1,0,0,1,0.24166666666666667
邮戒,0,0,0,0,1,0,0,1,0.24166666666666667
执行代码,0,0,0,0,1,0,0,1,0.24166666666666667
切换过,0,0,0,0,1,0,0,1,0.24166666666666667
pf,0,0,0,0,1,0,0,1,0.24166666666666667
npnapj,0,0,0,0,1,0,0,1,0.24166666666666667
qoe,0,0,0,0,1,0,0,1,0.24166666666666667
阈值,0,0,0,0,1,0,0,1,0.24166666666666667
心湖,0,0,0,0,1,0,0,1,0.24166666666666667
丑心湖,0,0,0,0,1,0,0,1,0.24166666666666667
rssi阈值,0,0,0,0,1,0,0,1,0.24166666666666667
将跡,0,0,0,0,1,0,0,1,0.24166666666666667
oa,0,0,0,0,1,0,0,1,0.24166666666666667
虚拟ap负载,0,0,0,0,1,0,0,1,0.24166666666666667
泊乌,0,0,0,0,1,0,0,1,0.24166666666666667
apfr6m,0,0,0,0,1,0,0,1,0.24166666666666667
loadm,0,0,0,0,1,0,0,1,0.24166666666666667
sfg,0,0,0,0,1,0,0,1,0.24166666666666667
vap标识,0,0,0,0,2,0,0,2,0.48333333333333334
负载不均衡条件,0,0,0,0,1,0,0,1,0.24166666666666667
更新映射表,0,0,0,0,1,0,0,1,0.24166666666666667
虚拟,0,0,0,0,2,0,0,2,0.48333333333333334
负载信息,0,0,0,0,1,0,0,1,0.24166666666666667
forward-vap-load协议,0,0,0,0,1,0,0,1,0.24166666666666667
物理ap负载,0,0,0,0,1,0,0,1,0.24166666666666667
forward-vap-load信令,0,0,0,0,1,0,0,1,0.24166666666666667
ad,0,0,0,0,1,0,0,1,0.24166666666666667
vap-,0,0,0,0,1,0,0,1,0.24166666666666667
tailroom,0,0,0,0,1,0,0,1,0.24166666666666667
loadvalue,0,0,0,0,1,0,0,1,0.24166666666666667
messagedats,0,0,0,0,1,0,0,1,0.24166666666666667
headroommessageheader,0,0,0,0,1,0,0,1,0.24166666666666667
字符串,0,0,0,0,1,0,0,1,0.24166666666666667
信令头,0,0,0,0,1,0,0,1,0.24166666666666667
协议信令,0,0,0,0,1,0,0,1,0.24166666666666667
vap-load,0,0,0,0,1,0,0,1,0.24166666666666667
控制番,0,0,0,0,1,0,0,1,0.24166666666666667
接入消息,0,0,0,0,1,0,0,1,0.24166666666666667
终端功能,0,0,0,0,1,0,0,1,0.24166666666666667
集中式移动性管理方案,0,0,0,0,1,0,0,1,0.24166666666666667
信令负载,0,0,0,0,1,0,0,1,0.24166666666666667
广播消息,0,0,0,0,2,0,0,2,0.48333333333333334
上下文消息,0,0,0,0,1,0,0,1,0.24166666666666667
mn3-ip,0,0,0,0,8,0,0,8,1.9333333333333333
dd-vap,0,0,0,0,6,0,0,6,1.45
mn3-vap,0,0,0,0,5,0,0,5,1.2083333333333333
ps-vap,0,0,0,0,5,0,0,5,1.2083333333333333
mn6,0,0,0,0,4,0,0,4,0.9666666666666667
虚拟mn3-vap,0,0,0,0,4,0,0,4,0.9666666666666667
ssid,0,0,0,0,4,0,0,4,0.9666666666666667
公共静态虚拟ap,0,0,0,0,4,0,0,4,0.9666666666666667
移动切换过程,0,0,0,0,3,0,0,3,0.725
服务设备,0,0,0,0,3,0,0,3,0.725
配置文件,0,0,0,0,3,0,0,3,0.725
通信流程,0,0,0,0,2,0,0,2,0.48333333333333334
缓存映射,0,0,0,0,2,0,0,2,0.48333333333333334
查询消息,0,0,0,0,2,0,0,2,0.48333333333333334
本地缓存映射,0,0,0,0,2,0,0,2,0.48333333333333334
数据传输过程,0,0,0,0,2,0,0,2,0.48333333333333334
移动切换,0,0,0,0,2,0,0,2,0.48333333333333334
mn2,0,0,0,0,2,0,0,2,0.48333333333333334
ap1-ip,0,0,0,0,2,0,0,2,0.48333333333333334
配置信息,0,0,0,0,2,0,0,2,0.48333333333333334
probereply,0,0,0,0,2,0,0,2,0.48333333333333334
响应,0,0,0,0,2,0,0,2,0.48333333333333334
用户资料,0,0,0,0,2,0,0,2,0.48333333333333334
请求消息,0,0,0,0,2,0,0,2,0.48333333333333334
注册用户,0,0,0,0,2,0,0,2,0.48333333333333334
物理,0,0,0,0,2,0,0,2,0.48333333333333334
集中处理器,0,0,0,0,2,0,0,2,0.48333333333333334
动态路由协议,0,0,0,0,2,0,0,2,0.48333333333333334
路由表,0,0,0,0,2,0,0,2,0.48333333333333334
注册过,0,0,0,0,1,0,0,1,0.24166666666666667
rs接入请,0,0,0,0,1,0,0,1,0.24166666666666667
前数据通信流程,0,0,0,0,1,0,0,1,0.24166666666666667
初始接入api,0,0,0,0,1,0,0,1,0.24166666666666667
mnap,0,0,0,0,1,0,0,1,0.24166666666666667
napmovecon,0,0,0,0,1,0,0,1,0.24166666666666667
contrustgpformm3,0,0,0,0,1,0,0,1,0.24166666666666667
nap3status,0,0,0,0,1,0,0,1,0.24166666666666667
napduplication,0,0,0,0,1,0,0,1,0.24166666666666667
tus,0,0,0,0,1,0,0,1,0.24166666666666667
nap3,0,0,0,0,1,0,0,1,0.24166666666666667
napmoverequest,0,0,0,0,1,0,0,1,0.24166666666666667
切换指示消息,0,0,0,0,1,0,0,1,0.24166666666666667
底层信息报告,0,0,0,0,1,0,0,1,0.24166666666666667
apid,0,0,0,0,1,0,0,1,0.24166666666666667
mnid,0,0,0,0,1,0,0,1,0.24166666666666667
fh-pmipv6,0,0,0,0,1,0,0,1,0.24166666666666667
二层切换,0,0,0,0,1,0,0,1,0.24166666666666667
家乡锚点,0,0,0,0,1,0,0,1,0.24166666666666667
移动性管理网络,0,0,0,0,1,0,0,1,0.24166666666666667
用户接入流程,0,0,0,0,1,0,0,1,0.24166666666666667
接入信令流程,0,0,0,0,1,0,0,1,0.24166666666666667
rao,0,0,0,0,1,0,0,1,0.24166666666666667
mn1-ip,0,0,0,0,1,0,0,1,0.24166666666666667
mnvap,0,0,0,0,1,0,0,1,0.24166666666666667
缓存表,0,0,0,0,1,0,0,1,0.24166666666666667
下行,0,0,0,0,1,0,0,1,0.24166666666666667
上行,0,0,0,0,1,0,0,1,0.24166666666666667
ap5,0,0,0,0,1,0,0,1,0.24166666666666667
vap5,0,0,0,0,1,0,0,1,0.24166666666666667
ap4,0,0,0,0,1,0,0,1,0.24166666666666667
vap4,0,0,0,0,1,0,0,1,0.24166666666666667
ap1,0,0,0,0,1,0,0,1,0.24166666666666667
mnvapap,0,0,0,0,1,0,0,1,0.24166666666666667
vap-id,0,0,0,0,1,0,0,1,0.24166666666666667
ap1-id,0,0,0,0,1,0,0,1,0.24166666666666667
更新消息,0,0,0,0,1,0,0,1,0.24166666666666667
査询映射表,0,0,0,0,1,0,0,1,0.24166666666666667
mn3接入api,0,0,0,0,1,0,0,1,0.24166666666666667
接入注册,0,0,0,0,1,0,0,1,0.24166666666666667
mni-ip,0,0,0,0,1,0,0,1,0.24166666666666667
mni,0,0,0,0,1,0,0,1,0.24166666666666667
mi,0,0,0,0,1,0,0,1,0.24166666666666667
homeaddress,0,0,0,0,1,0,0,1,0.24166666666666667
主机标识,0,0,0,0,1,0,0,1,0.24166666666666667
mobilenode,0,0,0,0,1,0,0,1,0.24166666666666667
移动性协议,0,0,0,0,1,0,0,1,0.24166666666666667
接入网络过程,0,0,0,0,1,0,0,1,0.24166666666666667
vapsetupresponse,0,0,0,0,1,0,0,1,0.24166666666666667
proberequest,0,0,0,0,1,0,0,1,0.24166666666666667
虚拟ap0,0,0,0,0,1,0,0,1,0.24166666666666667
中继节点,0,0,0,0,1,0,0,1,0.24166666666666667
apops-vap,0,0,0,0,1,0,0,1,0.24166666666666667
基站id,0,0,0,0,1,0,0,1,0.24166666666666667
基站,0,0,0,0,1,0,0,1,0.24166666666666667
mac地址,0,0,0,0,1,0,0,1,0.24166666666666667
ps-vapo,0,0,0,0,1,0,0,1,0.24166666666666667
控制信道,0,0,0,0,1,0,0,1,0.24166666666666667
标识符,0,0,0,0,1,0,0,1,0.24166666666666667
配置文,0,0,0,0,1,0,0,1,0.24166666666666667
固件,0,0,0,0,1,0,0,1,0.24166666666666667
程序,0,0,0,0,1,1,0,2,0.48333333333333334
接入口,0,0,0,0,1,0,0,1,0.24166666666666667
配置管理,0,0,0,0,1,0,0,1,0.24166666666666667
管理模块,0,0,0,0,1,0,0,1,0.24166666666666667
rip,0,0,0,0,1,0,0,1,0.24166666666666667
bgp,0,0,0,0,1,0,0,1,0.24166666666666667
ospf,0,0,0,0,1,0,0,1,0.24166666666666667
交互模块,0,0,0,0,1,0,0,1,0.24166666666666667
网络管理软件,0,0,0,0,1,0,0,1,0.24166666666666667
i/o端口,0,0,0,0,1,0,0,1,0.24166666666666667
虚拟路由器,0,0,0,0,1,0,0,1,0.24166666666666667
ueip地址,0,0,0,0,1,0,0,1,0.24166666666666667
apip,0,0,0,0,1,0,0,1,0.24166666666666667
镜像,0,0,0,0,0,5,0,5,1.2083333333333333
centos,0,0,0,0,0,2,0,2,0.48333333333333334
ocker,0,0,0,0,0,1,0,1,0.24166666666666667
4d,0,0,0,0,0,1,0,1,0.24166666666666667
ii,0,0,0,0,0,1,0,1,0.24166666666666667
policycore,0,0,0,0,0,1,0,1,0.24166666666666667
ibsemanage,0,0,0,0,0,1,0,1,0.24166666666666667
pythdb,0,0,0,0,0,1,0,1,0.24166666666666667
3docker,0,0,0,0,0,1,0,1,0.24166666666666667
yuminstalldocker,0,0,0,0,0,1,0,1,0.24166666666666667
yum,0,0,0,0,0,1,0,1,0.24166666666666667
更新包数据库,0,0,0,0,0,1,0,1,0.24166666666666667
yumcheck-update,0,0,0,0,0,1,0,1,0.24166666666666667
docker结构,0,0,0,0,0,1,0,1,0.24166666666666667
启动速度,0,0,0,0,0,1,0,1,0.24166666666666667
内存空间,0,0,0,0,0,1,0,1,0.24166666666666667
linux内核,0,0,0,0,0,1,0,1,0.24166666666666667
宿主机,0,0,0,0,0,1,0,1,0.24166666666666667
操作系统,0,0,0,0,0,1,0,1,0.24166666666666667
物理硬件,0,0,0,0,0,1,0,1,0.24166666666666667
虚拟机技,0,0,0,0,0,1,0,1,0.24166666666666667
环境变量,0,0,0,0,0,1,0,1,0.24166666666666667
虚拟环境,0,0,0,0,0,1,0,1,0.24166666666666667
container,0,0,0,0,0,1,0,1,0.24166666666666667
image,0,0,0,0,0,1,0,1,0.24166666666666667
内核,0,0,0,0,0,1,0,1,0.24166666666666667
轻量级,0,0,0,0,0,1,0,1,0.24166666666666667
安全,0,0,0,0,0,1,0,1,0.24166666666666667
隔离性,0,0,0,0,0,1,0,1,0.24166666666666667
应用程序,0,0,0,0,0,1,0,1,0.24166666666666667
容器虚拟化平台,0,0,0,0,0,1,0,1,0.24166666666666667
实验环境,0,0,0,0,0,1,0,1,0.24166666666666667
dmm方案,2,0,0,0,0,0,0,2,2.0
虚拟化技,1,0,0,0,0,0,0,1,1.0
dmm切换过程,1,0,0,0,0,0,0,1,1.0
流量优,1,0,0,0,0,0,0,1,1.0
alb,1,0,0,0,0,0,0,1,1.0
负载ap,1,0,0,0,0,0,0,1,1.0
仿真试验,1,0,0,0,0,0,0,1,1.0
distribu,1,0,0,0,0,0,0,1,1.0
tedmobilitymanage,1,0,0,0,0,0,0,1,1.0
管控压力,1,0,0,0,0,0,0,1,1.0
