,摘要,关键词,第一章,第二章,第三章,第四章,第五章,总词频,加权得分
lmmse算法,0,0,2,0,25,0,0,27,6.291666666666667
性能,0,0,14,3,47,4,5,73,15.658333333333333
信道估计算法,3,0,14,3,34,5,4,63,15.516666666666667
信道,3,0,14,5,55,18,0,95,23.016666666666666
vcfr算法,0,0,5,2,14,3,2,26,5.466666666666667
ls算法,0,0,1,2,10,0,0,13,2.7916666666666665
算法性能,0,0,2,0,2,0,0,4,0.7333333333333334
算法,0,0,8,1,5,0,0,14,2.333333333333333
协议,0,0,0,1,1,0,0,2,0.3666666666666667
吞吐量,0,0,1,2,6,0,0,9,1.825
f-lmmse算法,0,0,2,0,14,0,0,16,3.6333333333333333
dft去噪算法,0,0,2,0,3,0,1,6,1.2166666666666668
仿真,1,0,1,0,8,0,2,12,3.5416666666666665
差异化去噪策略,1,1,0,0,5,0,1,8,4.45
频域平滑,1,0,0,0,1,0,0,2,1.2416666666666667
升余弦窗,0,0,0,0,4,0,0,4,0.9666666666666667
vcfr,2,0,8,2,25,21,4,62,15.333333333333334
snr,0,0,0,1,30,0,1,32,7.616666666666667
乘法,0,0,0,0,1,2,0,3,0.725
大矩阵,0,0,2,0,3,0,0,5,0.975
工程,0,0,0,0,3,0,0,3,0.725
信道条件,0,0,3,0,6,0,0,9,1.825
自相关特性矩阵,0,0,0,0,1,0,0,1,0.24166666666666667
运算复杂度,0,0,6,0,6,0,0,12,2.2
求逆过程,0,0,0,0,2,0,0,2,0.48333333333333334
fft变换,0,0,0,0,1,0,0,1,0.24166666666666667
信道条,0,0,0,0,3,0,0,3,0.725
存储信道信息,0,0,0,0,1,0,0,1,0.24166666666666667
块分解,0,0,0,0,8,0,0,8,1.9333333333333333
svd分解,0,0,0,0,4,0,0,4,0.9666666666666667
化算法,0,0,0,0,1,0,0,1,0.24166666666666667
mmse,0,0,2,0,6,1,0,9,1.9416666666666667
边缘性能,0,0,0,0,1,0,0,1,0.24166666666666667
dft去噪,0,0,1,0,7,0,0,8,1.8166666666666667
dft变换域去噪,0,0,3,0,3,0,1,7,1.3416666666666668
mmse算法,0,0,3,0,4,0,0,7,1.3416666666666668
ls,0,0,1,1,7,0,0,9,1.9416666666666667
滤波,0,0,1,0,2,0,0,3,0.6083333333333334
信道自相关特性,0,0,0,0,1,0,0,1,0.24166666666666667
mmse准则,0,0,7,0,4,0,0,11,1.8416666666666668
信噪比,0,0,3,1,9,0,0,13,2.675
导频,1,0,4,0,4,0,0,9,2.466666666666667
子载波,0,0,0,16,9,5,0,30,5.383333333333333
分布式映射,0,0,0,3,0,0,0,3,0.375
集中式映射,0,0,0,3,0,0,0,3,0.375
dft,1,0,4,3,21,8,0,37,8.883333333333333
dft-s-ofdm,0,0,0,2,0,0,0,2,0.25
频域,0,0,3,6,12,2,0,23,4.508333333333333
sc-fdma,0,0,0,5,3,0,0,8,1.35
数据符号,0,0,0,2,0,0,0,2,0.25
papr,0,0,0,3,0,0,0,3,0.375
上行信号,0,0,0,2,0,0,0,2,0.25
发送处理,0,0,0,1,0,0,0,1,0.125
ft-s-fdma,0,0,0,1,0,0,0,1,0.125
功率控制,0,0,0,2,0,0,0,2,0.25
频率误差,0,0,0,2,0,0,0,2,0.25
频率分集,0,0,0,1,0,0,0,1,0.125
m点,0,0,0,1,1,0,0,2,0.3666666666666667
发射天线,0,0,0,1,0,0,0,1,0.125
d/a转换,0,0,0,1,0,0,0,1,0.125
ifft变换,0,0,0,1,1,0,0,2,0.3666666666666667
n点,0,0,0,1,0,0,0,1,0.125
dft输出信号,0,0,0,1,0,0,0,1,0.125
调制符号,0,0,0,1,0,0,0,1,0.125
调制字母表,0,0,0,1,0,0,0,1,0.125
信号,0,0,2,4,6,0,0,12,2.2
lte,3,0,5,15,7,4,1,35,8.4
时域,0,0,5,5,23,2,0,35,7.291666666666667
sc-fdma信号,0,0,0,2,0,0,0,2,0.25
上行发送,0,0,0,1,0,0,0,1,0.125
ofdm多载波系统,0,0,0,1,0,0,0,1,0.125
单载波系统,0,0,0,1,0,0,0,1,0.125
子载波映射,0,0,0,1,0,0,0,1,0.125
dft变,0,0,0,1,0,0,0,1,0.125
时域调制符号,0,0,0,1,0,0,0,1,0.125
调制,0,0,0,6,4,0,0,10,1.7166666666666668
ofdm,0,0,1,15,0,0,0,16,2.0
sc-fdmao,0,0,0,1,0,0,0,1,0.125
单载波频分多址,0,0,0,1,0,0,0,1,0.125
上行多址接,0,0,0,1,0,0,0,1,0.125
ofdma,0,0,0,2,0,0,0,2,0.25
lte系统,1,0,3,13,0,0,1,18,3.2416666666666667
ofdm系统,0,0,2,4,7,0,1,14,2.6833333333333336
选择性调度,0,0,0,1,0,0,0,1,0.125
频率,0,0,1,1,0,0,0,2,0.25
频率分集增益,0,0,0,1,0,0,0,1,0.125
功放设,0,0,0,1,0,0,0,1,0.125
终端设备,0,0,0,1,0,0,0,1,0.125
峰均比,0,0,0,1,0,0,0,1,0.125
上行发射信号,0,0,0,1,0,0,0,1,0.125
系统容量,0,0,0,1,0,0,0,1,0.125
小区间干扰,0,0,0,1,0,0,0,1,0.125
终端,0,0,0,1,0,0,0,1,0.125
上行物理层,0,0,0,1,0,0,0,1,0.125
fdma,0,0,2,2,0,0,0,4,0.5
etu70hz,0,0,1,0,0,0,0,1,0.125
eva70hz,0,0,1,0,0,0,0,1,0.125
cir,0,0,6,0,26,0,0,32,7.033333333333333
噪声,0,0,6,0,13,0,0,19,3.8916666666666666
自相关矩阵,0,0,4,0,12,0,0,16,3.4
去噪,0,0,3,0,9,1,0,13,2.7916666666666665
cfr,0,0,3,0,24,0,0,27,6.175
信道估计,2,1,6,4,14,7,1,35,10.566666666666666
加窗函数,0,0,2,0,3,0,0,5,0.975
虚载波频域信道响应,0,0,2,0,0,0,0,2,0.25
信道信息,0,0,3,0,8,0,1,12,2.55
信道自相关矩阵,0,0,2,0,5,0,0,7,1.4583333333333333
特征值,0,0,2,0,1,0,0,3,0.4916666666666667
复杂度,0,0,4,0,6,0,0,10,1.95
求逆运算,0,0,3,0,3,0,0,6,1.1
窗函数,0,0,3,0,8,4,0,15,3.275
idft,0,0,2,1,1,7,0,11,2.3083333333333336
长度,0,0,2,5,8,1,0,16,3.05
冲击响应,0,0,5,0,14,0,0,19,4.008333333333333
dmrs,0,0,2,3,6,1,0,12,2.3166666666666664
最大径数,0,0,1,0,1,0,0,2,0.3666666666666667
去噪算法,0,0,2,0,9,0,0,11,2.425
mse指标,0,0,1,0,9,0,0,10,2.3
干扰,0,0,1,1,2,0,0,4,0.7333333333333334
mst去噪算法,0,0,1,0,3,0,0,4,0.85
平滑,0,0,1,0,0,1,0,2,0.3666666666666667
信道估计算,0,0,1,0,3,0,0,4,0.85
dft信道估计算法,0,0,1,0,1,0,0,2,0.3666666666666667
偏差,0,0,1,0,0,0,0,1,0.125
cfr信息,0,0,1,0,3,0,0,4,0.85
邻道干扰,0,0,1,0,1,0,0,2,0.3666666666666667
虚子载波,0,0,2,0,14,0,0,16,3.6333333333333333
lmmse矩阵,0,0,1,0,1,0,0,2,0.3666666666666667
mst算法,0,0,1,0,5,0,0,6,1.3333333333333333
计算,0,0,1,0,1,0,0,2,0.3666666666666667
lmmse信道,0,0,2,0,0,0,0,2,0.25
lmmse,0,0,1,0,9,0,2,12,2.783333333333333
误差,0,0,1,0,6,3,0,10,2.3
建模,0,0,1,0,0,0,0,1,0.125
参数,0,0,1,0,1,8,0,10,2.3
实时信道,0,0,1,0,0,0,0,1,0.125
特征信息,0,0,1,0,0,0,0,1,0.125
并存储信道,0,0,1,0,0,0,0,1,0.125
choleshy分解运算,0,0,1,0,0,0,0,1,0.125
伪多径,0,0,1,0,0,0,0,1,0.125
多径,0,0,1,0,1,0,0,2,0.3666666666666667
能量值,0,0,1,0,0,0,0,1,0.125
idft变换,0,0,1,0,1,1,0,3,0.6083333333333334
带宽,0,0,2,3,2,0,0,7,1.1083333333333334
子矩阵块,0,0,1,0,1,0,0,2,0.3666666666666667
mmse运算量,0,0,1,0,0,0,0,1,0.125
矩阵降,0,0,1,0,0,0,0,1,0.125
奇异值,0,0,1,0,3,0,0,4,0.85
滤波矩阵,0,0,1,0,4,0,0,5,1.0916666666666668
svd,0,0,1,0,6,0,0,7,1.575
奇异值分解,0,0,1,0,1,0,0,2,0.3666666666666667
矩阵维度,0,0,1,0,2,0,0,3,0.6083333333333334
运算,0,0,1,0,0,2,0,3,0.6083333333333334
矩阵,0,0,1,0,19,0,0,20,4.716666666666667
真实信道响应,0,0,1,0,0,0,0,1,0.125
接收信号,0,0,2,0,0,0,0,2,0.25
接收端,1,0,1,0,1,1,0,4,1.6083333333333334
有噪声环,0,0,1,0,0,0,0,1,0.125
代价函数,0,0,1,0,4,0,0,5,1.0916666666666668
能量泄露,0,0,1,0,1,0,0,2,0.3666666666666667
冲击响应去噪,0,0,1,0,0,0,0,1,0.125
时域信道,0,0,2,0,4,0,0,6,1.2166666666666668
经验值窗函数,0,0,1,0,0,0,0,1,0.125
有效信道信息,0,0,1,0,1,0,0,2,0.3666666666666667
去噪操作,0,0,1,0,0,0,0,1,0.125
扩散,0,0,1,0,0,0,0,1,0.125
离散傅里叶反变换,0,0,1,0,1,0,0,2,0.3666666666666667
加窗平滑,0,0,1,0,0,0,0,1,0.125
dft算法,0,0,2,0,14,0,0,16,3.6333333333333333
频域加窗,0,0,3,0,2,1,0,6,1.1
指导门限,0,0,1,0,2,0,0,3,0.6083333333333334
估计性能,0,0,1,0,0,0,0,1,0.125
能量,0,0,1,0,7,0,0,8,1.8166666666666667
门限去噪,0,0,1,0,0,0,0,1,0.125
样点,0,0,1,0,0,0,0,1,0.125
cp长度,0,0,1,1,5,0,0,7,1.4583333333333333
循环前缀,0,0,1,2,1,2,0,6,1.1
信道冲击响应,0,0,1,0,4,0,0,5,1.0916666666666668
去噪策略,0,0,3,0,1,0,1,5,0.8583333333333334
去噪处理,0,0,1,0,4,0,0,5,1.0916666666666668
离散傅里叶变换,0,0,1,0,0,1,0,2,0.3666666666666667
ls估计算法,0,0,1,0,0,0,0,1,0.125
低信噪比,0,0,1,0,2,0,0,3,0.6083333333333334
抗噪声影响能力,0,0,1,0,0,0,0,1,0.125
ols算法,0,0,1,0,0,0,0,1,0.125
频域信道,0,0,2,0,7,0,0,9,1.9416666666666667
zadofflchu序列,0,0,1,0,0,0,0,1,0.125
ls信道,0,0,1,0,4,3,1,9,2.0583333333333336
非盲信道,1,0,1,0,0,0,0,2,1.125
计算法,1,0,1,0,1,0,1,4,1.6083333333333334
lte信道,0,0,1,0,0,1,0,2,0.3666666666666667
解调参考信号,0,0,1,2,3,1,0,7,1.3416666666666668
导频信号,2,0,1,3,1,0,0,7,2.7416666666666667
子帧,0,0,1,2,2,1,0,6,1.1
发送链路,0,0,1,0,0,0,0,1,0.125
2lte信道估计算法,0,0,1,0,0,0,0,1,0.125
上行链路,3,0,1,3,4,0,0,11,4.466666666666667
td-lte,4,0,1,2,2,3,0,12,5.583333333333333
冲激响应,0,0,0,0,10,3,0,13,3.1416666666666666
虚信道,0,1,0,0,5,2,0,8,3.6916666666666664
最小均方误差准则,0,0,0,0,1,0,0,1,0.24166666666666667
最小二乘准则,0,0,0,0,2,0,0,2,0.48333333333333334
lte算法,0,0,0,0,1,0,0,1,0.24166666666666667
非盲检测信道估计算法,0,0,0,0,1,0,0,1,0.24166666666666667
上行频域,0,0,0,0,1,0,0,1,0.24166666666666667
子帧结构,0,0,0,1,1,0,0,2,0.3666666666666667
pusch信道,0,0,0,0,1,1,0,2,0.48333333333333334
接收链路,0,0,0,0,1,0,0,1,0.24166666666666667
f-lmmse,0,0,3,0,11,0,0,14,3.033333333333333
自相关矩阵特性,0,0,0,0,1,0,0,1,0.24166666666666667
快速算法,0,0,0,0,1,0,0,1,0.24166666666666667
kuma,0,0,0,0,1,0,0,1,0.24166666666666667
信道环境,0,0,0,0,4,0,0,4,0.9666666666666667
均方时延拓展,0,0,0,0,1,0,0,1,0.24166666666666667
径时延幅值,0,0,0,0,1,0,0,1,0.24166666666666667
反也时,0,0,0,0,1,0,0,1,0.24166666666666667
酉矩阵存储,0,0,0,0,1,0,0,1,0.24166666666666667
3gpp,1,0,2,6,0,0,0,9,2.0
载波聚合,0,0,0,2,0,0,0,2,0.25
4g标准,0,0,0,1,0,0,0,1,0.125
imt-advanced,0,0,0,1,0,0,0,1,0.125
itu-r,0,0,0,1,0,0,0,1,0.125
频带内載波聚合,0,0,0,1,0,0,0,1,0.125
中继,0,0,0,1,0,0,0,1,0.125
icic,0,0,0,1,0,0,0,1,0.125
mim0,0,0,0,1,0,0,0,1,0.125
下行mim,0,0,0,1,0,0,0,1,0.125
多标准基站,0,0,0,1,0,0,0,1,0.125
lte-advanced,0,0,1,1,0,1,0,3,0.4916666666666667
mbms,0,0,0,1,0,0,0,1,0.125
定位业务,0,0,0,1,0,0,0,1,0.125
lte家庭基站,0,0,0,1,0,0,0,1,0.125
sae,0,0,0,1,0,0,0,1,0.125
epc,0,0,0,1,0,0,0,1,0.125
lte技术,1,0,0,1,0,0,0,2,1.125
300,0,0,0,1,0,0,0,1,0.125
tr36,0,0,0,1,0,0,0,1,0.125
ltestage2,0,0,0,1,0,0,0,1,0.125
ran3,0,0,0,1,0,0,0,1,0.125
ran2,0,0,0,1,0,0,0,1,0.125
ran1,0,0,0,1,0,0,0,1,0.125
需求报告,0,0,0,1,0,0,0,1,0.125
lteo,0,0,0,1,0,0,0,1,0.125
lte标准化,0,0,0,1,0,0,0,1,0.125
标准化进程,0,0,0,1,0,0,0,1,0.125
上行信道,0,0,0,1,5,4,1,11,2.5416666666666665
插值算法,0,0,0,0,4,0,0,4,0.9666666666666667
sc-fdma符号,0,0,0,5,9,2,0,16,3.283333333333333
插值,0,0,0,0,3,0,0,3,0.725
时隙,0,0,0,6,3,2,0,11,1.9583333333333333
拉格朗日,0,0,0,0,2,0,0,2,0.48333333333333334
dft插值,0,0,0,0,2,0,0,2,0.48333333333333334
低通滤波内插,0,0,0,0,2,0,0,2,0.48333333333333334
内插算法,0,0,0,0,2,0,0,2,0.48333333333333334
导频处信道,0,0,0,0,1,0,0,1,0.24166666666666667
信道均衡,0,0,0,0,1,7,0,8,1.9333333333333333
时变,0,0,0,0,1,0,0,1,0.24166666666666667
低速场景,0,0,0,0,1,0,0,1,0.24166666666666667
杂度,0,0,1,0,2,0,0,3,0.6083333333333334
阶数,0,0,0,0,1,0,0,1,0.24166666666666667
三阶插值,0,0,0,0,1,0,0,1,0.24166666666666667
cubic插值,0,0,0,0,1,0,0,1,0.24166666666666667
二阶抛物线内插,0,0,0,0,1,0,0,1,0.24166666666666667
线性内插,0,0,0,0,1,0,0,1,0.24166666666666667
一阶,0,0,0,0,1,0,0,1,0.24166666666666667
拉格朗日内插,0,0,0,0,1,0,0,1,0.24166666666666667
lte下行信道,0,0,0,0,1,0,0,1,0.24166666666666667
等距,0,0,0,0,1,0,0,1,0.24166666666666667
低通滤波,0,0,0,0,1,0,0,1,0.24166666666666667
拉格郎日内插,0,0,0,0,1,0,0,1,0.24166666666666667
时域维度,0,0,0,0,1,0,0,1,0.24166666666666667
频域冲激响应,0,0,0,0,1,0,0,1,0.24166666666666667
全频域,0,0,0,0,1,0,0,1,0.24166666666666667
odmrs,0,0,0,0,1,0,0,1,0.24166666666666667
ltepusch信道,0,0,0,0,1,0,0,1,0.24166666666666667
导频设,0,0,1,1,1,0,0,3,0.4916666666666667
±行链路,0,0,0,0,1,0,0,1,0.24166666666666667
zc序列,0,0,0,7,1,11,0,19,3.775
循环移位,0,0,0,4,3,3,0,10,1.95
基序列,0,0,0,3,0,2,0,5,0.8583333333333334
序列,0,0,0,3,2,0,0,5,0.8583333333333334
zc基序列,0,0,0,2,0,0,0,2,0.25
sch,0,0,0,2,0,4,0,6,1.2166666666666668
cp时解调参考信号,0,0,0,2,0,0,0,2,0.25
参考信号,0,0,0,2,0,4,0,6,1.2166666666666668
时隙队,0,0,0,1,0,0,0,1,0.125
归野,0,0,0,1,0,0,0,1,0.125
表达式,0,0,0,1,1,0,0,2,0.3666666666666667
qpsk,0,0,0,3,2,0,0,5,0.8583333333333334
传输带宽,0,0,0,1,0,0,0,1,0.125
rb资源块,0,0,0,1,0,0,0,1,0.125
长度长,0,0,0,1,0,0,0,1,0.125
子载波数,0,0,0,1,4,3,0,8,1.8166666666666667
rs信号,0,0,0,1,0,0,0,1,0.125
15景器,0,0,0,1,0,0,0,1,0.125
dmrs长度,0,0,0,1,0,0,0,1,0.125
信号序列,0,0,0,1,0,0,0,1,0.125
元素,0,0,0,1,8,0,0,9,2.0583333333333336
恒定功率,0,0,0,1,0,0,0,1,0.125
zadoff-chu,0,0,0,1,0,0,0,1,0.125
上行,0,0,1,2,0,1,0,4,0.6166666666666667
常规,0,0,0,2,0,0,0,2,0.25
上行参考信号,0,0,0,1,0,1,0,2,0.3666666666666667
功放效率,0,0,0,1,0,0,0,1,0.125
立方度量,0,0,0,1,0,0,0,1,0.125
上行传输,0,0,0,3,0,0,0,3,0.375
dm,0,0,0,1,0,0,0,1,0.125
非盲估计算法,0,0,0,1,0,0,0,1,0.125
定时估计,0,0,0,1,0,0,0,1,0.125
质量检测,0,0,0,1,0,0,0,1,0.125
用户信道,0,0,0,1,0,0,0,1,0.125
相干解调,0,0,0,1,0,0,0,1,0.125
srs,0,0,0,1,0,0,0,1,0.125
探测参考信号,0,0,0,1,0,0,0,1,0.125
lte时频资源栅格,0,0,0,1,0,0,0,1,0.125
上行信道导频信号,0,0,0,1,0,0,0,1,0.125
mse地板效应,0,0,0,0,4,0,0,4,0.9666666666666667
边缘效应,0,0,0,0,6,0,0,6,1.45
失真,0,0,0,0,2,0,0,2,0.48333333333333334
mse,0,0,0,0,4,0,0,4,0.9666666666666667
cfr边缘效应,0,0,0,0,2,0,0,2,0.48333333333333334
dft信道,1,0,0,0,5,0,1,7,2.45
回频域,0,0,0,0,1,0,0,1,0.24166666666666667
高频,0,0,0,0,1,0,0,1,0.24166666666666667
频谱,0,0,0,0,1,0,0,1,0.24166666666666667
时域信号,0,0,0,1,2,0,0,3,0.6083333333333334
拖尾,0,0,0,0,1,0,0,1,0.24166666666666667
功率谱,0,0,0,0,2,0,0,2,0.48333333333333334
频谱分析,0,0,0,0,1,0,0,1,0.24166666666666667
时域多径信道信息,0,0,0,0,1,0,0,1,0.24166666666666667
sine函数,0,0,0,0,1,0,0,1,0.24166666666666667
多径信道冲激径卷积,0,0,0,0,1,0,0,1,0.24166666666666667
加噪,0,0,0,0,1,0,0,1,0.24166666666666667
在时域,0,0,0,0,1,0,0,1,0.24166666666666667
低通滤波器,0,0,0,0,1,0,0,1,0.24166666666666667
冲激响应值,0,0,0,1,1,0,0,2,0.3666666666666667
边界影响,0,0,0,0,1,0,0,1,0.24166666666666667
有效信号,0,0,1,0,6,0,0,7,1.575
有效径,0,0,0,0,4,0,0,4,0.9666666666666667
有用信号径,0,0,0,0,1,0,0,1,0.24166666666666667
信号径,0,0,0,0,3,0,0,3,0.725
门限过滤,0,0,0,0,1,0,0,1,0.24166666666666667
变换域,0,0,0,0,1,0,0,1,0.24166666666666667
时域cir,0,0,0,0,1,0,0,1,0.24166666666666667
地板,0,0,1,0,2,0,0,3,0.6083333333333334
cfr误差,0,0,0,0,1,0,0,1,0.24166666666666667
mse地板现象,0,0,0,0,1,0,0,1,0.24166666666666667
地板现象,0,0,0,0,3,0,0,3,0.725
矩形,0,0,0,0,1,0,0,1,0.24166666666666667
rb数,0,0,0,2,2,4,0,8,1.7
epa5,0,0,0,0,1,0,0,1,0.24166666666666667
信道模型,0,0,0,0,3,0,0,3,0.725
边缘区,0,0,0,0,1,0,0,1,0.24166666666666667
丢失,0,0,0,0,1,0,0,1,0.24166666666666667
滤波器,0,0,0,0,1,0,0,1,0.24166666666666667
块状导频,0,0,0,0,1,0,0,1,0.24166666666666667
梳状导频,0,0,0,0,1,0,0,1,0.24166666666666667
mmse估计算法,0,0,0,0,2,0,0,2,0.48333333333333334
ls估计,1,0,1,0,1,2,1,6,2.091666666666667
dft估计算法,0,0,0,0,1,0,0,1,0.24166666666666667
ofdm符号,0,0,0,6,0,0,0,6,0.75
正交性,0,0,0,4,0,0,0,4,0.5
数据,0,0,0,2,0,21,0,23,5.325
时间长度,0,0,0,2,0,0,0,2,0.25
频域信号,0,0,0,2,0,0,0,2,0.25
相关器,0,0,0,2,0,0,0,2,0.25
子信道,0,0,0,2,0,0,0,2,0.25
硬件设备,0,0,0,1,0,0,0,1,0.125
峰均功率比,0,0,0,1,0,0,0,1,0.125
ofdm信号,0,0,0,1,0,0,0,1,0.125
高速移动用户,0,0,0,1,0,0,0,1,0.125
多普勒频移,0,0,0,1,0,0,0,1,0.125
相位噪声,0,0,0,1,0,0,0,1,0.125
系统,0,0,2,1,1,0,0,4,0.6166666666666667
符号间干扰,0,0,0,1,1,0,0,2,0.3666666666666667
多径信号,0,0,0,1,0,0,0,1,0.125
无线信道,0,0,0,1,0,0,0,1,0.125
均衡器,0,0,0,1,0,0,0,1,0.125
频谱利用率,0,0,0,2,0,0,0,2,0.25
抗衰落能力,0,0,0,1,0,0,0,1,0.125
移动通信系统,3,0,8,1,0,0,0,12,4.125
宽带接入结束,0,0,0,1,0,0,0,1,0.125
ofdm技术,0,0,0,3,0,0,0,3,0.375
cp过程,0,0,0,1,0,0,0,1,0.125
ofdmtu,0,0,0,1,0,0,0,1,0.125
cp前,0,0,0,1,0,0,0,1,0.125
时间长度波形复制,0,0,0,1,0,0,0,1,0.125
tcp,0,0,0,1,0,0,0,1,0.125
子载波间干扰,0,0,0,1,0,0,0,1,0.125
时间色散信道,0,0,0,1,0,0,0,1,0.125
ofdm解调性能,0,0,0,1,0,0,0,1,0.125
信道编码,0,0,0,1,0,0,0,1,0.125
ft,0,0,0,1,0,1,0,2,0.3666666666666667
ofdm基带信号,0,0,0,1,0,0,0,1,0.125
ofdm解调原,0,0,0,1,0,0,0,1,0.125
ofdm调制,0,0,0,1,0,0,0,1,0.125
解调,0,0,0,1,0,0,0,1,0.125
相干解调器,0,0,0,1,0,0,0,1,0.125
ofdm接收端,0,0,0,1,0,0,0,1,0.125
中心频率,0,0,0,1,0,0,0,1,0.125
数据流,0,0,0,1,0,0,0,1,0.125
数据速率,0,0,0,1,0,1,0,2,0.3666666666666667
速率,0,0,0,1,0,1,0,2,0.3666666666666667
子数据流,0,0,0,1,0,0,0,1,0.125
低速率子数据流,0,0,0,1,0,0,0,1,0.125
高速数据流,0,0,0,1,0,0,0,1,0.125
平坦衰落信道,0,0,0,1,0,0,0,1,0.125
相干带宽,0,0,0,1,1,0,0,2,0.3666666666666667
窄带子信道,0,0,0,1,0,0,0,1,0.125
宽带信道,0,0,0,1,0,0,0,1,0.125
多载波调制技术,0,0,0,1,0,0,0,1,0.125
vcfr信道估计算法,1,0,2,0,1,3,1,8,2.458333333333333
硬件,0,0,1,0,0,1,0,2,0.3666666666666667
dft变换域去噪信道,0,0,2,0,0,0,1,3,0.4916666666666667
非叠加分块,0,0,0,0,2,0,0,2,0.48333333333333334
运算量,0,0,0,0,9,3,0,12,2.9
叠加算法,0,0,0,0,1,0,0,1,0.24166666666666667
信息,0,0,0,0,1,2,0,3,0.725
子块,0,0,0,0,1,0,0,1,0.24166666666666667
对角子阵,0,0,0,0,1,0,0,1,0.24166666666666667
非叠加算法,0,0,0,0,1,0,0,1,0.24166666666666667
维矩阵,0,0,0,0,1,0,0,1,0.24166666666666667
lmms,0,0,0,0,1,0,0,1,0.24166666666666667
分块,0,0,0,0,1,1,0,2,0.48333333333333334
月伽,0,0,0,0,1,0,0,1,0.24166666666666667
中子块,0,0,0,0,1,0,0,1,0.24166666666666667
无叠加分解,0,0,0,0,1,0,0,1,0.24166666666666667
计算量,0,0,0,0,3,0,0,3,0.725
子系统,0,0,0,0,1,2,0,3,0.725
子矩阵,0,0,0,0,1,0,0,1,0.24166666666666667
计算复杂度,0,0,0,0,1,0,0,1,0.24166666666666667
lmmse简化算法,0,0,0,0,1,0,0,1,0.24166666666666667
相关性弱,0,0,0,0,1,0,0,1,0.24166666666666667
自相关特性,0,0,0,0,1,0,0,1,0.24166666666666667
吞吐量指标,0,0,0,2,1,0,0,3,0.4916666666666667
性能指标,0,0,0,2,1,0,0,3,0.4916666666666667
64qam调制,0,0,0,1,0,0,0,1,0.125
16qam调制,0,0,0,1,1,0,0,2,0.3666666666666667
qpsk调制,0,0,0,1,1,1,0,3,0.6083333333333334
信道冲激响应,0,0,0,0,11,0,0,11,2.658333333333333
接收端信号,0,0,0,0,7,0,0,7,1.6916666666666667
相关矩阵,0,0,0,0,1,0,0,1,0.24166666666666667
预算复杂度,0,0,0,0,1,0,0,1,0.24166666666666667
复数乘法,0,0,0,0,2,4,0,6,1.45
肉阳,0,0,0,0,1,0,0,1,0.24166666666666667
rhh,0,0,0,0,3,0,0,3,0.725
巧丁,0,0,0,0,1,0,0,1,0.24166666666666667
mmse信道,0,0,0,0,2,0,0,2,0.48333333333333334
偏导值,0,0,0,0,1,0,0,1,0.24166666666666667
偏导,0,0,0,0,1,0,0,1,0.24166666666666667
se,0,0,0,0,1,0,0,1,0.24166666666666667
系数矩阵,0,0,0,0,1,0,0,1,0.24166666666666667
协/,0,0,0,0,1,0,0,1,0.24166666666666667
信道冲激响应误差,0,0,0,0,1,0,0,1,0.24166666666666667
发送端信号,0,0,0,0,2,0,0,2,0.48333333333333334
最小均方误差,0,0,0,0,1,0,0,1,0.24166666666666667
msc8157,0,0,0,0,0,14,0,14,3.3833333333333333
时钟周期,0,0,0,0,0,4,0,4,0.9666666666666667
dsp芯片,0,0,0,0,0,5,0,5,1.2083333333333333
飞思卡尔,0,0,0,0,0,5,1,6,1.45
性价比,0,0,0,0,0,1,0,1,0.24166666666666667
功率效率,0,0,0,0,0,1,0,1,0.24166666666666667
硬件加速器,0,0,0,0,0,2,0,2,0.48333333333333334
dsp内核,0,0,0,0,0,2,0,2,0.48333333333333334
信号处,0,0,0,0,0,1,0,1,0.24166666666666667
wimax,0,0,1,1,0,3,0,5,0.975
hspa,0,0,0,0,0,1,0,1,0.24166666666666667
tdd,0,0,0,2,0,1,0,3,0.4916666666666667
fdd,0,0,0,3,0,1,0,4,0.6166666666666667
3g-lte,0,0,0,0,0,1,0,1,0.24166666666666667
芯片,0,0,0,0,0,2,0,2,0.48333333333333334
系统集成,0,0,0,0,0,1,0,1,0.24166666666666667
平台性能,0,0,0,0,0,1,0,1,0.24166666666666667
通信产业,0,0,1,0,0,1,0,2,0.3666666666666667
无线通信,0,0,3,1,0,3,0,7,1.225
高性能多核dsp平台,0,0,0,0,0,1,0,1,0.24166666666666667
指令流水线,0,0,0,0,0,1,0,1,0.24166666666666667
地址操,0,0,0,0,0,1,0,1,0.24166666666666667
硬件地址产生器,0,0,0,0,0,1,0,1,0.24166666666666667
硬件i/o,0,0,0,0,0,1,0,1,0.24166666666666667
中断处理,0,0,0,0,0,1,0,1,0.24166666666666667
指令,0,0,0,0,0,2,0,2,0.48333333333333334
总线,0,0,0,0,0,1,0,1,0.24166666666666667
加法,0,0,0,0,0,1,0,1,0.24166666666666667
乘法器,0,0,0,0,0,4,0,4,0.9666666666666667
数字信号处理算法,0,0,0,0,0,1,0,1,0.24166666666666667
数字信号处理器,0,0,0,0,0,2,0,2,0.48333333333333334
cachemisses,0,0,0,0,0,11,0,11,2.658333333333333
时间,0,0,1,1,0,11,1,14,3.15
agu,0,0,0,0,0,10,0,10,2.4166666666666665
timer探针,0,0,0,0,0,6,0,6,1.45
vcfr子模块,0,0,0,0,0,6,0,6,1.45
alu,0,0,0,0,0,7,0,7,1.6916666666666667
函数,0,0,0,0,0,17,0,17,4.108333333333333
模块,0,0,0,0,1,12,0,13,3.1416666666666666
32,0,0,0,0,0,5,0,5,1.2083333333333333
eftpe,0,0,0,0,0,43,0,43,10.391666666666667
代码,0,0,0,0,0,5,0,5,1.2083333333333333
timer,0,0,0,0,0,3,0,3,0.725
alu-agu,0,0,0,0,0,3,0,3,0.725
ddr3,0,0,0,0,0,3,0,3,0.725
ls模块,0,0,0,0,0,4,0,4,0.9666666666666667
vcfr信道,0,0,3,0,1,24,1,29,6.658333333333333
时延,0,0,0,0,5,2,0,7,1.6916666666666667
计时变量,0,0,0,0,0,2,0,2,0.48333333333333334
子模块,0,0,0,0,0,8,0,8,1.9333333333333333
负载,0,0,0,0,0,2,0,2,0.48333333333333334
dataread,0,0,0,0,0,2,0,2,0.48333333333333334
读数据,0,0,0,0,0,2,0,2,0.48333333333333334
存储空间,0,0,0,0,0,2,0,2,0.48333333333333334
存储指数表,0,0,0,0,0,2,0,2,0.48333333333333334
trace工具,0,0,0,0,0,2,0,2,0.48333333333333334
内核,0,0,0,0,0,11,0,11,2.658333333333333
cycle,0,0,0,0,0,2,0,2,0.48333333333333334
功能,0,0,0,0,0,2,0,2,0.48333333333333334
时域去噪操作,0,0,0,0,0,2,0,2,0.48333333333333334
功能耗时,0,0,0,0,0,1,0,1,0.24166666666666667
timer计时,0,0,0,0,0,1,0,1,0.24166666666666667
ec,0,0,0,0,0,1,0,1,0.24166666666666667
32mk,0,0,0,0,0,1,0,1,0.24166666666666667
fr,0,0,0,0,0,2,0,2,0.48333333333333334
u32microsec776,0,0,0,0,0,1,0,1,0.24166666666666667
fx,0,0,0,0,0,1,0,1,0.24166666666666667
timevcfr5,0,0,0,0,0,1,0,1,0.24166666666666667
ro,0,0,0,0,0,1,0,1,0.24166666666666667
qrtimevcfr,0,0,0,0,0,1,0,1,0.24166666666666667
u32mill,0,0,0,0,0,1,0,1,0.24166666666666667
con,0,0,0,0,0,1,0,1,0.24166666666666667
gu32,0,0,0,0,0,1,0,1,0.24166666666666667
timevcfr,0,0,0,0,0,1,0,1,0.24166666666666667
naoc,0,0,0,0,0,1,0,1,0.24166666666666667
u32microsec,0,0,0,0,0,1,0,1,0.24166666666666667
fmevc,0,0,0,0,0,1,0,1,0.24166666666666667
功能子模块,0,0,0,0,0,2,0,2,0.48333333333333334
纳秒,0,0,0,0,0,1,0,1,0.24166666666666667
计时器,0,0,0,0,0,1,0,1,0.24166666666666667
计时,0,0,0,0,0,1,0,1,0.24166666666666667
平均,0,0,0,0,0,1,0,1,0.24166666666666667
时间差,0,0,0,0,0,1,0,1,0.24166666666666667
等待,0,0,0,0,0,2,0,2,0.48333333333333334
信号量,0,0,0,0,0,4,0,4,0.9666666666666667
配置,0,0,0,0,0,1,0,1,0.24166666666666667
探针,0,0,0,0,0,1,0,1,0.24166666666666667
时间测试,0,0,0,0,0,1,0,1,0.24166666666666667
vcfr时间,0,0,0,0,0,1,0,1,0.24166666666666667
硬件平台,1,0,0,0,0,7,0,8,2.6916666666666664
maple-b2,0,0,0,0,0,15,0,15,3.625
组数据,0,0,0,0,0,1,0,1,0.24166666666666667
复数乘循环,0,0,0,0,0,1,0,1,0.24166666666666667
后代码,0,0,0,0,0,1,0,1,0.24166666666666667
球务侦,0,0,0,0,0,1,0,1,0.24166666666666667
eprlcop,0,0,0,0,0,1,0,1,0.24166666666666667
冬归,0,0,0,0,0,1,0,1,0.24166666666666667
循环内部代码,0,0,0,0,0,1,0,1,0.24166666666666667
数组,0,0,0,0,0,2,0,2,0.48333333333333334
循环,0,0,0,0,0,1,0,1,0.24166666666666667
ifft,0,0,0,0,1,3,0,4,0.9666666666666667
估计子模块,0,0,0,0,0,1,0,1,0.24166666666666667
cpu计算资源,0,0,0,0,0,1,0,1,0.24166666666666667
15ls信道,0,0,0,0,0,1,0,1,0.24166666666666667
ef,0,0,0,0,0,1,0,1,0.24166666666666667
ou,0,0,0,0,0,1,0,1,0.24166666666666667
ag,0,0,0,0,0,1,0,1,0.24166666666666667
ral,0,0,0,0,0,1,0,1,0.24166666666666667
agup,0,0,0,0,0,1,0,1,0.24166666666666667
dalucounter,0,0,0,0,0,1,0,1,0.24166666666666667
up,0,0,0,0,0,1,0,1,0.24166666666666667
执行效率,0,0,0,0,0,1,0,1,0.24166666666666667
地址产生单元,0,0,0,0,0,1,0,1,0.24166666666666667
运算逻辑单元,0,0,0,0,0,2,0,2,0.48333333333333334
优化,0,0,0,0,0,1,0,1,0.24166666666666667
cachemisses指数,0,0,0,0,0,1,0,1,0.24166666666666667
时间开销,0,0,0,0,0,1,0,1,0.24166666666666667
耗时,0,0,0,0,0,1,0,1,0.24166666666666667
oc,0,0,0,0,0,1,0,1,0.24166666666666667
ox,0,0,0,0,0,1,0,1,0.24166666666666667
复数乘法指令,0,0,0,0,0,1,0,1,0.24166666666666667
多字节操作指令,0,0,0,0,0,1,0,1,0.24166666666666667
存表法,0,0,0,0,0,1,0,1,0.24166666666666667
内存,0,0,0,0,0,2,0,2,0.48333333333333334
dma,0,0,0,0,0,5,0,5,1.2083333333333333
查表索引,0,0,0,0,0,1,0,1,0.24166666666666667
并存表,0,0,0,0,0,1,0,1,0.24166666666666667
基本,0,0,0,0,0,1,0,1,0.24166666666666667
定点化,1,0,2,0,0,10,0,13,3.6666666666666665
zc基本序列,0,0,0,0,0,2,0,2,0.48333333333333334
空间,0,0,1,0,0,1,0,2,0.3666666666666667
表大,0,0,0,0,0,1,0,1,0.24166666666666667
表存储,0,0,0,0,0,1,0,1,0.24166666666666667
代码时间,0,0,0,0,0,1,0,1,0.24166666666666667
cpu取数据,0,0,0,0,0,1,0,1,0.24166666666666667
读写,0,0,0,0,0,1,0,1,0.24166666666666667
cachemisses率,0,0,0,0,0,1,0,1,0.24166666666666667
uction,0,0,0,0,0,1,0,1,0.24166666666666667
datawrite,0,0,0,0,0,1,0,1,0.24166666666666667
柱状图,0,0,0,0,0,1,0,1,0.24166666666666667
cachemiss数据,0,0,0,0,0,1,0,1,0.24166666666666667
11,0,0,0,0,0,1,0,1,0.24166666666666667
cache分析工具,0,0,0,0,0,1,0,1,0.24166666666666667
命中率,0,0,0,0,0,1,0,1,0.24166666666666667
读数据cache,0,0,0,0,0,1,0,1,0.24166666666666667
连续性,0,0,0,0,0,1,0,1,0.24166666666666667
循环体,0,0,0,0,0,1,0,1,0.24166666666666667
shortsincos,0,0,0,0,0,1,0,1,0.24166666666666667
j32768,0,0,0,0,0,1,0,1,0.24166666666666667
基本单位,0,0,0,0,0,1,0,1,0.24166666666666667
dk,0,0,0,0,0,1,0,1,0.24166666666666667
取数据,0,0,0,0,0,1,0,1,0.24166666666666667
耗时分析,0,0,0,0,0,1,0,1,0.24166666666666667
enbrxchanestagcalc函数,0,0,0,0,0,1,0,1,0.24166666666666667
sxnadr,0,0,0,0,0,1,0,1,0.24166666666666667
iipi,0,0,0,0,0,1,0,1,0.24166666666666667
vxitsr,0,0,0,0,0,1,0,1,0.24166666666666667
si,0,0,0,0,0,1,0,1,0.24166666666666667
wi-iter,0,0,0,0,0,1,0,1,0.24166666666666667
iph,0,0,0,0,0,1,0,1,0.24166666666666667
感服,0,0,0,0,0,1,0,1,0.24166666666666667
sjafis,0,0,0,0,0,1,0,1,0.24166666666666667
压瘀,0,0,0,0,0,1,0,1,0.24166666666666667
内部时间,0,0,0,0,0,1,0,1,0.24166666666666667
基本zc序列,0,0,0,0,0,1,0,1,0.24166666666666667
tag,0,0,0,0,0,1,0,1,0.24166666666666667
分函数,0,0,0,0,0,1,0,1,0.24166666666666667
主频,0,0,0,0,0,1,0,1,0.24166666666666667
cycle数,0,0,0,0,0,1,0,1,0.24166666666666667
oa,0,0,0,0,0,1,0,1,0.24166666666666667
oo,0,0,0,0,0,1,0,1,0.24166666666666667
qfloatto,0,0,0,0,0,1,0,1,0.24166666666666667
qxc000,0,0,0,0,0,1,0,1,0.24166666666666667
qfmu,0,0,0,0,0,1,0,1,0.24166666666666667
qdiv32,0,0,0,0,0,1,0,1,0.24166666666666667
xcooolfs,0,0,0,0,0,1,0,1,0.24166666666666667
oxcoool,0,0,0,0,0,1,0,1,0.24166666666666667
xcdq,0,0,0,0,0,1,0,1,0.24166666666666667
dprogramsta,0,0,0,0,0,1,0,1,0.24166666666666667
ute,0,0,0,0,0,1,0,1,0.24166666666666667
cn,0,0,0,0,0,1,0,1,0.24166666666666667
ut,0,0,0,0,0,1,0,1,0.24166666666666667
总时间,0,0,0,0,0,1,0,1,0.24166666666666667
编译器,0,0,0,0,0,1,0,1,0.24166666666666667
代码分析,0,0,0,0,0,1,0,1,0.24166666666666667
codewarrior,0,0,0,0,0,3,0,3,0.725
ls估计模块,0,0,0,0,0,2,0,2,0.48333333333333334
cfr信道,0,0,0,0,1,2,0,3,0.725
对角阵,0,0,0,0,2,0,0,2,0.48333333333333334
真实信道模型,0,0,0,0,1,0,0,1,0.24166666666666667
hsvd,0,0,0,0,1,0,0,1,0.24166666666666667
勾似,0,0,0,0,1,0,0,1,0.24166666666666667
qsm,0,0,0,0,1,0,0,1,0.24166666666666667
酉矩阵,0,0,0,0,1,0,0,1,0.24166666666666667
天线,1,0,0,0,1,5,0,7,2.45
pusch,0,0,0,0,0,7,0,7,1.6916666666666667
符号级,0,0,0,0,0,3,0,3,0.725
解传输预编码,0,0,0,0,0,2,0,2,0.48333333333333334
符号,0,0,0,0,0,2,0,2,0.48333333333333334
链路,0,0,0,0,0,2,0,2,0.48333333333333334
功能模块,0,0,0,0,0,2,0,2,0.48333333333333334
pusch链路,0,0,0,0,0,2,0,2,0.48333333333333334
cqi\ri\ack译码,0,0,0,0,0,1,0,1,0.24166666666666667
解调解扰码,0,0,0,0,0,1,0,1,0.24166666666666667
码块解crc,0,0,0,0,0,1,0,1,0.24166666666666667
viterbi译码,0,0,0,0,0,1,0,1,0.24166666666666667
turbo译码,0,0,0,0,0,2,0,2,0.48333333333333334
解速率匹配,0,0,0,0,0,2,0,2,0.48333333333333334
去频偏,0,0,0,0,0,2,0,2,0.48333333333333334
去cp,0,0,0,0,0,1,0,1,0.24166666666666667
maple,0,0,0,0,0,3,0,3,0.725
用户,0,0,1,0,0,3,0,4,0.85
接收天线,0,0,0,0,0,1,0,1,0.24166666666666667
maple-b2协处理器,0,0,0,0,0,1,0,1,0.24166666666666667
双天线,0,0,0,0,0,1,0,1,0.24166666666666667
信道均衡模块,0,0,0,0,0,1,0,1,0.24166666666666667
链路级设,0,0,0,0,0,1,0,1,0.24166666666666667
多用户,0,0,0,0,0,1,0,1,0.24166666666666667
pusch接收,0,0,0,0,0,1,0,1,0.24166666666666667
多核任务,0,0,1,0,0,2,0,3,0.6083333333333334
usch,0,0,0,0,0,1,0,1,0.24166666666666667
比特级处理,0,0,0,0,0,1,0,1,0.24166666666666667
设备,0,0,0,0,0,1,0,1,0.24166666666666667
core2,0,0,0,0,0,1,0,1,0.24166666666666667
负载均衡原,0,0,0,0,0,1,0,1,0.24166666666666667
corel,0,0,0,0,0,1,0,1,0.24166666666666667
分配时,0,0,0,0,0,1,0,1,0.24166666666666667
接收处理链路框架,0,0,0,0,0,1,0,1,0.24166666666666667
复数,0,0,0,0,0,8,0,8,1.9333333333333333
频域窗函数,0,0,1,0,1,3,0,5,1.0916666666666668
定标,0,0,0,0,0,2,0,2,0.48333333333333334
小数点,0,0,0,0,0,1,0,1,0.24166666666666667
short类型,0,0,0,0,0,1,0,1,0.24166666666666667
虚部,0,0,0,0,0,2,0,2,0.48333333333333334
实部,0,0,0,0,0,1,0,1,0.24166666666666667
前端信号,0,0,0,0,0,1,0,1,0.24166666666666667
运算时间,0,0,0,0,0,1,0,1,0.24166666666666667
16位数,0,0,0,0,0,1,0,1,0.24166666666666667
要模块,0,0,0,0,0,1,0,1,0.24166666666666667
sc3850内核,0,0,0,0,0,1,0,1,0.24166666666666667
msc8157平台,0,0,1,0,0,4,0,5,1.0916666666666668
sl,0,0,0,0,0,1,0,1,0.24166666666666667
hvcfrs,0,0,0,0,0,1,0,1,0.24166666666666667
recipwinf,0,0,0,0,0,1,0,1,0.24166666666666667
变量变量,0,0,0,0,0,1,0,1,0.24166666666666667
精度,1,0,0,0,0,2,0,3,1.4833333333333334
溢出,0,0,0,0,0,2,0,2,0.48333333333333334
epa5hz,0,0,0,0,3,0,0,3,0.725
仿真条件,0,0,0,0,1,0,0,1,0.24166666666666667
线配,0,0,0,0,1,0,0,1,0.24166666666666667
收发天,0,0,0,0,1,0,0,1,0.24166666666666667
吞吐量指,0,0,0,0,1,0,0,1,0.24166666666666667
误块率,0,0,0,0,1,0,0,1,0.24166666666666667
次重传,0,0,0,0,1,0,0,1,0.24166666666666667
harq重传,0,0,0,0,1,0,0,1,0.24166666666666667
throughput指标,0,0,0,0,1,0,0,1,0.24166666666666667
oughput,0,0,0,0,1,0,0,1,0.24166666666666667
pusch接收性能,0,0,0,0,1,0,0,1,0.24166666666666667
2rx天线,0,0,0,0,1,0,0,1,0.24166666666666667
vcfr拓展信道,0,0,0,0,2,0,0,2,0.48333333333333334
dsp核,0,0,0,0,0,6,0,6,1.45
rb,0,0,0,3,0,6,0,9,1.825
中间临时全局数组,0,0,0,0,0,2,0,2,0.48333333333333334
pcetempdatal,0,0,0,0,0,2,0,2,0.48333333333333334
pchanestls,0,0,0,0,0,4,0,4,0.9666666666666667
消息模式,0,0,0,0,0,2,0,2,0.48333333333333334
dsp,0,0,0,0,0,4,0,4,0.9666666666666667
sc,0,0,0,0,0,2,0,2,0.48333333333333334
总点数,0,0,0,0,0,2,0,2,0.48333333333333334
vcfr数,0,0,0,0,0,2,0,2,0.48333333333333334
idft运算,0,0,1,0,0,3,0,4,0.85
时频域转换,0,0,0,0,0,2,0,2,0.48333333333333334
处理流程,0,0,0,0,0,2,0,2,0.48333333333333334
返回值,0,0,0,0,0,4,0,4,0.9666666666666667
pchanest,0,0,0,0,0,1,0,1,0.24166666666666667
pceteinpdata,0,0,0,0,0,1,0,1,0.24166666666666667
um,0,0,0,0,0,1,0,1,0.24166666666666667
控制信息,0,0,0,0,0,4,0,4,0.9666666666666667
pchanestvcfr,0,0,0,0,0,1,0,1,0.24166666666666667
pcetempdata2,0,0,0,0,0,1,0,1,0.24166666666666667
rbnum,0,0,0,0,0,1,0,1,0.24166666666666667
cha,0,0,0,0,0,2,0,2,0.48333333333333334
pus,0,0,0,0,0,2,0,2,0.48333333333333334
函数原型,0,0,0,0,0,4,0,4,0.9666666666666667
处理模块函数,0,0,0,0,0,1,0,1,0.24166666666666667
主函数,0,0,0,0,0,1,0,1,0.24166666666666667
dsp核资源,0,0,0,0,0,1,0,1,0.24166666666666667
消息收发处理,0,0,0,0,0,1,0,1,0.24166666666666667
消息机制,0,0,0,0,0,1,0,1,0.24166666666666667
运算速率,1,0,0,0,0,1,0,2,1.2416666666666667
调度,0,0,0,0,0,2,0,2,0.48333333333333334
强耦合性,0,0,0,0,0,1,0,1,0.24166666666666667
发消息,0,0,0,0,0,1,0,1,0.24166666666666667
控制,0,0,0,0,0,1,0,1,0.24166666666666667
返回数据,0,0,0,0,0,1,0,1,0.24166666666666667
等待状态,0,0,0,0,0,1,0,1,0.24166666666666667
信号量模,0,0,0,0,0,1,0,1,0.24166666666666667
numbersc,0,0,0,0,0,1,0,1,0.24166666666666667
子载波数目,0,0,0,0,0,1,0,1,0.24166666666666667
虚载波,0,0,0,0,0,1,0,1,0.24166666666666667
变比例,0,0,1,0,0,1,0,2,0.3666666666666667
协处理器,0,0,1,0,0,5,0,6,1.3333333333333333
点数,0,0,0,0,1,1,0,2,0.48333333333333334
rb占用,0,0,0,0,0,1,0,1,0.24166666666666667
比例,1,0,0,0,0,1,0,2,1.2416666666666667
eftpe模块,0,0,0,0,0,1,0,1,0.24166666666666667
门限,0,0,0,0,7,0,0,7,1.6916666666666667
等效cp长度,0,0,0,0,4,0,0,4,0.9666666666666667
噪声区域,0,0,0,0,5,0,0,5,1.2083333333333333
pan,0,0,0,0,3,0,0,3,0.725
噪声功率平均值,0,0,0,0,3,0,0,3,0.725
front区,0,0,0,0,2,0,0,2,0.48333333333333334
去噪门限,0,0,0,0,2,0,0,2,0.48333333333333334
去噪效果,0,0,0,0,3,0,0,3,0.725
front,0,0,0,0,2,0,0,2,0.48333333333333334
闭区间,0,0,0,0,2,0,0,2,0.48333333333333334
cir幅值响应,0,0,0,0,2,0,0,2,0.48333333333333334
rear区域,0,0,0,0,1,0,0,1,0.24166666666666667
js,0,0,0,0,1,0,0,1,0.24166666666666667
maxpower,0,0,0,0,1,0,0,1,0.24166666666666667
有效信号径数,0,0,0,0,1,0,0,1,0.24166666666666667
rearvalida,0,0,0,0,1,0,0,1,0.24166666666666667
rontvalida,0,0,0,0,1,0,0,1,0.24166666666666667
nvc,0,0,0,0,4,0,0,4,0.9666666666666667
qu,0,0,0,0,1,0,0,1,0.24166666666666667
取值范,0,0,0,0,1,0,0,1,0.24166666666666667
cir区域,0,0,0,0,1,0,0,1,0.24166666666666667
id,0,0,0,0,1,0,0,1,0.24166666666666667
wer,0,0,0,0,1,0,0,1,0.24166666666666667
max,0,0,0,0,1,0,0,1,0.24166666666666667
取值范围,0,0,0,0,1,0,0,1,0.24166666666666667
噪声功率,0,0,0,0,1,0,0,1,0.24166666666666667
噪声平均功率,0,0,0,0,1,0,0,1,0.24166666666666667
noisearea,0,0,0,0,1,0,0,1,0.24166666666666667
噪声段,0,0,0,0,1,0,0,1,0.24166666666666667
区域,0,0,0,0,1,0,0,1,0.24166666666666667
信道冲击响应长度,0,0,0,0,1,0,0,1,0.24166666666666667
等效cp,0,0,0,0,1,0,0,1,0.24166666666666667
去噪时,0,0,0,0,1,0,0,1,0.24166666666666667
效径,0,0,0,0,1,0,0,1,0.24166666666666667
蓝色虚线,0,0,0,0,1,0,0,1,0.24166666666666667
红色虚线代码,0,0,0,0,1,0,0,1,0.24166666666666667
hz,0,0,0,0,2,0,0,2,0.48333333333333334
延拓,0,0,0,0,1,0,0,1,0.24166666666666667
有效信道,0,0,0,0,1,0,0,1,0.24166666666666667
nirin,0,0,0,0,1,0,0,1,0.24166666666666667
cir径区域,0,0,0,0,1,0,0,1,0.24166666666666667
差异化门限,0,0,0,0,1,0,0,1,0.24166666666666667
信号区域,0,0,0,0,1,0,0,1,0.24166666666666667
多径数,0,0,0,0,1,0,0,1,0.24166666666666667
去噪性能,0,0,0,0,1,0,0,1,0.24166666666666667
噪声去除,0,0,0,0,1,0,0,1,0.24166666666666667
幅值,0,0,0,0,1,4,0,5,1.2083333333333333
时域去噪,0,0,0,0,1,0,0,1,0.24166666666666667
差异化门限去噪策略,0,0,0,0,1,0,1,2,0.48333333333333334
处理流程图,0,0,0,0,0,1,0,1,0.24166666666666667
接口,0,0,0,0,0,1,0,1,0.24166666666666667
调度函数,0,0,0,0,0,1,0,1,0.24166666666666667
接收,0,0,0,0,0,1,0,1,0.24166666666666667
vcfr模块,0,0,0,0,0,1,0,1,0.24166666666666667
可移植性,0,0,0,0,0,1,0,1,0.24166666666666667
帧结构,0,0,0,12,0,0,0,12,1.5
标准化,0,0,1,2,0,0,0,3,0.375
资源块,0,0,0,2,0,0,0,2,0.25
pusch带宽,0,0,0,1,0,0,0,1,0.125
频域资源,0,0,0,1,0,0,0,1,0.125
上行资源栅格,0,0,0,1,0,0,0,1,0.125
时间域,0,0,0,1,0,0,0,1,0.125
最小资源块,0,0,0,1,0,0,0,1,0.125
资源粒子,0,0,0,1,0,0,0,1,0.125
cp,0,0,0,1,1,0,0,2,0.3666666666666667
cp时,0,0,0,1,0,0,0,1,0.125
时频结构,0,0,0,1,0,0,0,1,0.125
资源,0,0,0,1,0,0,0,1,0.125
资源栅格,0,0,0,1,1,3,0,5,1.0916666666666668
上行传输资源块,0,0,0,1,0,0,0,1,0.125
matlab平台,0,0,0,0,0,4,0,4,0.9666666666666667
c平台,0,0,0,0,0,3,0,3,0.725
信道估计模块,0,0,0,0,0,2,0,2,0.48333333333333334
测试向量,0,0,0,0,0,2,0,2,0.48333333333333334
运算速度,0,0,0,0,0,1,0,1,0.24166666666666667
标记值,0,0,0,0,0,1,0,1,0.24166666666666667
matalb平台,0,0,0,0,0,1,0,1,0.24166666666666667
c实现平台,0,0,0,0,0,1,0,1,0.24166666666666667
子载波73,0,0,0,0,0,1,0,1,0.24166666666666667
msc-8157,0,0,0,0,0,1,0,1,0.24166666666666667
曲线,0,0,0,0,0,1,0,1,0.24166666666666667
十字点线,0,0,0,0,0,1,0,1,0.24166666666666667
集成开发,0,0,0,0,0,1,0,1,0.24166666666666667
星型点线,0,0,0,0,0,1,0,1,0.24166666666666667
硬件仿真,0,0,0,0,0,1,0,1,0.24166666666666667
c模块,0,0,0,0,0,1,0,1,0.24166666666666667
准确性,0,0,0,0,0,1,0,1,0.24166666666666667
dsp平台,0,0,0,0,0,2,0,2,0.48333333333333334
运算能力,0,0,0,0,0,2,0,2,0.48333333333333334
rm,0,0,0,0,0,1,0,1,0.24166666666666667
速率匹配,0,0,0,0,0,1,0,1,0.24166666666666667
turbo编译码,0,0,0,0,0,1,0,1,0.24166666666666667
fft运算,0,0,0,0,0,1,0,1,0.24166666666666667
crc校验,0,0,0,0,0,2,0,2,0.48333333333333334
功率,0,0,0,0,4,1,0,5,1.2083333333333333
多核dsp平台,0,0,3,0,0,2,1,6,1.1
上行接收,0,0,0,0,0,2,0,2,0.48333333333333334
密度,0,0,0,0,0,1,0,1,0.24166666666666667
比特级模块,0,0,0,0,0,1,0,1,0.24166666666666667
解资源映射,0,0,0,0,0,1,0,1,0.24166666666666667
上行接收处理,0,0,0,0,0,2,0,2,0.48333333333333334
基站侧,0,0,0,0,0,1,0,1,0.24166666666666667
基带处理运算,0,0,0,0,0,1,0,1,0.24166666666666667
处理吞吐能力,0,0,0,0,0,1,0,1,0.24166666666666667
处理器,0,0,0,0,0,1,0,1,0.24166666666666667
地址总线,0,0,0,0,0,1,0,1,0.24166666666666667
数据总线,0,0,0,0,0,1,0,1,0.24166666666666667
哈佛架构,0,0,0,0,0,1,0,1,0.24166666666666667
微处理器,0,0,0,0,0,1,0,1,0.24166666666666667
实时性数字信号处理,0,0,0,0,0,1,0,1,0.24166666666666667
多核dsp,0,0,0,0,0,1,0,1,0.24166666666666667
3glte,0,0,0,0,0,4,0,4,0.9666666666666667
译码,0,0,0,0,0,3,0,3,0.725
fft,0,0,0,0,1,3,1,5,1.2083333333333333
传输块,0,0,0,0,0,2,0,2,0.48333333333333334
优先级,0,0,0,0,0,2,0,2,0.48333333333333334
bufferdescriptor,0,0,0,0,0,2,0,2,0.48333333333333334
存储,0,0,0,0,0,2,0,2,0.48333333333333334
irc,0,0,0,0,0,1,0,1,0.24166666666666667
zf,0,0,0,0,0,1,0,1,0.24166666666666667
crcpe,0,0,0,0,0,1,0,1,0.24166666666666667
旋转,0,0,0,0,0,1,0,1,0.24166666666666667
相位,0,0,0,0,0,1,0,1,0.24166666666666667
保护边带,0,0,0,0,0,1,0,1,0.24166666666666667
输入数据,0,0,0,0,0,2,0,2,0.48333333333333334
ifft运算,0,0,0,0,0,1,0,1,0.24166666666666667
比特扰码,0,0,0,0,0,1,0,1,0.24166666666666667
fdd-lte,0,0,0,0,0,1,0,1,0.24166666666666667
crc,0,0,0,0,0,1,0,1,0.24166666666666667
单码块,0,0,0,0,0,1,0,1,0.24166666666666667
比特填充,0,0,0,0,0,1,0,1,0.24166666666666667
中码快crc,0,0,0,0,0,1,0,1,0.24166666666666667
3glte制,0,0,0,0,0,1,0,1,0.24166666666666667
处理速率,0,0,0,0,0,1,0,1,0.24166666666666667
信息比特编码,0,0,0,0,0,1,0,1,0.24166666666666667
umts系统,0,0,0,0,0,1,0,1,0.24166666666666667
ul-sch,0,0,0,0,0,1,0,1,0.24166666666666667
3getedl,0,0,0,0,0,1,0,1,0.24166666666666667
wimaxofdma,0,0,0,0,0,1,0,1,0.24166666666666667
turbo编码器,0,0,0,0,0,1,0,1,0.24166666666666667
硬比特校验,0,0,0,0,0,1,0,1,0.24166666666666667
crc检测,0,0,0,0,0,1,0,1,0.24166666666666667
终止触发条件,0,0,0,0,0,1,0,1,0.24166666666666667
linearlogmap,0,0,0,0,0,1,0,1,0.24166666666666667
maxlogmap,0,0,0,0,0,1,0,1,0.24166666666666667
解速率匹配函数,0,0,0,0,0,1,0,1,0.24166666666666667
编码,0,0,0,1,1,1,0,3,0.6083333333333334
码率,0,0,0,0,1,1,0,2,0.48333333333333334
双二进制编码,0,0,0,0,0,1,0,1,0.24166666666666667
二进制,0,0,0,0,0,1,0,1,0.24166666666666667
harq,0,0,0,2,0,1,0,3,0.4916666666666667
集成turbo译码,0,0,0,0,0,1,0,1,0.24166666666666667
3glte系统,0,0,0,0,0,1,0,1,0.24166666666666667
umts,0,0,0,0,0,1,0,1,0.24166666666666667
turbo译码器,0,0,0,0,1,1,0,2,0.48333333333333334
802.16m,0,0,0,0,0,1,0,1,0.24166666666666667
ieee802.16,0,0,0,0,0,1,0,1,0.24166666666666667
wimax模式,0,0,0,0,0,1,0,1,0.24166666666666667
umts标准,0,0,0,0,0,1,0,1,0.24166666666666667
3g模式,0,0,0,0,0,1,0,1,0.24166666666666667
高性能加速器,0,0,0,0,0,1,0,1,0.24166666666666667
加速器引擎,0,0,0,0,0,1,0,1,0.24166666666666667
硬件加速引擎,0,0,0,0,0,1,0,1,0.24166666666666667
循环仲裁,0,0,0,0,0,1,0,1,0.24166666666666667
时分复用,0,0,0,0,0,1,0,1,0.24166666666666667
先级,0,0,0,0,0,1,0,1,0.24166666666666667
dma通道,0,0,0,0,0,1,0,1,0.24166666666666667
ddr内存,0,0,0,0,0,1,0,1,0.24166666666666667
总内存,0,0,0,0,0,1,0,1,0.24166666666666667
控制器,0,0,0,0,0,1,0,1,0.24166666666666667
dma控制器,0,0,0,0,0,1,0,1,0.24166666666666667
双向通道,0,0,0,0,0,1,0,1,0.24166666666666667
32bit数据总线,0,0,0,0,0,1,0,1,0.24166666666666667
时钟主频,0,0,0,0,0,1,0,1,0.24166666666666667
ddr控制器,0,0,0,0,0,1,0,1,0.24166666666666667
512mddr3,0,0,0,0,0,1,0,1,0.24166666666666667
m3内存,0,0,0,0,0,1,0,1,0.24166666666666667
位宽,0,0,0,0,0,1,0,1,0.24166666666666667
l2缓存,0,0,0,0,0,1,0,1,0.24166666666666667
16位宽指令集,0,0,0,0,0,1,0,1,0.24166666666666667
aau,0,0,0,0,0,1,0,1,0.24166666666666667
地址运算单元,0,0,0,0,0,1,0,1,0.24166666666666667
生单元,0,0,0,0,0,1,0,1,0.24166666666666667
地址,0,0,0,0,0,2,0,2,0.48333333333333334
16x16,0,0,0,0,0,1,0,1,0.24166666666666667
it,0,0,0,0,0,1,0,1,0.24166666666666667
arithmeticandlogic,0,0,0,0,0,1,0,1,0.24166666666666667
dalu,0,0,0,0,0,1,0,1,0.24166666666666667
逻辑单元,0,0,0,0,0,1,0,1,0.24166666666666667
数据运算,0,0,0,0,0,1,0,1,0.24166666666666667
工作主频,0,0,0,0,0,1,0,1,0.24166666666666667
共享内存,0,0,0,0,0,1,0,1,0.24166666666666667
l2cache,0,0,0,0,0,1,0,1,0.24166666666666667
lldcache,0,0,0,0,0,1,0,1,0.24166666666666667
数据cache,0,0,0,0,0,1,0,1,0.24166666666666667
lhcache,0,0,0,0,0,1,0,1,0.24166666666666667
指令cache,0,0,0,0,0,1,0,1,0.24166666666666667
sc3850芯片,0,0,0,0,0,1,0,1,0.24166666666666667
sc3850dsp,0,0,0,0,0,1,0,1,0.24166666666666667
msc8157内核,0,0,0,0,0,1,0,1,0.24166666666666667
8157,0,0,0,0,0,2,0,2,0.48333333333333334
ram,0,0,0,0,0,1,0,1,0.24166666666666667
ck,0,0,0,0,0,1,0,1,0.24166666666666667
sc8157平台,0,0,0,0,0,1,0,1,0.24166666666666667
vcfr处理模块,0,0,0,0,0,2,0,2,0.48333333333333334
本地,0,0,0,0,0,3,0,3,0.725
hopping,0,0,0,0,0,2,0,2,0.48333333333333334
rs数据,0,0,0,0,0,1,0,1,0.24166666666666667
dmrs数据,0,0,0,0,0,1,0,1,0.24166666666666667
ls信道估计模块,0,0,0,0,0,1,0,1,0.24166666666666667
去vcfr,0,0,0,0,0,1,0,1,0.24166666666666667
频域去窗,0,0,0,0,0,1,0,1,0.24166666666666667
dft变换,0,0,0,0,2,2,0,4,0.9666666666666667
噪声去噪门限,0,0,0,0,0,1,0,1,0.24166666666666667
输入信号,0,0,0,0,0,1,0,1,0.24166666666666667
解调参考序列,0,0,0,0,0,1,0,1,0.24166666666666667
参考序列,0,0,0,0,0,1,0,1,0.24166666666666667
sequence,0,0,0,0,0,1,0,1,0.24166666666666667
小区,0,0,0,0,0,1,0,1,0.24166666666666667
本地解调参考信号,0,0,0,0,0,2,0,2,0.48333333333333334
型号,0,0,0,0,0,1,0,1,0.24166666666666667
本地解调,0,0,0,0,0,1,0,1,0.24166666666666667
幅度响应,0,0,0,0,1,0,0,1,0.24166666666666667
多径信道径数,0,0,0,0,1,0,0,1,0.24166666666666667
高斯白噪声,0,0,0,0,1,0,0,1,0.24166666666666667
离散型号,0,0,0,0,1,0,0,1,0.24166666666666667
发送端,0,0,0,0,1,0,0,1,0.24166666666666667
基本时间单元,0,0,0,0,1,0,0,1,0.24166666666666667
ute系统,0,0,0,0,1,0,0,1,0.24166666666666667
子载波间隔,0,0,0,1,1,0,0,2,0.3666666666666667
内容,0,0,0,0,1,0,0,1,0.24166666666666667
时间连续信号,0,0,0,0,1,0,0,1,0.24166666666666667
带宽配置,0,0,0,0,1,0,0,1,0.24166666666666667
isi,0,0,0,0,1,0,0,1,0.24166666666666667
多径传播,0,0,0,0,1,0,0,1,0.24166666666666667
cir长度,0,0,0,0,2,0,0,2,0.48333333333333334
估计算法,0,0,1,0,2,0,0,3,0.6083333333333334
nac,0,0,0,0,3,0,0,3,0.725
虚频域信道,0,0,1,0,4,0,0,5,1.0916666666666668
dft转换,0,0,0,0,2,0,0,2,0.48333333333333334
加窗,0,0,0,0,2,0,0,2,0.48333333333333334
幅值响应,0,0,0,0,2,0,0,2,0.48333333333333334
vcfr拓展过程,0,0,0,0,2,0,0,2,0.48333333333333334
去窗,0,0,0,0,1,0,0,1,0.24166666666666667
hdeno,0,0,0,0,1,0,0,1,0.24166666666666667
hdewin,0,0,0,0,1,0,0,1,0.24166666666666667
差异化去噪过程,0,0,0,0,1,0,0,1,0.24166666666666667
na,0,0,0,0,1,0,0,1,0.24166666666666667
去噪过程数学表,0,0,0,0,1,0,0,1,0.24166666666666667
时域去噪处理,1,0,0,0,1,0,0,2,1.2416666666666667
升余弦窗函数,1,0,1,0,1,0,0,3,1.3666666666666667
平滑滤波,0,0,0,0,1,0,0,1,0.24166666666666667
频域加窗处理,0,0,0,0,1,0,0,1,0.24166666666666667
虚子载波长度,0,0,0,0,1,0,0,1,0.24166666666666667
cfr长度,0,0,0,0,1,0,0,1,0.24166666666666667
cxp,0,0,0,0,1,0,0,1,0.24166666666666667
线性,0,0,0,0,1,0,0,1,0.24166666666666667
vcfr长度,0,0,0,0,1,0,0,1,0.24166666666666667
ls信道估计器,0,0,0,0,1,0,0,1,0.24166666666666667
vcfr信道估计,0,0,0,0,1,0,0,1,0.24166666666666667
本地导频信号,0,0,0,0,1,0,0,1,0.24166666666666667
差异去噪,0,0,0,0,6,0,0,6,1.45
hao窗,0,0,0,0,5,0,0,5,1.2083333333333333
mse性能,0,0,0,0,2,0,0,2,0.48333333333333334
etu5hz,0,0,0,0,2,0,0,2,0.48333333333333334
hao算法,0,0,0,0,2,0,0,2,0.48333333333333334
虚线,0,0,0,0,1,0,0,1,0.24166666666666667
实线,0,0,0,0,1,0,0,1,0.24166666666666667
倒三角形,0,0,0,0,1,0,0,1,0.24166666666666667
标注曲线,0,0,0,0,1,0,0,1,0.24166666666666667
黑色星形,0,0,0,0,1,0,0,1,0.24166666666666667
a5hz,0,0,0,0,1,0,0,1,0.24166666666666667
等效cp内径,0,0,0,0,1,0,0,1,0.24166666666666667
去噪策,0,0,0,0,1,0,0,1,0.24166666666666667
of-lmmse算法,0,0,0,0,1,0,0,1,0.24166666666666667
性噪比,0,0,0,0,1,0,0,1,0.24166666666666667
星形实线,0,0,0,0,1,0,0,1,0.24166666666666667
方形实线,0,0,0,0,1,0,0,1,0.24166666666666667
拓展信道,0,0,0,0,1,0,0,1,0.24166666666666667
黑色星形实线,0,0,0,0,1,0,0,1,0.24166666666666667
菱形虚线,0,0,0,0,1,0,0,1,0.24166666666666667
性能曲线,0,0,0,0,1,0,0,1,0.24166666666666667
绿色菱形线,0,0,0,0,1,0,0,1,0.24166666666666667
时损失,0,0,0,0,1,0,0,1,0.24166666666666667
过多噪声,0,0,0,0,1,0,0,1,0.24166666666666667
径径数,0,0,0,0,1,0,0,1,0.24166666666666667
多径径数,0,0,0,0,1,0,0,1,0.24166666666666667
目标径数,0,0,0,0,1,0,0,1,0.24166666666666667
多径时延,0,0,0,0,1,0,0,1,0.24166666666666667
etu信道,0,0,0,0,1,0,0,1,0.24166666666666667
mst径数,0,0,0,0,1,0,0,1,0.24166666666666667
vcfr改进算法,0,0,0,0,1,0,0,1,0.24166666666666667
均方误差,0,0,0,0,2,0,0,2,0.48333333333333334
自适应模式,0,0,0,0,0,8,0,8,1.9333333333333333
eftpebd,0,0,0,0,0,5,0,5,1.2083333333333333
缩放,0,0,0,0,0,3,0,3,0.725
缩放模式,0,0,0,0,0,3,0,3,0.725
数据结构,0,0,0,0,0,3,0,3,0.725
调整倍数,0,0,0,0,0,2,0,2,0.48333333333333334
倍数,0,0,0,0,0,2,0,2,0.48333333333333334
向下调整系数,0,0,0,0,0,2,0,2,0.48333333333333334
置位,0,0,0,0,0,2,0,2,0.48333333333333334
调整系数,0,0,0,0,0,2,0,2,0.48333333333333334
饱和,0,0,0,0,0,2,0,2,0.48333333333333334
起始位,0,0,0,0,0,2,0,2,0.48333333333333334
控制比特,0,0,0,0,0,2,0,2,0.48333333333333334
存储位,0,0,0,0,0,2,0,2,0.48333333333333334
内存地址,0,0,0,0,0,1,0,1,0.24166666666666667
bdjtat,0,0,0,0,0,1,0,1,0.24166666666666667
反馈回,0,0,0,0,0,1,0,1,0.24166666666666667
调整倍数反馈,0,0,0,0,0,1,0,1,0.24166666666666667
ova,0,0,0,0,0,1,0,1,0.24166666666666667
adp,0,0,0,0,0,1,0,1,0.24166666666666667
累积,0,0,0,0,0,1,0,1,0.24166666666666667
scljtype域,0,0,0,0,0,1,0,1,0.24166666666666667
后乘,0,0,0,0,0,1,0,1,0.24166666666666667
po_scl域,0,0,0,0,0,1,0,1,0.24166666666666667
pacscz域,0,0,0,0,0,1,0,1,0.24166666666666667
缩放因子,0,0,0,0,0,1,0,1,0.24166666666666667
蝶形运算,0,0,0,0,0,1,0,1,0.24166666666666667
sclo,0,0,0,0,0,1,0,1,0.24166666666666667
usrj,0,0,0,0,0,1,0,1,0.24166666666666667
pojcl,0,0,0,0,0,1,0,1,0.24166666666666667
pmscl,0,0,0,0,0,1,0,1,0.24166666666666667
sclx,0,0,0,0,0,1,0,1,0.24166666666666667
usr,0,0,0,0,0,1,0,1,0.24166666666666667
scltype,0,0,0,0,0,1,0,1,0.24166666666666667
运算结果,0,0,0,0,0,1,0,1,0.24166666666666667
向下缩放,0,0,0,0,0,1,0,1,0.24166666666666667
dft运算,0,0,0,0,0,1,0,1,0.24166666666666667
dft点,0,0,0,0,0,1,0,1,0.24166666666666667
eftpe系数调整模式,0,0,0,0,0,1,0,1,0.24166666666666667
缩放结,0,0,0,0,0,1,0,1,0.24166666666666667
缩放值,0,0,0,0,0,1,0,1,0.24166666666666667
调整指数,0,0,0,0,0,1,0,1,0.24166666666666667
自适应缩放模式,0,0,0,0,0,1,0,1,0.24166666666666667
总缩放量,0,0,0,0,0,1,0,1,0.24166666666666667
自适应缩放,0,0,0,0,0,1,0,1,0.24166666666666667
用户缩放,0,0,0,0,0,1,0,1,0.24166666666666667
幅值缩放模式,0,0,0,0,0,1,0,1,0.24166666666666667
缩放调整,0,0,0,0,0,1,0,1,0.24166666666666667
内部幅值,0,0,0,0,0,1,0,1,0.24166666666666667
oba字段,0,0,0,0,0,1,0,1,0.24166666666666667
系统内存,0,0,0,0,0,1,0,1,0.24166666666666667
eftpe数据,0,0,0,0,0,1,0,1,0.24166666666666667
复数点,0,0,0,0,0,1,0,1,0.24166666666666667
输入,0,0,0,0,0,1,0,1,0.24166666666666667
数据符号模式,0,0,0,0,0,1,0,1,0.24166666666666667
处理数据,0,0,0,0,0,1,0,1,0.24166666666666667
存储位置,0,0,0,0,0,1,0,1,0.24166666666666667
存储区域,0,0,0,0,0,1,0,1,0.24166666666666667
dft反变换,0,0,0,0,0,1,0,1,0.24166666666666667
guardband,0,0,0,0,0,1,0,1,0.24166666666666667
快速傅里叶变换,0,0,0,0,0,1,0,1,0.24166666666666667
变换域去噪,0,0,0,0,0,1,0,1,0.24166666666666667
操作模式,0,0,0,0,0,1,0,1,0.24166666666666667
展信道估计算法,0,0,0,0,0,1,0,1,0.24166666666666667
idft运算能力,0,0,0,0,0,1,0,1,0.24166666666666667
dft/,0,0,0,0,0,2,0,2,0.48333333333333334
ms,0,0,0,0,0,1,0,1,0.24166666666666667
sc8157eftpe,0,0,0,0,0,1,0,1,0.24166666666666667
主控核,0,0,0,0,0,1,0,1,0.24166666666666667
pucch,0,0,0,0,0,1,0,1,0.24166666666666667
prach,0,0,0,0,0,1,0,1,0.24166666666666667
sounding处理,0,0,0,0,0,1,0,1,0.24166666666666667
共享信道,0,0,0,0,0,1,0,1,0.24166666666666667
dsp片,0,0,0,0,0,1,0,1,0.24166666666666667
均衡,0,0,0,0,0,1,0,1,0.24166666666666667
多核负载,0,0,0,0,0,1,0,1,0.24166666666666667
处理效率,0,0,0,0,0,1,0,1,0.24166666666666667
上行接收链路天线,0,0,0,0,0,1,0,1,0.24166666666666667
上下行链路,0,0,0,0,0,1,0,1,0.24166666666666667
物理层,0,0,0,0,0,1,0,1,0.24166666666666667
msc8157芯片,0,0,0,0,0,1,0,1,0.24166666666666667
多核设计,0,0,0,0,0,1,0,1,0.24166666666666667
拓展信道估计算法,0,0,0,0,1,0,0,1,0.24166666666666667
实数窗函数,0,0,0,0,1,0,0,1,0.24166666666666667
bler,0,0,0,0,1,0,0,1,0.24166666666666667
泄露,0,0,0,0,1,0,0,1,0.24166666666666667
vp,0,0,0,0,1,0,0,1,0.24166666666666667
虚导频,0,0,0,0,1,0,0,1,0.24166666666666667
去除边缘效应,0,0,0,0,1,0,0,1,0.24166666666666667
有效信息径,0,0,0,0,1,0,0,1,0.24166666666666667
cir信道,0,0,0,0,1,0,0,1,0.24166666666666667
边界效应,1,0,0,0,0,0,3,4,1.725
msc8157dsp平台,1,0,0,0,0,0,1,2,1.2416666666666667
msc8157dsp,0,0,0,0,0,0,1,1,0.24166666666666667
快速f-lmmse算法,0,0,0,0,0,0,1,1,0.24166666666666667
简化算法,0,0,1,0,1,0,1,3,0.6083333333333334
vcfr拓展信道估计算法,0,0,0,0,0,0,1,1,0.24166666666666667
频域平滑窗函数,0,0,0,0,0,0,1,1,0.24166666666666667
lmmse准则信道,0,0,0,0,0,0,1,1,0.24166666666666667
抗噪声能力,0,0,0,0,1,0,1,2,0.48333333333333334
lte上行导频,0,0,0,0,0,0,1,1,0.24166666666666667
无线通信系统,0,0,3,0,0,0,1,4,0.6166666666666667
移动通信,0,0,1,0,0,0,1,2,0.3666666666666667
lte上行信道,0,0,1,0,0,0,1,2,0.3666666666666667
td-lte专网无线系统,0,0,0,0,0,0,1,1,0.24166666666666667
信道噪声,0,0,0,0,1,0,0,1,0.24166666666666667
响应值,0,0,0,0,1,0,0,1,0.24166666666666667
高信噪比,0,0,2,0,2,0,0,4,0.7333333333333334
先验信息,0,0,0,0,1,0,0,1,0.24166666666666667
噪声干扰,0,0,0,0,1,0,0,1,0.24166666666666667
估计值,0,0,0,0,2,0,0,2,0.48333333333333334
信道响应,0,0,0,0,1,0,0,1,0.24166666666666667
发端数据,0,0,0,0,1,0,0,1,0.24166666666666667
上行接收侧信号,0,0,0,0,1,0,0,1,0.24166666666666667
最小方差准,0,0,0,0,1,0,0,1,0.24166666666666667
c语言,0,0,2,0,0,0,0,2,0.25
信道估计性能,0,0,2,0,1,0,0,3,0.4916666666666667
定点化运算,0,0,1,0,0,0,0,1,0.125
lmmse信道估计算法,0,0,1,0,0,0,0,1,0.125
ls准则,0,0,1,0,0,0,0,1,0.125
物理层导频设,0,0,1,0,0,0,0,1,0.125
快速lmmse信道估计算法,0,0,1,0,0,0,0,1,0.125
统计信道信息,0,0,1,0,0,0,0,1,0.125
mmse信道估计算法,0,0,1,0,0,0,0,1,0.125
信道估计处理效率,0,0,1,0,0,0,0,1,0.125
时频域,0,0,1,0,0,0,0,1,0.125
性能验证,0,0,1,0,0,0,0,1,0.125
能量损失,0,0,1,0,0,0,0,1,0.125
差异化去噪,0,0,1,0,0,0,0,1,0.125
有效径分布区,0,0,1,0,0,0,0,1,0.125
有效径分布,0,0,1,0,0,0,0,1,0.125
时域信道冲击,0,0,1,0,0,0,0,1,0.125
时域冲击响应,0,0,1,0,0,0,0,1,0.125
dft类信道估计算法,0,0,1,0,0,0,0,1,0.125
统计特性,0,0,1,0,0,0,0,1,0.125
移动通信服务,0,0,0,3,0,0,0,3,0.375
数据传输效率,0,0,0,2,0,0,0,2,0.25
无线通信技术,0,0,0,2,0,0,0,2,0.25
dfts-ofdm,0,0,0,1,0,0,0,1,0.125
mimo,0,0,0,1,0,0,0,1,0.125
多输入输出,0,0,0,1,0,0,0,1,0.125
正交频分复用技术,0,0,0,1,0,0,0,1,0.125
数据传输业务,0,0,0,1,0,0,0,1,0.125
4g,0,0,0,1,0,0,0,1,0.125
移动通信技术,0,0,1,1,0,0,0,2,0.25
结构体,0,0,0,0,0,6,0,6,1.45
控制结构体,0,0,0,0,0,4,0,4,0.9666666666666667
指针,0,0,0,0,0,3,0,3,0.725
小区级控制信息,0,0,0,0,0,2,0,2,0.48333333333333334
ns时隙号,0,0,0,0,0,2,0,2,0.48333333333333334
pusch数据,0,0,0,0,0,2,0,2,0.48333333333333334
结构类型,0,0,0,0,0,2,0,2,0.48333333333333334
ncs,0,0,0,0,0,2,0,2,0.48333333333333334
pncsout,0,0,0,0,0,2,0,2,0.48333333333333334
计算函数,0,0,0,0,0,2,0,2,0.48333333333333334
poutputdmrs,0,0,0,0,0,2,0,2,0.48333333333333334
dmrs2,0,0,0,0,0,1,0,1,0.24166666666666667
ndmrs2,0,0,0,0,0,1,0,1,0.24166666666666667
dmrsj,0,0,0,0,0,1,0,1,0.24166666666666667
ndmrsl,0,0,0,0,0,1,0,1,0.24166666666666667
cellld小区,0,0,0,0,0,1,0,1,0.24166666666666667
ulcptypecp类型,0,0,0,0,0,1,0,1,0.24166666666666667
序列跳频,0,0,0,0,0,1,0,1,0.24166666666666667
ulseqhoppingflag,0,0,0,0,0,1,0,1,0.24166666666666667
组跳频,0,0,0,0,0,1,0,1,0.24166666666666667
seqgroup,0,0,0,0,0,1,0,1,0.24166666666666667
序列移位图,0,0,0,0,0,1,0,1,0.24166666666666667
循环移位参数,0,0,0,0,0,1,0,1,0.24166666666666667
ndmrslndex,0,0,0,0,0,1,0,1,0.24166666666666667
上行带宽,0,0,0,0,0,1,0,1,0.24166666666666667
bandwidthindex,0,0,0,0,0,1,0,1,0.24166666666666667
inputncs,0,0,0,0,0,1,0,1,0.24166666666666667
总rb数,0,0,0,0,0,1,0,1,0.24166666666666667
rbniim,0,0,0,0,0,1,0,1,0.24166666666666667
rbstartposion,0,0,0,0,0,1,0,1,0.24166666666666667
loclnfb,0,0,0,0,0,1,0,1,0.24166666666666667
pu,0,0,0,0,0,1,0,1,0.24166666666666667
用户控制信息,0,0,0,0,0,1,0,1,0.24166666666666667
用户级控制信息,0,0,0,0,0,1,0,1,0.24166666666666667
控制结构,0,0,0,0,0,1,0,1,0.24166666666666667
函数设计,0,0,0,0,0,1,0,1,0.24166666666666667
瑜岀参数,0,0,0,0,0,1,0,1,0.24166666666666667
rs符号位数,0,0,0,0,0,1,0,1,0.24166666666666667
plnput,0,0,0,0,0,1,0,1,0.24166666666666667
本地zc序列,0,0,0,0,0,1,0,1,0.24166666666666667
ci,0,0,0,0,0,1,0,1,0.24166666666666667
信息控制结构,0,0,0,0,0,1,0,1,0.24166666666666667
ls估计算,0,0,0,0,1,1,0,2,0.48333333333333334
pz,0,0,0,0,0,1,0,1,0.24166666666666667
ll,0,0,0,0,0,1,0,1,0.24166666666666667
ls计算函数,0,0,0,0,0,1,0,1,0.24166666666666667
strupuschcellinfo,0,0,0,0,0,1,0,1,0.24166666666666667
cellln,0,0,0,0,0,1,0,1,0.24166666666666667
ppus,0,0,0,0,0,1,0,1,0.24166666666666667
内循环移位参,0,0,0,0,0,1,0,1,0.24166666666666667
ns时隙,0,0,0,0,0,1,0,1,0.24166666666666667
gold码序列,0,0,0,0,0,1,0,1,0.24166666666666667
ncs计算函数,0,0,0,0,0,1,0,1,0.24166666666666667
参考序列数组,0,0,0,0,0,1,0,1,0.24166666666666667
探测,0,0,0,0,0,1,0,1,0.24166666666666667
ncs数组,0,0,0,0,0,1,0,1,0.24166666666666667
p!nputncs,0,0,0,0,0,1,0,1,0.24166666666666667
cellinfo,0,0,0,0,0,1,0,1,0.24166666666666667
hn,0,0,0,0,0,1,0,1,0.24166666666666667
pinputncs,0,0,0,0,0,1,0,1,0.24166666666666667
子函数,0,0,0,0,0,1,0,1,0.24166666666666667
zc序列复数乘法,0,0,0,0,0,1,0,1,0.24166666666666667
内循环移位,0,0,0,0,0,1,0,1,0.24166666666666667
时隙m,0,0,0,0,0,1,0,1,0.24166666666666667
ls估计子模块,0,0,0,0,0,1,0,1,0.24166666666666667
同步,0,0,0,3,0,0,0,3,0.375
harqchase,0,0,0,2,0,0,0,2,0.25
帧长,0,0,0,2,0,0,0,2,0.25
802,0,0,0,2,0,0,0,2,0.25
宽带无线接入技术,0,0,0,1,0,0,0,1,0.125
宽带无线系统,0,0,0,1,0,0,0,1,0.125
系统带宽,0,0,0,1,0,0,0,1,0.125
umts技术,0,0,0,1,0,0,0,1,0.125
ieeewimax,0,0,0,1,0,0,0,1,0.125
终端功耗,0,0,0,1,0,0,0,1,0.125
开放接口,0,0,0,1,0,0,0,1,0.125
网络架构,0,0,0,1,0,0,0,1,0.125
频谱资源,0,0,0,1,0,0,0,1,0.125
业务,0,0,0,1,0,0,0,1,0.125
通信,0,0,0,1,0,0,0,1,0.125
b3g系统,0,0,0,1,0,0,0,1,0.125
异步,0,0,0,1,0,0,0,1,0.125
外部时空,0,0,0,1,0,0,0,1,0.125
ha,0,0,0,1,0,0,0,1,0.125
上行同步,0,0,0,1,0,0,0,1,0.125
卜行自适应,0,0,0,1,0,0,0,1,0.125
增量冗余,0,0,0,1,0,0,0,1,0.125
增量冗,0,0,0,1,0,0,0,1,0.125
卷积码,0,0,0,1,0,0,0,1,0.125
turbo码,0,0,0,1,0,0,0,1,0.125
ldpc码,0,0,0,1,0,0,0,1,0.125
卷积turbo码,0,0,0,1,0,0,0,1,0.125
块turbo码,0,0,0,1,0,0,0,1,0.125
级联码,0,0,0,1,0,0,0,1,0.125
卷积,0,0,0,1,1,0,0,2,0.3666666666666667
am,0,0,0,1,1,0,0,2,0.3666666666666667
6q,0,0,0,1,0,0,0,1,0.125
64qam,0,0,0,1,0,0,0,1,0.125
bpsk,0,0,0,1,0,0,0,1,0.125
下行子帧,0,0,0,1,0,0,0,1,0.125
上行子帧,0,0,0,1,0,0,0,1,0.125
tdd模式,0,0,0,2,0,0,0,2,0.25
半双工fdd,0,0,0,1,0,0,0,1,0.125
双工,0,0,0,2,0,0,0,2,0.25
多址技术,0,0,0,1,0,0,0,1,0.125
16,0,0,0,1,0,0,0,1,0.125
gpplte,0,0,0,1,0,0,0,1,0.125
2lte系统,0,0,0,1,0,0,0,1,0.125
仿真参数,0,0,0,0,2,0,0,2,0.48333333333333334
eva信道模型,0,0,0,0,2,0,0,2,0.48333333333333334
衰落,0,0,0,0,2,0,0,2,0.48333333333333334
etu信道模型,0,0,0,0,2,0,0,2,0.48333333333333334
epa,0,0,0,0,2,0,0,2,0.48333333333333334
etu,0,0,0,0,3,0,0,3,0.725
仿真子帧数,0,0,0,0,1,0,0,1,0.24166666666666667
urbo,0,0,0,0,1,0,0,1,0.24166666666666667
子帧符号,0,0,0,0,1,0,0,1,0.24166666666666667
时隙导频符号,0,0,0,0,1,0,0,1,0.24166666666666667
仿真值,0,0,0,0,1,0,0,1,0.24166666666666667
各径衰,0,0,0,0,1,0,0,1,0.24166666666666667
3epa信道模型,0,0,0,0,1,0,0,1,0.24166666666666667
epa信道模型,0,0,0,0,1,0,0,1,0.24166666666666667
车辆模型,0,0,0,0,1,0,0,1,0.24166666666666667
城市模型,0,0,0,0,4,0,0,4,0.9666666666666667
行人模型,0,0,0,0,1,0,0,1,0.24166666666666667
eva模型,0,0,0,0,1,0,0,1,0.24166666666666667
vcfr性能,0,0,0,0,1,0,0,1,0.24166666666666667
仿真模型,0,0,0,0,1,0,0,1,0.24166666666666667
raw-ber指标,0,0,0,0,3,0,0,3,0.725
raw-ber,0,0,0,0,2,0,0,2,0.48333333333333334
多普勒频移信道,0,0,0,0,1,0,0,1,0.24166666666666667
raw-ber性能,0,0,0,0,1,0,0,1,0.24166666666666667
-ber,0,0,0,0,1,0,0,1,0.24166666666666667
解调输出比特,0,0,0,0,1,0,0,1,0.24166666666666667
有效长度,0,0,0,0,3,0,0,3,0.725
频域时域频域,0,0,0,0,2,0,0,2,0.48333333333333334
有效信号径,0,0,0,0,2,0,0,2,0.48333333333333334
噪声方差,0,0,0,0,1,0,0,1,0.24166666666666667
ctyvz,0,0,0,0,1,0,0,1,0.24166666666666667
门限值,0,0,0,0,1,0,0,1,0.24166666666666667
去噪门限值,0,0,0,0,1,0,0,1,0.24166666666666667
时域噪声区域,0,0,0,0,1,0,0,1,0.24166666666666667
信号噪声估计器,0,0,0,0,1,0,0,1,0.24166666666666667
位置信道,0,0,0,0,1,0,0,1,0.24166666666666667
estimation,0,0,0,0,1,0,0,1,0.24166666666666667
均方误差指标,0,0,0,0,1,0,0,1,0.24166666666666667
估计,0,0,0,0,1,0,0,1,0.24166666666666667
计性能,0,0,0,0,1,0,0,1,0.24166666666666667
保护间隔,0,0,0,0,1,0,0,1,0.24166666666666667
延续长度,0,0,0,0,1,0,0,1,0.24166666666666667
持续时间,0,0,0,0,1,0,0,1,0.24166666666666667
符号周期,0,0,0,0,1,0,0,1,0.24166666666666667
dft变换域去噪算法,0,0,0,0,1,0,0,1,0.24166666666666667
mst,0,0,0,0,2,0,0,2,0.48333333333333334
重要信号径,0,0,0,0,1,0,0,1,0.24166666666666667
径幅值,0,0,0,0,1,0,0,1,0.24166666666666667
低信噪比信道,0,0,0,0,1,0,0,1,0.24166666666666667
抗噪声干扰能力,0,0,0,0,1,0,0,1,0.24166666666666667
cdma,0,0,4,0,0,0,0,4,0.5
容量,0,0,3,0,0,0,0,3,0.375
数据传输速率,1,0,2,0,0,0,0,3,1.25
传输速率,0,0,2,0,0,0,0,2,0.25
数据通信业务,0,0,2,0,0,0,0,2,0.25
2g系统,0,0,2,0,0,0,0,2,0.25
保密性,0,0,2,0,0,0,0,2,0.25
多址,0,0,2,0,0,0,0,2,0.25
蜂窝网,0,0,2,0,0,0,0,2,0.25
通信系统,0,0,1,0,0,0,0,1,0.125
td-lte无线通信系统,0,0,1,0,0,0,0,1,0.125
专网系统,0,0,1,0,0,0,0,1,0.125
公网,0,0,1,0,0,0,0,1,0.125
移动终端制造业,0,0,1,0,0,0,0,1,0.125
通信设备制造商,0,0,1,0,0,0,0,1,0.125
芯片制造商,0,0,1,0,0,0,0,1,0.125
td-lte牌照,0,0,1,0,0,0,0,1,0.125
lte移动通信系统,0,0,1,0,0,0,0,1,0.125
联通,0,0,1,0,0,0,0,1,0.125
电信,0,0,1,0,0,0,0,1,0.125
移动,0,0,1,0,0,0,0,1,0.125
工信部,0,0,1,0,0,0,0,1,0.125
吉比特,0,0,1,0,0,0,0,1,0.125
移动系统,0,0,1,0,0,0,0,1,0.125
4g技,0,0,1,0,0,0,0,1,0.125
itu,0,0,1,0,0,0,0,1,0.125
移动无线接入,0,0,1,0,0,0,0,1,0.125
移动通信宽带化,0,0,1,0,0,0,0,1,0.125
多用户处理能力,0,0,1,0,0,0,0,1,0.125
全漫游,0,0,1,0,0,0,0,1,0.125
公用频段,0,0,1,0,0,0,0,1,0.125
全球漫游,0,0,1,0,0,0,0,1,0.125
3g无线通信系统,0,0,1,0,0,0,0,1,0.125
td-scdma,0,0,1,0,0,0,0,1,0.125
cdma2000,0,0,1,0,0,0,0,1,0.125
wcdma,0,0,1,0,0,0,0,1,0.125
imt-2000,0,0,1,0,0,0,0,1,0.125
多址接入,0,0,1,0,0,0,0,1,0.125
plltu-2000,0,0,1,0,0,0,0,1,0.125
视频,0,0,1,0,0,0,0,1,0.125
慢速图像,0,0,1,0,0,0,0,1,0.125
高速速率,0,0,1,0,0,0,0,1,0.125
宽带通信业务,0,0,1,0,0,0,0,1,0.125
3g,0,0,1,0,0,0,0,1,0.125
数据业务传输,0,0,1,0,0,0,0,1,0.125
gprs/edge,0,0,1,0,0,0,0,1,0.125
数据通信,0,0,1,0,0,0,0,1,0.125
话音移动通信,0,0,1,0,0,0,0,1,0.125
无线接入,0,0,1,0,0,0,0,1,0.125
用户容量,0,0,1,0,0,0,0,1,0.125
正交码,0,0,1,0,0,0,0,1,0.125
分集,0,0,1,0,0,0,0,1,0.125
地址码,0,0,1,0,0,0,0,1,0.125
cdma系统,0,0,1,0,0,0,0,1,0.125
数字蜂窝网络,0,0,1,0,0,0,0,1,0.125
is-95,0,0,1,0,0,0,0,1,0.125
自适应语音编码技,0,0,1,0,0,0,0,1,0.125
gsm系统,0,0,1,0,0,0,0,1,0.125
tdma,0,0,1,0,0,0,0,1,0.125
gsm,0,0,1,0,0,0,0,1,0.125
移动通信标准,0,0,1,0,0,0,0,1,0.125
全球移动通信系统,0,0,1,0,0,0,0,1,0.125
is-95og,0,0,1,0,0,0,0,1,0.125
数字时代,0,0,1,0,0,0,0,1,0.125
模拟时代,0,0,1,0,0,0,0,1,0.125
2g时代,0,0,1,0,0,0,0,1,0.125
网络结,0,0,1,0,0,0,0,1,0.125
频率复用,0,0,1,0,0,0,0,1,0.125
尔实验,0,0,1,0,0,0,0,1,0.125
大区制,0,0,1,0,0,0,0,1,0.125
1g系统,0,0,1,0,0,0,0,1,0.125
微电子技术,0,0,1,0,0,0,0,1,0.125
频分多址,0,0,1,0,0,0,0,1,0.125
模拟移动通信系统,0,0,1,0,0,0,0,1,0.125
移动通信时代,0,0,1,0,0,0,0,1,0.125
模拟移动无线电系统,0,0,1,0,0,0,0,1,0.125
无线电通信纪元,0,0,1,0,0,0,0,1,0.125
无线电报,0,0,1,0,0,0,0,1,0.125
马可尼,0,0,1,0,0,0,0,1,0.125
q矩阵,0,0,0,0,6,0,0,6,1.45
求逆,0,0,0,0,1,0,0,1,0.24166666666666667
多径信道功率,0,0,0,0,1,0,0,1,0.24166666666666667
16qam,0,0,0,0,1,0,0,1,0.24166666666666667
常数,0,0,0,0,2,0,0,2,0.48333333333333334
沢冲,0,0,0,0,1,0,0,1,0.24166666666666667
噪声方,0,0,0,0,1,0,0,1,0.24166666666666667
h点数,0,0,0,0,1,0,0,1,0.24166666666666667
lmmse准则,0,0,0,0,1,0,0,1,0.24166666666666667
lte帧结构,0,0,0,2,0,0,0,2,0.25
上下行传输资源,0,0,0,1,0,0,0,1,0.125
上下行子帧配比,0,0,0,1,0,0,0,1,0.125
tdd系统,0,0,0,1,0,0,0,1,0.125
tdd模,0,0,0,1,0,0,0,1,0.125
上下行传输,0,0,0,1,0,0,0,1,0.125
下行,0,0,0,1,0,0,0,1,0.125
fdd模式,0,0,0,1,0,0,0,1,0.125
无线帧,0,0,0,1,0,0,0,1,0.125
时间时间,0,0,0,1,0,0,0,1,0.125
mst径,0,0,0,0,4,0,0,4,0.9666666666666667
循环矩阵,0,0,0,0,2,0,0,2,0.48333333333333334
f-lmmse算,0,0,0,0,1,0,0,1,0.24166666666666667
snr门限,0,0,0,0,1,0,0,1,0.24166666666666667
mm,0,0,0,0,1,0,0,1,0.24166666666666667
性能退化,0,0,0,0,1,0,0,1,0.24166666666666667
大rb,0,0,0,0,1,0,0,1,0.24166666666666667
时域肌,0,0,0,0,1,0,0,1,0.24166666666666667
频域向量,0,0,0,0,1,0,0,1,0.24166666666666667
hls矩阵,0,0,0,0,1,0,0,1,0.24166666666666667
矩阵乘法,0,0,0,0,1,0,0,1,0.24166666666666667
复数加法,0,0,0,0,1,0,0,1,0.24166666666666667
复'数,0,0,0,0,1,0,0,1,0.24166666666666667
hu,0,0,0,0,1,0,0,1,0.24166666666666667
求逆矩阵,0,0,0,0,1,0,0,1,0.24166666666666667
-lmmse,0,0,0,0,1,0,0,1,0.24166666666666667
移位,0,0,0,0,1,0,0,1,0.24166666666666667
mst径功率,0,0,0,0,1,0,0,1,0.24166666666666667
向量,0,0,0,0,1,0,0,1,0.24166666666666667
pmst,0,0,0,0,1,0,0,1,0.24166666666666667
径勒,0,0,0,0,1,0,0,1,0.24166666666666667
rhh特征值,0,0,0,0,1,0,0,1,0.24166666666666667
rhh矩阵,0,0,0,0,1,0,0,1,0.24166666666666667
信道估计改进算法,0,0,0,0,0,1,0,1,0.24166666666666667
时间效率,0,0,0,0,0,1,0,1,0.24166666666666667
大表读写,0,0,0,0,0,1,0,1,0.24166666666666667
ls估计操作,0,0,0,0,0,1,0,1,0.24166666666666667
pusch接收链路,0,0,0,0,0,1,0,1,0.24166666666666667
自动幅值调整,0,0,0,0,0,1,0,1,0.24166666666666667
无线通信协议,0,0,0,0,0,1,0,1,0.24166666666666667
运算能,0,0,0,0,0,1,0,1,0.24166666666666667
基带信号,0,0,0,0,0,1,0,1,0.24166666666666667
基站侧无线通信系统,0,0,0,0,0,1,0,1,0.24166666666666667
TD-LTE,0,1,0,0,0,0,0,1,2.0
冲激响应拓展,0,1,0,0,0,0,0,1,2.0
多核DSP,0,1,0,0,0,0,0,1,2.0
双收,1,0,0,0,0,0,0,1,1.0
多核任务分配,1,0,0,0,0,0,0,1,1.0
处理时间,1,0,0,0,0,0,0,1,1.0
实验测试,1,0,0,0,0,0,0,1,1.0
lmmse估计,1,0,0,0,0,0,0,1,1.0
虚信道冲激响应,1,0,0,0,0,0,0,1,1.0
性能提升,1,0,0,0,0,0,0,1,1.0
时隙结构,1,0,0,0,0,0,0,1,1.0
接收侧,1,0,0,0,0,0,0,1,1.0
数据传输能力,1,0,0,0,0,0,0,1,1.0
移动互联网技术,1,0,0,0,0,0,0,1,1.0
移动终端,1,0,0,0,0,0,0,1,1.0
应用,1,0,0,0,0,0,0,1,1.0
新业务,1,0,0,0,0,0,0,1,1.0
