,摘要,关键词,第一章,第二章,第三章,第四章,第五章,总词频,加权得分
基站,2,0,10,55,26,25,4,122,23.416666666666664
视距信号,0,0,4,0,0,0,0,4,0.5
单基站,8,1,15,16,3,11,3,57,17.983333333333334
定位精度,3,0,10,8,0,5,3,29,7.183333333333334
视距,0,0,4,5,2,1,0,12,1.85
定位,8,0,29,25,7,6,3,78,18.616666666666667
参数,2,0,5,4,13,4,0,28,7.233333333333333
信号,1,0,8,20,20,25,0,74,15.375
虚拟基站,1,0,5,0,0,15,1,22,5.491666666666667
距离,0,0,4,5,7,6,0,22,4.266666666666667
pdr,1,0,4,0,0,13,1,19,4.883333333333333
nlos基站,0,0,4,0,2,4,0,10,1.95
pdr约束,1,0,3,0,0,6,1,11,3.0666666666666664
接收模型,0,0,3,0,5,0,0,8,1.5833333333333333
频域信号,0,0,3,0,1,0,0,4,0.6166666666666667
角度,1,0,3,8,11,16,2,41,9.383333333333333
远近场角度时延估计算法,0,0,2,0,1,0,0,3,0.4916666666666667
遮挡物,0,0,2,0,0,0,0,2,0.25
非视距,1,0,7,2,1,6,0,17,3.8166666666666664
定位终端,0,0,2,0,0,0,0,2,0.25
时延,1,0,2,6,19,18,2,48,11.425
5g网络,2,0,12,9,3,0,3,29,6.075
定位服务,1,0,4,5,4,2,0,16,3.575
终端,0,0,4,32,17,26,2,81,15.375
全球卫星导航系统,0,0,3,0,0,0,1,4,0.6166666666666667
亚米,0,0,1,0,0,1,0,2,0.3666666666666667
非视距环境,0,0,1,0,0,0,1,2,0.3666666666666667
加权定位,0,0,1,0,0,0,0,1,0.125
识别,0,0,1,0,0,0,0,1,0.125
仿真实,0,0,1,0,0,0,0,1,0.125
位置,1,0,2,0,0,2,2,7,2.216666666666667
nlos,0,0,2,0,0,20,0,22,5.083333333333333
二次加权,1,0,2,0,0,0,0,3,1.25
移动速度矢量,0,0,1,0,0,0,0,1,0.125
冗余信息,0,0,2,0,0,0,0,2,0.25
nlos路径,0,0,1,0,0,10,0,11,2.5416666666666665
解算,0,0,1,0,0,0,0,1,0.125
路径参数,0,0,1,0,0,0,0,1,0.125
nlos信号,0,0,1,0,0,13,0,14,3.2666666666666666
los信号路径,0,0,1,0,0,0,0,1,0.125
nlos信号路径,0,0,1,0,0,0,0,1,0.125
建筑平面结构,0,0,2,0,0,0,0,2,0.25
误差点,0,0,1,0,0,1,0,2,0.3666666666666667
时延参数,0,0,1,0,3,4,0,8,1.8166666666666667
聚类算法,0,0,3,0,0,5,0,8,1.5833333333333333
dbscan,0,0,1,0,0,2,0,3,0.6083333333333334
角度时延数据集,0,0,1,0,0,0,0,1,0.125
非视距环,0,0,1,0,0,0,0,1,0.125
估计精度,0,0,1,0,0,0,0,1,0.125
近场,0,0,1,4,2,0,0,7,1.1083333333333334
时延估计,3,0,3,0,5,0,1,12,4.825
远近场角度,1,0,3,0,5,0,1,10,2.825
仿真,0,0,3,0,4,7,2,16,3.5166666666666666
时域信号,0,0,2,0,2,0,0,4,0.7333333333333334
远场时延,0,0,1,0,0,0,0,1,0.125
混合阶,1,0,2,0,4,0,1,8,2.458333333333333
传输模型,0,0,1,0,0,0,0,1,0.125
时域,0,0,1,0,11,0,1,13,3.025
频谱搜索,1,0,1,0,0,0,0,2,1.125
角度时延估计算,0,0,1,0,0,0,0,1,0.125
复杂度,0,0,1,1,10,0,0,12,2.6666666666666665
响应时间,0,0,1,0,2,0,0,3,0.6083333333333334
视距基站,1,0,4,5,4,0,2,16,3.575
波形,0,0,1,1,0,0,0,2,0.25
定位架构,0,0,2,0,5,1,1,9,1.9416666666666667
5g波束,0,0,1,0,3,0,0,4,0.85
参数量,0,0,1,0,0,0,0,1,0.125
空旷区,0,0,1,0,0,0,0,1,0.125
遮挡,0,0,1,0,0,0,0,1,0.125
室内场所,0,0,1,0,0,0,0,1,0.125
地下停车场,0,0,1,1,0,0,0,2,0.25
城市拐角,0,0,1,0,0,0,0,1,0.125
室外,0,0,1,1,0,0,0,2,0.25
公园,0,0,1,0,0,0,0,1,0.125
体育场,0,0,1,1,0,0,0,2,0.25
环境复杂度,0,0,1,0,0,0,0,1,0.125
定位能力,0,0,2,2,0,0,0,4,0.5
定位算法,0,0,1,0,0,1,1,3,0.6083333333333334
阵列孔径,0,0,1,0,2,0,0,3,0.6083333333333334
天线阵元,0,0,1,4,4,1,0,10,1.8333333333333333
定位性能,1,0,8,0,0,0,2,11,2.4833333333333334
非视距基站,0,0,1,1,0,0,2,4,0.7333333333333334
测量,0,0,1,0,1,0,0,2,0.3666666666666667
基站信号,0,0,1,8,2,2,0,13,2.091666666666667
多基站定位算法,0,0,2,0,0,0,0,2,0.25
定位信号源,0,0,1,0,0,0,0,1,0.125
超密集网络,0,0,5,3,3,0,1,12,1.9666666666666668
定位技术,1,0,7,7,0,0,0,15,2.75
数据传输速率,0,0,1,0,0,0,0,1,0.125
时空连接,0,0,1,0,0,0,0,1,0.125
智慧城市,1,0,1,0,0,0,0,2,1.125
无线医疗,0,0,1,0,0,0,0,1,0.125
智能制造,0,0,1,0,0,0,0,1,0.125
车辆网,0,0,1,0,0,0,0,1,0.125
新位置服务,0,0,1,0,0,0,0,1,0.125
性能,0,0,2,1,3,0,0,6,1.1
服务等级,0,0,1,0,0,0,0,1,0.125
接收信号,0,0,1,1,7,1,0,10,2.1833333333333336
卫星信号,0,0,2,0,0,0,0,2,0.25
位置服务,1,0,5,0,0,0,3,9,2.35
gps,0,0,1,0,0,0,0,1,0.125
北斗,0,0,2,0,0,0,0,2,0.25
单基站定位,1,0,4,5,3,1,1,15,3.333333333333333
通导融合,0,0,2,2,2,0,0,6,0.9833333333333334
角度时延估计,0,1,1,0,0,0,0,2,2.125
基站覆盖,0,0,1,1,0,0,0,2,0.25
5g网络技术,0,0,1,0,0,0,0,1,0.125
数据集,0,0,0,0,0,4,0,4,0.9666666666666667
minpt,0,0,0,0,0,3,0,3,0.725
半径参数,0,0,0,0,0,3,0,3,0.725
干扰点,0,0,1,0,0,4,1,6,1.3333333333333333
组数,0,0,0,0,0,3,0,3,0.725
反射次数,0,0,0,0,0,6,0,6,1.45
聚类,0,0,1,0,0,3,1,5,1.0916666666666668
集合,0,0,0,0,0,2,0,2,0.48333333333333334
visited,0,0,0,0,0,2,0,2,0.48333333333333334
密度阈值,0,0,0,0,0,2,0,2,0.48333333333333334
密度,0,0,0,2,0,2,0,4,0.7333333333333334
中心点,0,0,0,0,0,2,0,2,0.48333333333333334
数据点,0,0,0,0,0,2,0,2,0.48333333333333334
k-means算法,0,0,0,0,0,2,0,2,0.48333333333333334
样本数据集,0,0,0,0,0,2,0,2,0.48333333333333334
传输距离,0,0,0,1,1,5,0,7,1.575
反射,1,0,0,1,0,15,0,17,4.75
聚烁,0,0,0,0,0,1,0,1,0.24166666666666667
噪声干扰点,0,0,0,0,0,1,0,1,0.24166666666666667
聚类效,0,0,0,0,0,1,0,1,0.24166666666666667
nlos误差点,0,0,0,0,0,1,0,1,0.24166666666666667
角度参数,0,0,0,2,2,4,0,8,1.7
site,0,0,0,0,0,1,0,1,0.24166666666666667
噪声,0,0,0,1,1,1,0,3,0.6083333333333334
s啲噸域,0,0,0,0,0,1,0,1,0.24166666666666667
vi,0,0,0,0,0,1,0,1,0.24166666666666667
对象集合,0,0,0,0,0,1,0,1,0.24166666666666667
数据对,0,0,0,0,0,1,0,1,0.24166666666666667
时延样本数据集,0,0,0,0,0,1,0,1,0.24166666666666667
分类算法,0,0,0,0,0,1,0,1,0.24166666666666667
数据偏移量,0,0,0,0,0,1,0,1,0.24166666666666667
测量误差,0,0,0,0,0,1,0,1,0.24166666666666667
真实数据,0,0,0,0,0,1,0,1,0.24166666666666667
角度误差,0,0,0,0,0,2,0,2,0.48333333333333334
时延误差,0,0,0,0,0,1,0,1,0.24166666666666667
实验仿真,0,0,0,0,4,1,0,5,1.2083333333333333
数据量,0,0,0,0,0,1,0,1,0.24166666666666667
minpts,0,0,0,0,0,1,0,1,0.24166666666666667
dbscan算法,0,0,0,0,0,1,0,1,0.24166666666666667
偏离反射区,0,0,0,0,0,1,0,1,0.24166666666666667
聚类结果,0,0,0,0,0,1,0,1,0.24166666666666667
路径,1,0,2,0,0,2,0,5,1.7333333333333334
初始点,0,0,0,0,0,1,0,1,0.24166666666666667
位置坐标,0,0,1,5,0,3,0,9,1.475
欧式距离,0,0,0,0,0,2,0,2,0.48333333333333334
误差反射点,0,0,0,0,0,1,0,1,0.24166666666666667
分类,0,0,0,0,0,1,0,1,0.24166666666666667
无标签数据,0,0,0,0,0,1,0,1,0.24166666666666667
分布,0,0,0,0,0,1,0,1,0.24166666666666667
反射体,0,0,0,0,0,12,0,12,2.9
场景定位模型,0,0,0,0,0,2,0,2,0.48333333333333334
参数聚类,0,0,0,0,0,1,0,1,0.24166666666666667
los基站,0,0,0,0,12,1,0,13,3.1416666666666666
数据,1,0,0,2,2,0,0,5,1.7333333333333334
music算法,0,0,0,0,7,0,0,7,1.6916666666666667
高阶,0,0,0,0,1,0,0,1,0.24166666666666667
esprit-like算法,0,0,0,0,10,0,0,10,2.4166666666666665
远近场角,0,0,0,0,1,0,0,1,0.24166666666666667
远场,0,0,0,3,6,0,0,9,1.825
频域,0,0,0,0,9,0,0,9,2.175
远近场,1,1,2,0,5,0,1,10,4.7
指向性,0,0,0,0,1,0,0,1,0.24166666666666667
波束,2,0,0,6,12,3,1,24,6.616666666666667
mec网,0,0,0,0,1,0,0,1,0.24166666666666667
角度时延估计算法,0,0,0,0,1,0,0,1,0.24166666666666667
远近场模型,0,0,0,0,1,0,0,1,0.24166666666666667
空旷,0,0,0,0,1,0,0,1,0.24166666666666667
lmf,0,0,0,0,6,0,0,6,1.45
amf,0,0,0,0,5,0,0,5,1.2083333333333333
授权,0,0,0,0,4,0,0,4,0.9666666666666667
mec网元,0,0,0,0,3,0,0,3,0.725
udm,0,0,0,0,3,0,0,3,0.725
定位请求,0,0,0,0,3,0,0,3,0.725
ng-ran,0,0,0,0,3,0,0,3,0.725
ue,0,0,0,0,3,0,0,3,0.725
5g定位架构,1,0,0,0,3,0,0,4,1.725
mec,0,0,0,0,2,0,0,2,0.48333333333333334
响应,0,0,0,0,3,0,0,3,0.725
复杂场景,0,0,0,0,2,0,0,2,0.48333333333333334
波束定位,0,0,0,0,1,0,0,1,0.24166666666666667
用户,0,0,0,0,1,0,0,1,0.24166666666666667
无线信道资源,0,0,0,0,1,0,0,1,0.24166666666666667
mec网关,0,0,0,0,1,0,0,1,0.24166666666666667
网络拥塞,0,0,0,0,1,0,0,1,0.24166666666666667
定位服务请求,0,0,0,0,1,1,0,2,0.48333333333333334
信道资源,0,0,0,0,1,0,0,1,0.24166666666666667
资源占用,0,0,0,0,1,0,0,1,0.24166666666666667
密集网络,0,0,0,0,1,0,0,1,0.24166666666666667
广播控制信道,0,0,0,0,1,0,0,1,0.24166666666666667
时间效率,0,0,0,0,1,0,0,1,0.24166666666666667
空旷环境,0,0,0,0,1,0,0,1,0.24166666666666667
波束成形,1,0,2,3,3,1,0,10,2.591666666666667
移动云计算服务器,0,0,0,0,1,0,0,1,0.24166666666666667
历史轨迹,0,0,0,0,1,0,0,1,0.24166666666666667
定位结果,0,0,0,0,2,0,0,2,0.48333333333333334
加密存储,0,0,0,0,1,0,0,1,0.24166666666666667
定位过,0,0,0,0,1,0,0,1,0.24166666666666667
lcs服务,0,0,0,0,1,0,0,1,0.24166666666666667
amf响应,0,0,0,0,1,0,0,1,0.24166666666666667
cellid,0,0,0,0,1,0,0,1,0.24166666666666667
基站波束,0,0,0,0,1,0,0,1,0.24166666666666667
lmf网元,0,0,0,0,1,0,0,1,0.24166666666666667
天线单元,0,0,0,1,1,0,0,2,0.3666666666666667
隐私,0,0,0,0,1,0,0,1,0.24166666666666667
精度,0,0,2,4,1,0,1,8,1.2333333333333334
lcs定位服务,0,0,0,0,1,0,0,1,0.24166666666666667
amf网元,0,0,0,0,1,0,0,1,0.24166666666666667
过程,0,0,0,0,1,0,0,1,0.24166666666666667
定位单基站,0,0,0,1,1,0,0,2,0.3666666666666667
终端p,0,0,0,0,1,0,0,1,0.24166666666666667
波束定位架构,0,0,0,0,1,0,0,1,0.24166666666666667
云计算服务,0,0,0,0,1,0,0,1,0.24166666666666667
超密集组网,0,0,0,2,1,0,0,3,0.4916666666666667
移动边缘云服务器,0,0,0,0,1,0,0,1,0.24166666666666667
mobileedgecloud,0,0,0,0,1,0,0,1,0.24166666666666667
ng-enb,0,0,0,0,1,0,0,1,0.24166666666666667
gnb,0,0,0,0,1,0,0,1,0.24166666666666667
节点,0,0,2,0,1,0,0,3,0.4916666666666667
5g无线接入网,0,0,0,0,1,0,0,1,0.24166666666666667
radioaccessnetwork,0,0,0,0,1,0,0,1,0.24166666666666667
nextgeneration,0,0,0,0,1,0,0,1,0.24166666666666667
授权信息,0,0,0,0,1,0,0,1,0.24166666666666667
隐私设置,0,0,0,0,1,0,0,1,0.24166666666666667
存储网,0,0,0,0,1,0,0,1,0.24166666666666667
数据管理,0,0,0,0,1,0,0,1,0.24166666666666667
unifieddatamanagement,0,0,0,0,1,0,0,1,0.24166666666666667
辅助定位数据,0,0,0,0,1,0,0,1,0.24166666666666667
上行链路,0,0,0,0,1,0,0,1,0.24166666666666667
下行,0,0,0,0,1,0,0,1,0.24166666666666667
核心网,0,0,0,0,1,0,0,1,0.24166666666666667
定位管理功能,0,0,0,0,1,0,0,1,0.24166666666666667
locationmanagementfunction,0,0,0,0,1,0,0,1,0.24166666666666667
定位消息,0,0,0,0,1,0,0,1,0.24166666666666667
移动性管理功能,0,0,0,0,1,0,0,1,0.24166666666666667
接入,0,0,0,1,1,0,0,2,0.3666666666666667
accessandmobilitymanagementfunction,0,0,0,0,1,0,0,1,0.24166666666666667
核心网元,0,0,0,0,1,0,0,1,0.24166666666666667
udn网络,0,0,0,0,1,0,0,1,0.24166666666666667
最优基站,0,0,0,0,1,0,0,1,0.24166666666666667
定位误差,0,0,1,4,2,3,0,10,1.8333333333333333
toa信息,0,0,0,0,1,0,0,1,0.24166666666666667
aoa,0,0,5,2,1,0,0,8,1.1166666666666667
基站a,0,0,0,0,1,0,0,1,0.24166666666666667
非视距盲区,0,0,0,0,1,0,0,1,0.24166666666666667
遮挡终端,0,0,0,0,1,0,0,1,0.24166666666666667
空旷场,0,0,0,0,1,0,0,1,0.24166666666666667
视距路径,0,0,1,2,1,0,1,5,0.8583333333333334
空旷场景,0,0,1,0,1,1,1,4,0.85
场景,0,0,0,1,1,0,0,2,0.3666666666666667
子载波,0,0,1,0,4,0,0,5,1.0916666666666668
阵元,0,0,0,0,12,0,0,12,2.9
远场信号,0,0,0,0,16,0,0,16,3.8666666666666667
扩展信道,0,0,0,0,4,0,0,4,0.9666666666666667
频域响应,0,0,0,0,3,0,0,3,0.725
信道,0,0,0,5,3,0,0,8,1.35
个阵元,0,0,0,0,2,0,0,2,0.48333333333333334
观测区间,0,0,0,0,2,0,0,2,0.48333333333333334
空间相位差,0,0,0,0,2,0,0,2,0.48333333333333334
信号参数,0,0,2,1,4,1,0,8,1.5833333333333333
虚拟带宽,0,0,0,0,1,0,0,1,0.24166666666666667
频域响应矩阵,0,0,0,0,1,0,0,1,0.24166666666666667
切附师,0,0,0,0,1,0,0,1,0.24166666666666667
频率响应,0,0,0,0,2,0,0,2,0.48333333333333334
加性高斯白噪声,0,0,0,0,3,0,0,3,0.725
功率,0,0,0,5,2,0,0,7,1.1083333333333334
均值,0,0,0,0,1,0,0,1,0.24166666666666667
耳丿,0,0,0,0,1,0,0,1,0.24166666666666667
子载波间隔,0,0,0,0,1,0,0,1,0.24166666666666667
载波频率,0,0,0,1,2,0,0,3,0.6083333333333334
傅里叶变换,0,0,0,0,1,0,0,1,0.24166666666666667
冲激响应,0,0,0,0,1,0,0,1,0.24166666666666667
ofdm系统,0,0,0,0,1,0,0,1,0.24166666666666667
信道冲激响应,0,0,0,0,1,0,0,1,0.24166666666666667
传输衰减系数,0,0,0,0,1,0,0,1,0.24166666666666667
传输时延,0,0,0,1,1,0,0,2,0.3666666666666667
单位冲激响应,0,0,0,0,1,0,0,1,0.24166666666666667
相对时延,0,0,0,0,1,0,0,1,0.24166666666666667
阵列单元,0,0,0,4,5,0,0,9,1.7083333333333333
中远场模型,0,0,0,0,1,0,0,1,0.24166666666666667
频带效率,0,0,0,0,1,0,0,1,0.24166666666666667
5g通信,0,0,0,0,1,0,0,1,0.24166666666666667
ofdm,0,0,0,0,1,0,0,1,0.24166666666666667
正交频分复用技术,0,0,0,0,1,0,0,1,0.24166666666666667
相移,0,0,0,0,1,0,0,1,0.24166666666666667
时间,0,0,0,3,1,0,0,4,0.6166666666666667
距离参数,0,0,0,1,6,1,0,8,1.8166666666666667
天线,0,0,0,14,1,0,0,15,1.9916666666666667
频域接收模型,1,0,0,0,3,0,0,4,1.725
连接,0,0,0,0,1,0,0,1,0.24166666666666667
云端,0,0,0,0,1,0,0,1,0.24166666666666667
通信信号,0,0,0,0,1,0,0,1,0.24166666666666667
定位信号,0,0,0,0,1,0,0,1,0.24166666666666667
基站节点,1,0,2,1,1,0,0,5,1.6166666666666667
超密集组网技术,1,0,1,4,1,0,0,7,1.8666666666666667
5g,0,0,6,3,2,0,0,11,1.6083333333333334
毫米波技术,0,0,0,1,0,0,0,1,0.125
大规模天线技术,1,0,1,6,0,0,0,8,1.875
5g组网技术,1,0,1,2,0,0,0,4,1.375
15g组网,0,0,0,1,0,0,0,1,0.125
全向天线,0,0,0,0,2,0,0,2,0.48333333333333334
排布,0,0,0,0,2,0,0,2,0.48333333333333334
波束成形天线,0,0,0,0,2,0,0,2,0.48333333333333334
概率,0,0,0,4,2,1,0,7,1.225
定位系统,0,0,1,1,2,0,0,4,0.7333333333333334
参考信号,0,0,0,0,2,0,0,2,0.48333333333333334
小区,0,0,1,0,2,0,0,3,0.6083333333333334
服务小区,0,0,0,0,2,0,0,2,0.48333333333333334
5gmassivemim0,0,0,0,0,1,0,0,1,0.24166666666666667
3d波束,0,0,0,0,1,0,0,1,0.24166666666666667
性质,0,0,0,0,1,0,0,1,0.24166666666666667
5gmassivemimo,0,0,0,0,1,0,0,1,0.24166666666666667
波束密度,0,0,0,1,1,0,0,2,0.3666666666666667
4g网络,0,0,0,0,1,0,0,1,0.24166666666666667
线性,0,0,0,0,1,0,0,1,0.24166666666666667
数据传输信号,0,0,0,0,1,0,0,1,0.24166666666666667
4gmim0波束成形天线,0,0,0,0,1,0,0,1,0.24166666666666667
控制信道,0,0,0,0,1,0,0,1,0.24166666666666667
公共导频,0,0,0,0,1,0,0,1,0.24166666666666667
广播信号,0,0,0,0,1,0,0,1,0.24166666666666667
同步信号,0,0,0,0,1,0,0,1,0.24166666666666667
增益,0,0,0,3,1,1,0,5,0.8583333333333334
4gmim0,0,0,0,0,1,0,0,1,0.24166666666666667
4g波束,0,0,0,0,1,0,0,1,0.24166666666666667
大规模天线,1,0,3,5,2,1,0,12,2.725
天线波束,0,0,0,0,1,0,0,1,0.24166666666666667
5gnr,0,0,0,0,1,0,0,1,0.24166666666666667
toa,0,0,5,5,6,0,0,16,2.7
定位请求信号,0,0,0,0,1,2,0,3,0.725
toa值,0,0,0,1,1,0,0,2,0.3666666666666667
坐标,0,0,1,5,1,7,0,14,2.6833333333333336
噪声干扰,0,0,0,0,1,0,0,1,0.24166666666666667
信号衰减,0,0,0,0,1,0,0,1,0.24166666666666667
障碍物,0,0,0,1,1,5,0,7,1.575
传播路径,0,0,0,0,1,3,0,4,0.9666666666666667
多径nlos信号,0,0,0,0,1,0,0,1,0.24166666666666667
触发条件,0,0,0,0,1,0,0,1,0.24166666666666667
负载,0,0,0,0,1,0,0,1,0.24166666666666667
rsrq,0,0,0,0,1,0,0,1,0.24166666666666667
接收质量,0,0,0,0,1,0,0,1,0.24166666666666667
rsrp,0,0,0,0,1,0,0,1,0.24166666666666667
接收功率测量值,0,0,0,0,1,0,0,1,0.24166666666666667
eutran,0,0,0,0,1,0,0,1,0.24166666666666667
通信系统,0,0,0,2,1,0,0,3,0.4916666666666667
15g波束成形,0,0,0,0,1,0,0,1,0.24166666666666667
直线,0,0,0,0,0,7,0,7,1.6916666666666667
误差区域,0,0,0,0,0,2,0,2,0.48333333333333334
直射径信号,0,0,0,0,0,3,0,3,0.725
受遮挡,0,0,0,0,0,2,0,2,0.48333333333333334
主径,0,0,0,0,0,2,0,2,0.48333333333333334
信号簇,0,0,0,0,0,2,0,2,0.48333333333333334
传播模型,0,0,0,0,0,3,0,3,0.725
衰减,0,0,0,2,0,1,0,3,0.4916666666666667
能量值,0,0,0,0,0,1,0,1,0.24166666666666667
反射损耗系数,0,0,0,0,0,1,0,1,0.24166666666666667
建筑材料,0,0,0,0,0,1,0,1,0.24166666666666667
损耗,0,0,0,0,0,1,0,1,0.24166666666666667
建筑平面结构图,0,0,0,0,0,1,0,1,0.24166666666666667
坐标系,0,0,0,0,0,1,0,1,0.24166666666666667
nlos环境,0,0,0,0,0,1,0,1,0.24166666666666667
多径,1,0,0,0,0,1,0,2,1.2416666666666667
大规模天线阵列,1,0,0,2,2,2,0,7,2.216666666666667
光速,0,0,0,2,0,1,0,3,0.4916666666666667
传播距离,0,0,0,1,0,1,0,2,0.3666666666666667
上行信号,0,0,0,0,0,1,0,1,0.24166666666666667
干扰,0,0,0,1,0,1,0,2,0.3666666666666667
环境因素,0,0,0,0,0,1,0,1,0.24166666666666667
菱形区域,0,0,0,0,0,1,0,1,0.24166666666666667
反射区域,0,0,0,0,0,1,0,1,0.24166666666666667
圆形,0,0,0,0,0,1,0,1,0.24166666666666667
用户终端,0,0,0,0,0,1,0,1,0.24166666666666667
聚集性,0,0,0,0,0,1,0,1,0.24166666666666667
半径,0,0,0,1,0,1,0,2,0.3666666666666667
墙面反射,0,0,0,0,0,1,0,1,0.24166666666666667
nlos传播模型,0,0,0,0,0,2,0,2,0.48333333333333334
反射路径,0,0,0,0,0,1,0,1,0.24166666666666667
散射体,0,0,0,0,0,2,0,2,0.48333333333333334
dp,0,0,0,0,0,1,0,1,0.24166666666666667
nlos多径信号,0,0,0,0,0,1,0,1,0.24166666666666667
穿透能力,0,0,0,0,0,1,0,1,0.24166666666666667
路径损耗,0,0,1,2,0,1,0,4,0.6166666666666667
毫米波,1,0,2,8,0,1,0,12,2.4916666666666667
异构组网架构,0,0,0,0,0,1,0,1,0.24166666666666667
直射径,0,0,1,1,0,2,0,4,0.7333333333333334
udp非视距信号,0,0,0,0,0,1,0,1,0.24166666666666667
直射径漏检,0,0,0,0,0,1,0,1,0.24166666666666667
nddp非视距信号,0,0,0,0,0,1,0,1,0.24166666666666667
undetectabledirectpath,0,0,0,0,0,1,0,1,0.24166666666666667
udp,0,0,0,0,0,1,0,1,0.24166666666666667
dominantdirectpath,0,0,0,0,0,1,0,1,0.24166666666666667
non,0,0,0,0,0,1,0,1,0.24166666666666667
nddp,0,0,0,0,0,1,0,1,0.24166666666666667
建筑物,0,0,0,0,0,1,0,1,0.24166666666666667
非主径,0,0,0,0,0,1,0,1,0.24166666666666667
收发信号,0,0,0,0,1,2,0,3,0.725
3gpp,0,0,0,2,0,1,0,3,0.4916666666666667
移动通信网络,0,0,2,7,0,0,0,9,1.125
基站坐标,0,0,0,1,0,0,0,1,0.125
时延估,0,0,0,1,0,0,1,2,0.3666666666666667
来波信号,0,0,0,1,1,0,0,2,0.3666666666666667
球面波,0,0,0,3,0,0,0,3,0.375
平面波,0,0,0,3,1,0,0,4,0.6166666666666667
概率模型,0,0,0,2,0,0,0,2,0.25
室内区域,0,0,0,2,0,0,0,2,0.25
单基站定位服务,0,0,0,2,0,0,0,2,0.25
收发,0,0,0,3,0,0,0,3,0.375
衰减特性,0,0,0,1,0,0,0,1,0.125
毫米波频段,0,0,1,4,0,0,0,5,0.625
信号路径,0,0,0,1,0,0,0,1,0.125
视距径,0,0,0,1,0,0,0,1,0.125
los径概率,0,0,0,1,0,0,0,1,0.125
los径,0,0,0,1,0,0,0,1,0.125
数学建模,0,0,0,1,0,0,0,1,0.125
视距信号径,0,0,0,1,0,0,0,1,0.125
视距传输,0,0,0,1,0,0,0,1,0.125
单基站定位技术,0,0,2,3,0,0,0,5,0.625
估计,0,0,0,1,0,0,0,1,0.125
混场模型,0,0,0,1,0,0,0,1,0.125
阵元间,0,0,0,1,1,0,0,2,0.3666666666666667
宏/微基站,0,0,0,1,0,0,0,1,0.125
波长,0,0,0,3,1,0,0,4,0.6166666666666667
接收阵列阵元,0,0,0,1,0,0,0,1,0.125
菲涅尔区,0,0,0,1,0,0,0,1,0.125
飞基站,0,0,0,1,0,0,0,1,0.125
皮基站,0,0,0,2,0,0,0,2,0.25
复杂区域,0,0,0,1,0,0,0,1,0.125
室内外,0,0,0,1,0,0,0,1,0.125
微基站,0,0,0,3,0,0,0,3,0.375
空旷区域,0,0,0,1,0,0,0,1,0.125
宏基站,0,0,0,3,0,0,0,3,0.375
布置区域,0,0,0,1,0,0,0,1,0.125
5g基站,0,0,1,2,0,0,0,3,0.375
精度误差,0,0,0,1,0,0,0,1,0.125
参数估计,0,0,0,2,1,0,0,3,0.4916666666666667
信号波,0,0,0,1,0,0,0,1,0.125
电磁场理论,0,0,0,1,0,0,0,1,0.125
抑制,0,0,0,1,0,0,0,1,0.125
非视距单基站,0,0,0,1,0,0,0,1,0.125
信息,0,0,0,3,0,1,0,4,0.6166666666666667
信息交互,0,0,0,2,0,0,0,2,0.25
联合多基站,0,0,0,1,0,0,0,1,0.125
导航,0,0,6,1,0,0,0,7,0.875
工信部,0,0,2,0,0,0,0,2,0.25
定位结,0,0,3,1,0,1,0,5,0.7416666666666667
位置信息,0,0,3,0,0,0,1,4,0.6166666666666667
助力,0,0,1,0,0,0,0,1,0.125
通信,0,0,2,2,0,0,0,4,0.5
定位基站信源,0,0,1,0,0,0,0,1,0.125
角度时延,0,0,2,0,0,1,0,3,0.4916666666666667
速率,0,0,1,1,0,0,0,2,0.25
通信质量,0,0,1,0,0,0,0,1,0.125
mmwave,0,0,1,0,0,0,0,1,0.125
mim0,0,0,1,1,0,0,0,2,0.25
massiveoutput,0,0,1,0,0,0,0,1,0.125
massiveinput,0,0,1,0,0,0,0,1,0.125
ultra-densenetwork,0,0,1,0,0,0,0,1,0.125
通导融合定位,0,0,2,0,0,0,0,2,0.25
5g产业,0,0,1,0,0,0,0,1,0.125
增长率,0,0,1,0,0,0,0,1,0.125
广值規模,0,0,1,0,0,0,0,1,0.125
5g商,0,0,1,0,0,0,0,1,0.125
5g应用,0,0,1,0,0,0,0,1,0.125
5g手机,0,0,1,0,0,0,0,1,0.125
5g终端连接,0,0,1,0,0,0,0,1,0.125
商用5g网络,0,0,1,0,0,0,0,1,0.125
5g商用牌照,0,0,1,0,0,0,0,1,0.125
运营商,0,0,1,0,0,0,0,1,0.125
5g技术,0,0,1,0,0,0,0,1,0.125
5thgenerationmobilenet,0,0,1,0,0,0,0,1,0.125
移动通信技术,0,0,1,0,0,0,0,1,0.125
五代,0,0,1,0,0,0,0,1,0.125
社会,0,0,1,0,0,0,0,1,0.125
生活,0,0,1,0,0,0,0,1,0.125
4g,0,0,1,0,0,0,0,1,0.125
终端接收基站,0,0,1,1,0,0,1,3,0.4916666666666667
参数信息,0,0,1,0,0,0,0,1,0.125
tdoa,0,0,4,9,0,0,0,13,1.625
多基站,1,0,2,2,0,0,1,6,1.7416666666666667
定位导航精度,0,0,1,0,0,0,0,1,0.125
卫星定位技术,0,0,1,0,0,0,0,1,0.125
cell-id,0,0,1,0,0,0,0,1,0.125
小区识别码,0,0,1,0,0,0,0,1,0.125
gnss位置服务,0,0,1,0,0,0,0,1,0.125
信号覆盖,0,0,1,0,0,0,0,1,0.125
地磁,0,0,1,0,0,0,0,1,0.125
惯性导航,1,0,1,0,0,2,0,4,1.6083333333333334
系统,0,0,1,2,0,0,0,3,0.375
普适性,0,0,1,0,0,0,0,1,0.125
设备节点,0,0,1,0,0,0,0,1,0.125
短距离,0,0,1,0,0,0,0,1,0.125
rfid,0,0,1,0,0,0,0,1,0.125
uwb,0,0,2,0,0,0,0,2,0.25
wifi,0,0,2,1,0,0,0,3,0.375
蓝牙,0,0,2,1,0,0,0,3,0.375
信号传输衰减,0,0,1,0,0,0,0,1,0.125
城市峡谷,0,0,1,0,0,0,0,1,0.125
gnss系统,0,0,1,0,0,0,0,1,0.125
可靠性,0,0,1,0,0,0,1,2,0.3666666666666667
仓储,0,0,1,0,0,0,1,2,0.3666666666666667
智慧物流,0,0,1,0,0,0,1,2,0.3666666666666667
智慧医疗,0,0,1,0,0,0,1,2,0.3666666666666667
无人驾驶,0,0,1,0,0,0,1,2,0.3666666666666667
智能产业,0,0,1,0,0,0,1,2,0.3666666666666667
减灾灭灾,0,0,1,0,0,0,1,2,0.3666666666666667
水文监测,0,0,1,0,0,0,0,1,0.125
农林渔业,0,0,1,0,0,0,1,2,0.3666666666666667
公共安全,0,0,1,0,0,0,1,2,0.3666666666666667
交通运输,0,0,1,0,0,0,1,2,0.3666666666666667
gnss,0,0,1,0,0,0,0,1,0.125
atellitesystem,0,0,1,0,0,0,0,1,0.125
globalnavigations,0,0,1,0,0,0,0,1,0.125
全球定位系统,0,0,1,0,0,0,1,2,0.3666666666666667
北斗导航系统,0,0,1,0,0,0,1,2,0.3666666666666667
lbs,0,0,1,0,0,0,1,2,0.3666666666666667
locationbasedservice,0,0,1,0,0,0,1,2,0.3666666666666667
万物互联,1,0,1,0,0,0,1,3,1.3666666666666667
互联网产业,0,0,1,0,0,0,1,2,0.3666666666666667
同步,0,0,0,4,0,0,0,4,0.5
终端坐标,0,0,0,2,0,3,0,5,0.975
终端基站,0,0,0,1,0,0,0,1,0.125
基站间,0,0,0,1,0,0,0,1,0.125
位置解算,0,0,0,2,0,1,0,3,0.4916666666666667
非视距多径干扰,1,0,0,1,0,0,0,2,1.125
射线,0,0,0,1,0,0,0,1,0.125
二维平面,0,0,0,2,0,0,0,2,0.25
角度定位原,0,0,0,1,0,0,0,1,0.125
正余弦定理,0,0,0,1,0,0,0,1,0.125
方程,0,0,0,2,0,0,0,2,0.25
终端定位,0,0,0,1,0,0,0,1,0.125
测角精度,0,0,0,1,0,0,0,1,0.125
天线阵列,0,0,0,3,0,1,0,4,0.6166666666666667
定位技,0,0,0,3,0,0,0,3,0.375
候选集,0,0,0,0,0,3,0,3,0.725
虚拟基站坐标,0,0,0,0,0,2,0,2,0.48333333333333334
终端位置,0,0,0,0,0,2,0,2,0.48333333333333334
环境噪声,0,0,0,0,0,2,0,2,0.48333333333333334
时延估计误差,0,0,0,0,0,2,0,2,0.48333333333333334
终端坐标候选集,0,0,0,0,0,1,0,1,0.24166666666666667
重复元素,0,0,0,0,0,1,0,1,0.24166666666666667
排列数,0,0,0,0,0,1,0,1,0.24166666666666667
反射信号,0,0,0,0,0,1,0,1,0.24166666666666667
nlos信号模型,0,0,0,0,0,1,0,1,0.24166666666666667
定位场景,0,0,0,1,0,1,0,2,0.3666666666666667
nlos传播路径,0,0,0,0,0,1,0,1,0.24166666666666667
xuq,0,0,0,0,0,1,0,1,0.24166666666666667
单次反射,0,0,0,0,0,1,0,1,0.24166666666666667
接收角度,0,0,0,0,2,1,0,3,0.725
正负,0,0,0,0,0,1,0,1,0.24166666666666667
夹角,0,0,0,0,0,1,0,1,0.24166666666666667
辺坐标七,0,0,0,0,0,1,0,1,0.24166666666666667
建筑平面,0,0,0,0,0,1,0,1,0.24166666666666667
墙面,0,0,0,0,0,1,0,1,0.24166666666666667
单次反射路径,0,0,0,0,0,1,0,1,0.24166666666666667
nlos定位,0,0,0,0,0,1,0,1,0.24166666666666667
终端位置坐标,0,0,0,0,0,3,0,3,0.725
角度值,0,0,0,0,0,2,0,2,0.48333333333333334
非视距误差,0,0,2,2,0,2,1,7,1.225
硬件,0,0,0,3,0,0,0,3,0.375
射频链路,0,0,0,2,0,0,0,2,0.25
导频符号,0,0,0,2,0,0,0,2,0.25
预编码,0,0,0,2,0,0,0,2,0.25
下行信道,0,0,0,2,0,0,0,2,0.25
导频污染,0,0,0,2,0,0,0,2,0.25
信道容量,0,0,0,3,0,0,0,3,0.375
波束成形技术,0,0,0,2,1,0,0,3,0.4916666666666667
基站天线,0,0,0,2,0,0,0,2,0.25
lte通信系统,0,0,0,2,0,0,0,2,0.25
信道衰落,0,0,0,2,0,0,0,2,0.25
多天线技术,0,0,0,2,0,0,0,2,0.25
波束赋型,0,0,0,1,0,0,0,1,0.125
大规模天线系统,0,0,0,1,0,0,0,1,0.125
能量开销,0,0,0,1,0,0,0,1,0.125
硬件耗材,0,0,0,1,0,0,0,1,0.125
射频通路,0,0,0,1,0,0,0,1,0.125
混合预编码,0,0,0,1,0,0,0,1,0.125
频谱效率,0,0,0,1,0,0,0,1,0.125
csi,0,0,2,1,0,0,0,3,0.375
信道状态信息,0,0,0,1,0,0,0,1,0.125
数据符号,0,0,0,1,0,0,0,1,0.125
符号,0,0,0,1,0,0,0,1,0.125
相干时间,0,0,0,1,0,0,0,1,0.125
信号反馈,0,0,0,1,0,0,0,1,0.125
fdd,0,0,0,1,0,0,0,1,0.125
导频,0,0,0,1,0,0,0,1,0.125
多天线,0,0,1,1,0,0,0,2,0.25
分辨率,0,0,0,1,0,0,0,1,0.125
信噪比,0,0,0,1,4,2,0,7,1.575
用户间干扰,0,0,0,1,0,0,0,1,0.125
导频设计,0,0,0,1,0,0,0,1,0.125
信道模型,0,0,1,1,0,0,0,2,0.25
信道传输参数,0,0,0,1,0,0,0,1,0.125
信道测量,0,0,0,1,0,0,0,1,0.125
服务,0,0,0,1,0,0,0,1,0.125
城市化,0,0,0,1,0,0,0,1,0.125
测角,0,0,0,1,0,0,0,1,0.125
通信服务体验,0,0,0,1,0,0,0,1,0.125
通信时延,0,0,0,1,0,0,0,1,0.125
深度衰弱,0,0,0,1,0,0,0,1,0.125
衰落,0,0,0,1,0,0,0,1,0.125
5gmimo,0,0,0,1,0,0,0,1,0.125
低延时通信,0,0,0,1,0,0,0,1,0.125
平坦性衰落信道,0,0,0,1,0,0,0,1,0.125
低功率多天线,0,0,0,1,0,0,0,1,0.125
波束赋形技术,0,0,0,1,0,0,0,1,0.125
功率放大设备,0,0,0,1,0,0,0,1,0.125
通信服务水,0,0,0,1,0,0,0,1,0.125
传输时间,0,0,0,1,0,0,0,1,0.125
线路,0,0,0,1,0,0,0,1,0.125
接收,0,0,0,1,0,0,0,1,0.125
信令,0,0,0,1,0,0,0,1,0.125
通信信道容量,0,0,0,1,0,0,0,1,0.125
数据容量,0,0,0,1,0,0,0,1,0.125
根天线,0,0,0,1,0,0,0,1,0.125
is2-2,0,0,0,1,0,0,0,1,0.125
吞吐量,0,0,0,2,0,0,0,2,0.25
覆盖能力,0,0,0,5,0,0,0,5,0.625
相位,0,0,4,1,2,0,0,7,1.1083333333333334
发射信号,0,0,0,1,0,0,0,1,0.125
干涉原理,0,0,0,1,0,0,0,1,0.125
波的,0,0,0,1,0,0,0,1,0.125
massivencmo技术,0,0,0,1,0,0,0,1,0.125
mim0技术,0,0,0,1,0,0,0,1,0.125
硬件集成,0,0,0,1,0,0,0,1,0.125
复用技术,0,0,0,1,0,0,0,1,0.125
空间分集,0,0,0,1,0,0,0,1,0.125
标准化,0,0,0,1,0,0,0,1,0.125
通信技术,0,0,0,1,0,0,0,1,0.125
通信网容量,0,0,0,1,0,0,0,1,0.125
大规模天线技,0,0,0,1,0,0,0,1,0.125
非视距路径,1,0,1,0,0,0,2,4,1.6083333333333334
信号传播,0,0,0,0,0,0,2,2,0.48333333333333334
效率,0,0,0,0,0,0,1,1,0.24166666666666667
高精度覆盖,0,0,0,0,0,0,1,1,0.24166666666666667
加权,0,0,1,0,0,4,1,6,1.3333333333333333
门限,0,0,0,0,0,1,1,2,0.48333333333333334
加权位置,0,0,0,0,0,2,1,3,0.725
冗余路径信息,0,0,0,0,0,1,1,2,0.48333333333333334
运动状态信息,0,0,1,0,0,2,1,4,0.85
非监督聚类,0,0,0,0,0,0,1,1,0.24166666666666667
坐标位置,0,0,0,0,0,0,1,1,0.24166666666666667
门限值,0,0,0,0,0,1,1,2,0.48333333333333334
高阶累积量,0,0,0,0,5,0,1,6,1.45
频域传播模型,0,0,0,0,0,0,1,1,0.24166666666666667
近场效应,0,0,2,1,0,0,1,4,0.6166666666666667
直射路径,0,0,0,0,0,0,1,1,0.24166666666666667
覆盖密度,0,0,0,1,0,0,1,2,0.3666666666666667
单基站定位算法,1,0,0,0,0,1,1,3,1.4833333333333334
5g组网,1,0,0,1,0,0,1,3,1.3666666666666667
时钟误差,0,0,0,2,0,0,1,3,0.4916666666666667
无缝定位,0,0,1,0,0,0,1,2,0.3666666666666667
水纹监测,0,0,0,0,0,0,1,1,0.24166666666666667
础性信息,0,0,0,0,0,0,1,1,0.24166666666666667
频率资源,0,0,0,3,0,0,0,3,0.375
接入设备,0,0,0,4,0,0,0,4,0.5
自由空间,0,0,0,2,0,0,0,2,0.25
带宽,0,0,0,2,1,0,0,3,0.4916666666666667
频率,0,0,0,2,0,0,0,2,0.25
定位源,0,0,0,1,0,0,0,1,0.125
密集定位服务请求,0,0,0,1,0,0,0,1,0.125
香农信道,0,0,0,1,0,0,0,1,0.125
频点,0,0,0,1,0,0,0,1,0.125
天线阵列单元,0,0,0,1,0,0,0,1,0.125
密集,0,0,0,1,0,0,0,1,0.125
天线尺寸,0,0,0,1,0,0,0,1,0.125
多普勒时延,0,0,0,1,0,0,0,1,0.125
穿透性,0,0,0,1,0,0,0,1,0.125
路径损失,0,0,0,1,0,0,0,1,0.125
高频特性,0,0,0,1,0,0,0,1,0.125
干扰能,0,0,0,1,0,0,0,1,0.125
抗用户间,0,0,0,1,0,0,0,1,0.125
频谱,0,0,0,1,3,0,0,4,0.85
移动网络,0,0,0,1,0,0,0,1,0.125
毫米,0,0,0,1,0,0,0,1,0.125
资源,0,0,0,1,0,0,0,1,0.125
集成电路技术,0,0,0,1,0,0,0,1,0.125
频率信号,0,0,0,1,0,0,0,1,0.125
传输速率,0,0,0,1,0,0,0,1,0.125
频段,0,0,0,1,0,0,0,1,0.125
载波信号,0,0,0,1,0,0,0,1,0.125
毫米波技,0,0,0,1,0,0,0,1,0.125
下单基站,1,0,2,0,0,0,0,3,1.25
基站定位技术,0,0,2,0,0,0,0,2,0.25
二次加权终端,0,0,1,0,0,0,0,1,0.125
时延估计参数,0,0,1,0,0,3,0,4,0.85
角度时延估计性能,0,0,1,0,0,0,0,1,0.125
性能理论,0,0,1,0,0,0,0,1,0.125
角度时延参数,0,0,1,0,0,3,0,4,0.85
服务器网关,0,0,1,0,0,0,0,1,0.125
mec边缘计算,0,0,1,0,0,0,0,1,0.125
高阶累积量矩阵,0,0,0,0,4,0,0,4,0.9666666666666667
谱峰搜索,0,0,0,0,7,0,0,7,1.6916666666666667
参数匹配,0,0,0,0,4,0,0,4,0.9666666666666667
高阶music算法,0,0,0,0,5,0,0,5,1.2083333333333333
远场toa,0,0,0,0,4,0,0,4,0.9666666666666667
步进,0,0,0,0,3,0,0,3,0.725
算法复杂度,0,0,0,0,2,0,0,2,0.48333333333333334
算法,0,0,0,0,6,0,0,6,1.45
远近场toa,0,0,0,0,1,0,0,1,0.24166666666666667
特征分,0,0,0,0,1,0,0,1,0.24166666666666667
频率响应矩阵,0,0,0,0,2,0,0,2,0.48333333333333334
次谱峰,0,0,0,0,1,0,0,1,0.24166666666666667
特征值分,0,0,0,0,1,0,0,1,0.24166666666666667
矩阵,0,0,0,0,4,1,0,5,1.2083333333333333
doa,0,0,0,1,9,0,0,10,2.3
esprit算,0,0,0,0,1,0,0,1,0.24166666666666667
估计值,0,0,0,0,1,0,0,1,0.24166666666666667
谱峰,0,0,0,0,2,0,0,2,0.48333333333333334
估计维度,0,0,0,0,1,0,0,1,0.24166666666666667
混合场,0,0,0,0,2,0,0,2,0.48333333333333334
参数维度,0,0,0,0,1,0,0,1,0.24166666666666667
信号接收模型,0,0,0,0,1,0,0,1,0.24166666666666667
正确率,0,0,0,0,0,9,0,9,2.175
误差,0,0,0,0,4,11,0,15,3.625
nlos识别,0,0,0,0,0,6,0,6,1.45
nlos误差,1,0,0,0,0,5,0,6,2.208333333333333
估计误差,0,0,0,0,0,7,0,7,1.6916666666666667
取值,0,0,0,0,0,2,0,2,0.48333333333333334
随机变量,0,0,0,0,0,2,0,2,0.48333333333333334
定位点,0,0,0,0,0,2,0,2,0.48333333333333334
空间,0,0,0,0,0,2,0,2,0.48333333333333334
nlos路径识别,0,0,0,0,0,3,0,3,0.725
约束条件,0,0,0,0,0,1,0,1,0.24166666666666667
信号径,0,0,0,0,0,1,0,1,0.24166666666666667
蒙特卡洛,0,0,0,0,0,1,0,1,0.24166666666666667
门限参数,0,0,0,0,0,1,0,1,0.24166666666666667
均匀分布,0,0,0,0,0,1,0,1,0.24166666666666667
nlos识别率,0,0,0,0,0,1,0,1,0.24166666666666667
仿真实验,0,0,0,0,1,2,0,3,0.725
eshhold,0,0,0,0,0,1,0,1,0.24166666666666667
久取,0,0,0,0,0,1,0,1,0.24166666666666667
状态,0,0,0,0,0,1,0,1,0.24166666666666667
蒙特卡洛实验,0,0,0,0,0,1,0,1,0.24166666666666667
b信号,0,0,0,0,0,1,0,1,0.24166666666666667
odisqggieqpdr,0,0,0,0,0,1,0,1,0.24166666666666667
固定误差参数,0,0,0,0,0,1,0,1,0.24166666666666667
传输,0,0,0,1,0,1,0,2,0.3666666666666667
镜面反射定律,0,0,0,0,0,1,0,1,0.24166666666666667
光滑程度,0,0,0,0,0,1,0,1,0.24166666666666667
反射墙体,0,0,0,0,0,2,0,2,0.48333333333333334
蒙特卡洛实验仿真,0,0,0,0,0,1,0,1,0.24166666666666667
仿真环,0,0,0,0,0,1,0,1,0.24166666666666667
qpqr,0,0,0,0,0,1,0,1,0.24166666666666667
误差参数,0,0,0,0,0,1,0,1,0.24166666666666667
标准角度偏差,0,0,0,0,0,1,0,1,0.24166666666666667
标准距离偏差,0,0,0,0,0,1,0,1,0.24166666666666667
nlos传播角度误差,0,0,0,0,0,1,0,1,0.24166666666666667
nlos传播距离误差,0,0,0,0,0,1,0,1,0.24166666666666667
pdr误差,0,0,0,0,0,1,0,1,0.24166666666666667
惯性导航器件,0,0,0,0,0,4,0,4,0.9666666666666667
判决门限,0,0,0,0,0,1,0,1,0.24166666666666667
坐标处,0,0,0,0,0,1,0,1,0.24166666666666667
仿真环境,0,0,0,0,0,1,0,1,0.24166666666666667
二维坐标系,0,0,0,0,0,1,0,1,0.24166666666666667
非视距多径,0,0,0,4,0,0,0,4,0.5
邮电大学,0,0,0,2,0,1,0,3,0.4916666666666667
多基站定位技术,0,0,0,1,0,0,0,1,0.125
同步时钟,0,0,0,1,0,0,0,1,0.125
单基站定位模型,0,0,0,1,0,0,0,1,0.125
非视距多径信号,0,0,0,2,0,0,0,2,0.25
时钟,0,0,0,3,0,0,0,3,0.375
拓扑,0,0,1,1,0,0,0,2,0.25
部署,0,0,1,1,0,0,0,2,0.25
rssi,0,0,3,5,0,0,0,8,1.0
定位优势,0,0,0,1,0,0,0,1,0.125
信号强度,0,0,2,3,0,0,0,5,0.625
损耗系数,0,0,0,2,0,0,0,2,0.25
模型,0,0,1,1,0,0,0,2,0.25
信号传输路径,0,0,0,1,0,0,0,1,0.125
近距离通信,0,0,0,1,0,0,0,1,0.125
环境影响因子,0,0,0,1,0,0,0,1,0.125
标准功率参数,0,0,0,1,0,0,0,1,0.125
离心,0,0,0,1,0,0,0,1,0.125
发射端,0,0,0,2,0,0,0,2,0.25
接收端,0,0,0,3,0,0,0,3,0.375
描述模型,0,0,0,1,0,0,0,1,0.125
定位解算,0,0,0,3,0,1,0,4,0.6166666666666667
信号接收端,0,0,0,1,0,0,0,1,0.125
esprit算法,0,0,0,0,4,0,0,4,0.9666666666666667
旋转子空间,0,0,0,0,1,0,0,1,0.24166666666666667
信号子空间,0,0,0,0,6,0,0,6,1.45
超分辨率角度时延估计算法,0,0,0,0,1,0,0,1,0.24166666666666667
合阶,0,0,0,0,2,0,0,2,0.48333333333333334
双曲线,0,0,0,2,0,0,0,2,0.25
到达时间,0,0,1,2,0,0,0,3,0.375
时间间隔,0,0,0,2,0,0,0,2,0.25
测距误差,0,0,0,1,0,0,0,1,0.125
tdoa2,0,0,0,1,0,0,0,1,0.125
oa,0,0,0,1,0,0,0,1,0.125
tdoa值,0,0,0,1,0,0,0,1,0.125
定位原理,1,0,0,1,0,0,0,2,1.125
同步误差,0,0,0,1,0,0,0,1,0.125
时间差,0,0,0,1,0,0,0,1,0.125
时间同步误差,0,0,0,1,0,0,0,1,0.125
质心,0,0,0,1,0,0,0,1,0.125
非视距多径效应,0,0,0,1,0,0,0,1,0.125
投射,0,0,0,1,0,0,0,1,0.125
折射,0,0,0,1,0,0,0,1,0.125
写字楼,0,0,0,1,0,0,0,1,0.125
时钟同步误差,0,0,0,1,0,0,0,1,0.125
求解,0,0,0,1,0,0,0,1,0.125
toa定位原,0,0,0,1,0,0,0,1,0.125
toa定位,0,0,0,1,0,0,0,1,0.125
速度,0,0,0,1,0,0,0,1,0.125
无线电磁波,0,0,0,1,0,0,0,1,0.125
介质,0,0,0,1,0,0,0,1,0.125
指纹库,0,0,6,0,0,0,0,6,0.75
特征参数,0,0,4,0,0,0,0,4,0.5
幅值,0,0,3,0,2,0,0,5,0.8583333333333334
向量机,0,0,2,0,0,0,0,2,0.25
指纹,0,0,2,0,0,0,0,2,0.25
神经网络,0,0,2,0,0,0,0,2,0.25
亚米级,0,0,2,0,0,1,0,3,0.4916666666666667
5g定位技术,0,0,1,0,0,0,0,1,0.125
massivemimo,0,0,1,0,0,0,0,1,0.125
单基站定位效,0,0,1,0,0,0,0,1,0.125
路径损耗因子,0,0,1,0,0,0,0,1,0.125
向量回归,0,0,1,0,0,0,0,1,0.125
aoa估计,0,0,1,0,0,0,0,1,0.125
低信噪比,0,0,1,0,0,0,0,1,0.125
状态信息,0,0,1,0,0,0,0,1,0.125
wifi信道,0,0,1,0,0,0,0,1,0.125
定位参数,0,0,1,0,0,0,0,1,0.125
定位仿真过程,0,0,1,0,0,0,0,1,0.125
大规模天线通信系统,0,0,1,0,0,0,0,1,0.125
脉冲幅度,0,0,1,0,0,0,0,1,0.125
单基站超宽带,0,0,1,0,0,0,0,1,0.125
圆形天线阵列,0,0,1,0,0,0,0,1,0.125
定位解算误差,0,0,1,0,0,0,0,1,0.125
均方根误差,0,0,1,0,3,0,0,4,0.85
定位模型,0,0,1,0,0,0,0,1,0.125
延迟轮廓交线,0,0,1,0,0,0,0,1,0.125
mim0系统,0,0,1,0,0,0,0,1,0.125
亚米级定位性能,0,0,1,0,0,0,0,1,0.125
直接定位,0,0,1,0,0,0,0,1,0.125
角度估计,0,0,1,0,0,0,0,1,0.125
massivemim0,0,0,1,0,0,0,0,1,0.125
aoa值,0,0,1,0,0,0,0,1,0.125
线性阵列,0,0,1,0,0,0,0,1,0.125
超密集网络架构,0,0,1,0,0,0,0,1,0.125
owerbo,0,0,1,0,0,0,0,1,0.125
ra,0,0,1,0,0,0,0,1,0.125
克拉美罗下界,0,0,1,0,0,0,0,1,0.125
随机节点分布,0,0,1,0,0,0,0,1,0.125
5g毫米波,0,0,1,0,0,0,0,1,0.125
5g毫米波频段,0,0,1,0,0,0,0,1,0.125
arri,0,0,1,0,0,0,0,1,0.125
angle,0,0,1,0,0,0,0,1,0.125
到达角,0,0,1,0,0,0,0,1,0.125
arrival,0,0,1,0,0,0,0,1,0.125
timedifferent,0,0,1,0,0,0,0,1,0.125
到达时间差,0,0,1,0,0,0,0,1,0.125
ai,0,0,1,0,0,0,0,1,0.125
time,0,0,1,0,0,0,0,1,0.125
移动终端,0,0,1,5,0,2,0,8,1.2333333333333334
估计参数,0,0,1,0,0,0,0,1,0.125
匹配,0,0,1,0,0,0,0,1,0.125
csi提取设备,0,0,1,0,0,0,0,1,0.125
5g信号,0,0,1,0,0,0,0,1,0.125
设备,0,0,1,0,0,1,0,2,0.3666666666666667
离线指纹,0,0,1,0,0,0,0,1,0.125
随机森林,0,0,1,0,0,0,0,1,0.125
匹配算法,0,0,1,0,0,0,0,1,0.125
向量距离,0,0,1,0,0,0,0,1,0.125
csi特征匹配,0,0,1,0,0,0,0,1,0.125
csi统计特征,0,0,1,0,0,0,0,1,0.125
phase,0,0,1,0,0,0,0,1,0.125
深度学习系统,0,0,1,0,0,0,0,1,0.125
权值,0,0,1,0,0,0,0,1,0.125
cs啲幅值,0,0,1,0,0,0,0,1,0.125
deepfi系统,0,0,1,0,0,0,0,1,0.125
相位差异,0,0,1,0,0,0,0,1,0.125
幅度,0,0,1,0,0,0,0,1,0.125
csi-mimo系统,0,0,1,0,0,0,0,1,0.125
ap,0,0,1,0,0,0,0,1,0.125
csi数据采集,0,0,1,0,0,0,0,1,0.125
多径效应,0,0,1,0,0,0,0,1,0.125
无线信道,0,0,1,0,0,0,0,1,0.125
维度,0,0,1,0,0,0,0,1,0.125
rssip0,0,0,1,0,0,0,0,1,0.125
csi特征,0,0,1,0,0,0,0,1,0.125
wifi信号,0,0,1,0,0,0,0,1,0.125
密集化,0,0,1,0,0,0,0,1,0.125
wifi网络,0,0,1,0,0,0,0,1,0.125
蓝牙信号,0,0,1,0,0,0,0,1,0.125
定位效果,0,0,1,0,0,0,0,1,0.125
of-sight,0,0,1,0,0,0,0,1,0.125
line,0,0,1,0,0,0,0,1,0.125
室内外定位算法,0,0,1,0,0,0,0,1,0.125
惯性导航pdr,0,0,1,0,0,0,0,1,0.125
蓝牙节点,0,0,1,0,0,0,0,1,0.125
信号源,0,0,1,0,1,0,0,2,0.3666666666666667
位置特征参数,0,0,1,0,0,0,0,1,0.125
匹配度,0,0,1,0,0,0,0,1,0.125
指纹构建,0,0,1,0,0,0,0,1,0.125
室内外定位技术,0,0,1,0,0,0,0,1,0.125
冗余路径,0,0,0,0,0,1,0,1,0.24166666666666667
los信号,0,0,0,0,0,3,0,3,0.725
建筑平面坐标,0,0,0,0,0,2,0,2,0.48333333333333334
非视距定位,0,1,0,0,0,1,0,2,2.2416666666666667
观测量,0,0,0,0,0,1,0,1,0.24166666666666667
传输路径,0,0,0,0,0,2,0,2,0.48333333333333334
5g组网技,0,0,0,1,0,0,0,1,0.125
数据传输能力,0,0,0,1,0,0,0,1,0.125
空间复用能力,0,0,0,1,0,0,0,1,0.125
部署密度,0,0,0,1,0,0,0,1,0.125
massivemimo技术,0,0,0,1,0,0,0,1,0.125
毫米波波长,0,0,0,1,0,0,0,1,0.125
毫米波强衰减性,0,0,0,1,0,0,0,1,0.125
传输带宽,0,0,0,1,0,0,0,1,0.125
频谱资源,0,0,0,1,0,0,0,1,0.125
通信交互,0,0,0,1,0,0,0,1,0.125
urllc,0,0,0,1,0,0,0,1,0.125
低延时,0,0,0,1,0,0,0,1,0.125
mmtc,0,0,0,1,0,0,0,1,0.125
海量物联网通信,0,0,0,1,0,0,0,1,0.125
embb,0,0,0,1,0,0,0,1,0.125
增强移动宽带,0,0,0,1,0,0,0,1,0.125
电信,0,0,0,1,0,0,0,1,0.125
定位理论,0,0,0,1,0,0,0,1,0.125
5g单基站,0,0,0,1,0,0,0,1,0.125
发射功率,0,0,0,3,0,0,0,3,0.375
多连接技术,0,0,0,3,0,0,0,3,0.375
宏微基站,0,0,0,2,0,0,0,2,0.25
异构组网,0,0,0,2,0,0,0,2,0.25
数据通信,0,0,0,1,0,0,0,1,0.125
信令控制,0,0,0,1,0,0,0,1,0.125
定位基站,0,0,0,1,0,0,0,1,0.125
定位节点,0,0,0,1,0,0,0,1,0.125
无线资源,0,0,0,1,0,0,0,1,0.125
evolvednodeb,0,0,0,1,0,0,0,1,0.125
enb,0,0,0,1,0,0,0,1,0.125
x2接口,0,0,0,1,0,0,0,1,0.125
接收终端,0,0,0,1,0,0,0,1,0.125
发送,0,0,0,1,0,0,0,1,0.125
rrc连接态,0,0,0,1,0,0,0,1,0.125
e-utran,0,0,0,1,0,0,0,1,0.125
3gpp标准化,0,0,0,1,0,0,0,1,0.125
小区边缘,0,0,0,1,0,0,0,1,0.125
多连接技,0,0,0,1,0,0,0,1,0.125
间距,0,0,0,1,2,0,0,3,0.6083333333333334
体验,0,0,0,1,0,0,0,1,0.125
移动终端服务,0,0,0,1,0,0,0,1,0.125
映射,0,0,0,1,0,0,0,1,0.125
无缝连接,0,0,0,1,0,0,0,1,0.125
覆盖面积,0,0,0,1,0,0,0,1,0.125
picosite,0,0,0,1,0,0,0,1,0.125
microsite,0,0,0,1,0,0,0,1,0.125
网络,0,0,0,1,0,0,0,1,0.125
覆盖,1,0,0,1,0,0,0,2,1.125
macrosite,0,0,0,1,0,0,0,1,0.125
数量,0,0,0,1,0,0,0,1,0.125
接入点,0,0,0,1,0,0,0,1,0.125
连接请求,0,0,0,1,0,0,0,1,0.125
热点,0,0,0,1,0,0,0,1,0.125
办公楼,0,0,0,1,0,0,0,1,0.125
4g基站,0,0,0,1,0,0,0,1,0.125
通信性能,0,0,0,1,0,0,0,1,0.125
业务,0,0,0,1,0,0,0,1,0.125
4g蜂窝组网技术,0,0,0,1,0,0,0,1,0.125
数据传输,0,0,0,1,0,0,0,1,0.125
5g复合场,0,0,0,1,0,0,0,1,0.125
相位差,0,0,0,0,7,0,0,7,1.6916666666666667
近场模型,0,0,0,0,5,0,0,5,1.2083333333333333
远场模型,1,0,0,0,5,0,0,6,2.208333333333333
阵列,0,0,0,0,5,0,0,5,1.2083333333333333
信源,0,0,0,0,4,0,0,4,0.9666666666666667
接收相位差,0,0,0,0,2,0,0,2,0.48333333333333334
八心,0,0,0,0,1,0,0,1,0.24166666666666667
到达角度,0,0,0,0,1,0,0,1,0.24166666666666667
妙匕,0,0,0,0,1,0,0,1,0.24166666666666667
rk,0,0,0,0,1,0,0,1,0.24166666666666667
离阵元,0,0,0,0,1,0,0,1,0.24166666666666667
久纳,0,0,0,0,1,0,0,1,0.24166666666666667
坐标轴,0,0,0,0,1,0,0,1,0.24166666666666667
强度,0,0,0,0,1,0,0,1,0.24166666666666667
表征信号,0,0,0,0,1,0,0,1,0.24166666666666667
远近场下信号,0,0,0,0,1,0,0,1,0.24166666666666667
平行波,0,0,0,0,1,0,0,1,0.24166666666666667
到达阵列,0,0,0,0,1,0,0,1,0.24166666666666667
大规模阵列,0,0,0,0,1,0,0,1,0.24166666666666667
平面波模型,0,0,0,0,1,0,0,1,0.24166666666666667
孔径,0,0,0,0,1,0,0,1,0.24166666666666667
基站密度,0,0,0,0,1,0,0,1,0.24166666666666667
孔径差,0,0,0,0,1,0,0,1,0.24166666666666667
超密集组网架构,0,0,0,0,1,0,0,1,0.24166666666666667
5g异构网络,0,0,0,0,1,0,0,1,0.24166666666666667
快拍数,0,0,0,0,8,0,0,8,1.9333333333333333
high-music算法,0,0,0,0,4,0,0,4,0.9666666666666667
杂度,0,0,0,0,2,0,0,2,0.48333333333333334
仿真图,0,0,0,0,2,0,0,2,0.48333333333333334
远场信源,0,0,0,0,2,0,0,2,0.48333333333333334
四阶累积量,0,0,0,0,3,0,0,3,0.725
怏拍数,0,0,0,0,1,0,0,1,0.24166666666666667
指数,0,0,0,0,1,0,0,1,0.24166666666666667
运算复杂度,0,0,0,0,2,0,0,2,0.48333333333333334
d0a,0,0,0,0,1,0,0,1,0.24166666666666667
矩阵运算,0,0,0,0,1,1,0,2,0.48333333333333334
snr,0,0,0,0,1,1,0,2,0.48333333333333334
二阶累积量,0,0,0,0,1,0,0,1,0.24166666666666667
累积误差,0,0,0,0,1,2,0,3,0.725
子阵列,0,0,0,0,1,0,0,1,0.24166666666666667
近场信源,0,0,0,0,2,0,0,2,0.48333333333333334
路径数,0,0,0,0,1,0,0,1,0.24166666666666667
蒙特卡洛仿真实验,0,0,0,0,1,0,0,1,0.24166666666666667
rmse,0,0,0,0,1,0,0,1,0.24166666666666667
异构网络,0,0,0,0,1,0,0,1,0.24166666666666667
fft点数,0,0,0,0,1,0,0,1,0.24166666666666667
观测区间数,0,0,0,0,1,0,0,1,0.24166666666666667
载波频率犬,0,0,0,0,1,0,0,1,0.24166666666666667
子载波数量,0,0,0,0,1,0,0,1,0.24166666666666667
环境参数,0,0,0,0,1,0,0,1,0.24166666666666667
性能优势,0,0,0,0,2,0,0,2,0.48333333333333334
性能仿真,0,0,0,0,1,0,0,1,0.24166666666666667
近场信号,0,0,0,0,13,0,0,13,3.1416666666666666
远场阵列流形,0,0,0,0,2,0,0,2,0.48333333333333334
阵列流形,0,0,0,0,2,0,0,2,0.48333333333333334
近场信号矩阵,0,0,0,0,1,0,0,1,0.24166666666666667
smt,0,0,0,0,1,0,0,1,0.24166666666666667
远场信号矩阵,0,0,0,0,1,0,0,1,0.24166666666666667
观测信号,0,0,0,0,1,0,0,1,0.24166666666666667
矩阵相乘,0,0,0,0,1,0,0,1,0.24166666666666667
达式,0,0,0,0,1,0,0,1,0.24166666666666667
窄带,0,0,0,0,1,0,0,1,0.24166666666666667
时域接收模型,0,0,0,0,1,0,0,1,0.24166666666666667
陀螺仪,0,0,0,0,0,4,0,4,0.9666666666666667
加速度计,0,0,0,0,0,5,0,5,1.2083333333333333
非视距干扰,0,0,0,0,0,1,0,1,0.24166666666666667
概率分布图,0,0,0,0,0,1,0,1,0.24166666666666667
运动时间,0,0,0,0,0,1,0,1,0.24166666666666667
时间点,0,0,0,0,0,1,0,1,0.24166666666666667
仿真测,0,0,0,0,0,1,0,1,0.24166666666666667
cdf,0,0,0,0,0,1,0,1,0.24166666666666667
纽心汕,0,0,0,0,0,1,0,1,0.24166666666666667
仿真实测,0,0,0,0,0,1,0,1,0.24166666666666667
测试仪器,0,0,0,0,0,1,0,1,0.24166666666666667
华为,0,0,0,0,0,1,0,1,0.24166666666666667
操作系统,0,0,0,0,0,1,0,1,0.24166666666666667
智能手机,0,0,0,0,0,1,0,1,0.24166666666666667
激光测距仪,0,0,0,0,0,1,0,1,0.24166666666666667
融合,0,0,0,0,0,1,0,1,0.24166666666666667
采样,0,0,0,0,0,1,0,1,0.24166666666666667
数据采样,0,0,0,0,0,1,0,1,0.24166666666666667
为智能手机,0,0,0,0,0,1,0,1,0.24166666666666667
速度矢量参数,0,0,0,0,0,1,0,1,0.24166666666666667
射线追踪,0,0,0,0,0,1,0,1,0.24166666666666667
仿真模拟,0,0,0,0,0,1,0,1,0.24166666666666667
模拟mimo基站,0,0,0,0,0,1,0,1,0.24166666666666667
mimo天线,0,0,0,0,0,1,0,1,0.24166666666666667
绿色五角星,0,0,0,0,0,1,0,1,0.24166666666666667
蓝色五角星,0,0,0,0,0,1,0,1,0.24166666666666667
移动路径,0,0,0,0,0,1,0,1,0.24166666666666667
黑色虚线,0,0,0,0,0,1,0,1,0.24166666666666667
视距区域,0,0,0,0,0,1,0,1,0.24166666666666667
非视距区域,0,0,0,0,0,1,0,1,0.24166666666666667
nlos定位算法,0,0,0,0,0,1,0,1,0.24166666666666667
速度信息,0,0,0,0,0,1,0,1,0.24166666666666667
融合终端,0,0,0,0,0,1,0,1,0.24166666666666667
坐标值,0,0,0,0,0,1,0,1,0.24166666666666667
参考信息,0,0,0,0,0,1,0,1,0.24166666666666667
定位环境,0,0,0,0,0,1,0,1,0.24166666666666667
xsnr,0,0,0,0,0,1,0,1,0.24166666666666667
二乘,0,0,0,0,0,1,0,1,0.24166666666666667
权重,0,0,0,0,0,1,0,1,0.24166666666666667
seconm,0,0,0,0,0,1,0,1,0.24166666666666667
优化函数,0,0,0,0,0,1,0,1,0.24166666666666667
速度参数,0,0,0,0,0,1,0,1,0.24166666666666667
发送间隔,0,0,0,0,0,1,0,1,0.24166666666666667
pdr数据,0,0,0,0,0,1,0,1,0.24166666666666667
运动模型,0,0,0,0,0,1,0,1,0.24166666666666667
速度矢量,0,0,0,0,0,1,0,1,0.24166666666666667
时刻间隔,0,0,0,0,0,1,0,1,0.24166666666666667
待定位终端,0,0,0,0,0,1,0,1,0.24166666666666667
令仏山,0,0,0,0,0,1,0,1,0.24166666666666667
请求,0,0,0,0,0,2,0,2,0.48333333333333334
数据支,0,0,0,0,0,1,0,1,0.24166666666666667
运动状态,0,0,0,0,0,1,0,1,0.24166666666666667
pdr技术,0,0,0,0,0,1,0,1,0.24166666666666667
精度定位,0,0,0,0,0,1,0,1,0.24166666666666667
in,0,0,0,0,0,1,0,1,0.24166666666666667
cosa,0,0,0,0,0,1,0,1,0.24166666666666667
测角能力,0,0,0,0,0,1,0,1,0.24166666666666667
线性化,0,0,0,0,0,1,0,1,0.24166666666666667
ct,0,0,0,0,0,1,0,1,0.24166666666666667
噪声误差,0,0,0,0,0,1,0,1,0.24166666666666667
环境误差,0,0,0,0,0,1,0,1,0.24166666666666667
加权估计,0,0,0,0,0,1,0,1,0.24166666666666667
兀余信息,0,0,0,0,0,1,0,1,0.24166666666666667
反射过,0,0,0,0,0,1,0,1,0.24166666666666667
二次加权位置,0,0,0,0,0,1,0,1,0.24166666666666667
理论仿真,0,0,0,0,1,0,0,1,0.24166666666666667
波束指向性,0,0,0,0,1,0,0,1,0.24166666666666667
los场景,0,0,0,0,1,0,0,1,0.24166666666666667
阵列接收信号,0,0,0,2,1,0,0,3,0.4916666666666667
几何关系,0,0,0,2,0,0,0,2,0.25
坐标位,0,0,0,1,0,0,0,1,0.125
三角函数,0,0,0,1,0,0,0,1,0.125
bs坐标,0,0,0,1,0,0,0,1,0.125
阵列信号,0,0,0,1,0,0,0,1,0.125
传播速度,0,0,0,1,0,0,0,1,0.125
取信号,0,0,0,1,0,0,0,1,0.125
传播时间,0,0,0,1,0,0,0,1,0.125
方位角,0,0,0,1,0,0,0,1,0.125
俯仰角,0,0,0,1,0,0,0,1,0.125
面阵,0,0,0,1,0,0,0,1,0.125
圆阵,0,0,0,1,0,0,0,1,0.125
印坷,0,0,0,1,0,0,0,1,0.125
线性排布,0,0,0,1,0,0,0,1,0.125
三维平面,0,0,0,1,0,0,0,1,0.125
单基站定位原理,0,0,0,1,0,0,0,1,0.125
二维频谱搜索,0,0,0,0,1,0,0,1,0.24166666666666667
doa值,0,0,0,0,1,0,0,1,0.24166666666666667
累积量矩阵,0,0,0,0,2,0,0,2,0.48333333333333334
四阶,0,0,0,0,2,0,0,2,0.48333333333333334
远场doa,0,0,0,0,2,0,0,2,0.48333333333333334
时域接收信号模型,0,0,0,0,1,0,0,1,0.24166666666666667
信号传播模型,0,0,0,0,0,1,0,1,0.24166666666666667
los/nlos基站,0,0,0,0,0,1,0,1,0.24166666666666667
惯性导航技术,0,0,0,0,0,1,0,1,0.24166666666666667
室内外定位,0,0,0,0,0,1,0,1,0.24166666666666667
imu,0,0,0,0,0,1,0,1,0.24166666666666667
inertialmeasurement,0,0,0,0,0,1,0,1,0.24166666666666667
惯性导航系统,0,0,0,0,0,1,0,1,0.24166666666666667
子阵,0,0,0,0,9,0,0,9,2.175
频谱搜索函数,0,0,0,0,5,0,0,5,1.2083333333333333
特征值,0,0,0,0,5,0,0,5,1.2083333333333333
协方差矩阵,0,0,0,0,5,0,0,5,1.2083333333333333
协方差,0,0,0,0,2,0,0,2,0.48333333333333334
接收阵列信号,0,0,0,0,2,0,0,2,0.48333333333333334
近场doa值,0,0,0,0,2,0,0,2,0.48333333333333334
特征分解,0,0,0,0,2,0,0,2,0.48333333333333334
二乘准则,0,0,0,0,2,0,0,2,0.48333333333333334
噪声子空间,0,0,0,0,2,0,0,2,0.48333333333333334
对角线,0,0,0,0,2,0,0,2,0.48333333333333334
对角矩阵,0,0,0,0,2,0,0,2,0.48333333333333334
旋转不变性,0,0,0,0,1,0,0,1,0.24166666666666667
子空间,0,0,0,0,1,0,0,1,0.24166666666666667
argmax,0,0,0,0,1,0,0,1,0.24166666666666667
协方差矩阵分,0,0,0,0,1,0,0,1,0.24166666666666667
近场toa,0,0,0,0,1,0,0,1,0.24166666666666667
子矩阵,0,0,0,0,1,0,0,1,0.24166666666666667
对角元素,0,0,0,0,1,0,0,1,0.24166666666666667
特征,0,0,0,0,1,0,0,1,0.24166666666666667
四阶累积量矩阵,0,0,0,0,1,0,0,1,0.24166666666666667
输出,0,0,0,0,1,0,0,1,0.24166666666666667
接收数据,0,0,0,0,1,0,0,1,0.24166666666666667
非线性,0,0,0,0,1,0,0,1,0.24166666666666667
峰度,0,0,0,0,1,0,0,1,0.24166666666666667
near,0,0,0,0,1,0,0,1,0.24166666666666667
knear,0,0,0,0,1,0,0,1,0.24166666666666667
累积量,0,0,0,0,1,0,0,1,0.24166666666666667
近场d0a,0,0,0,0,1,0,0,1,0.24166666666666667
个谱,0,0,0,0,1,0,0,1,0.24166666666666667
频谱函数,0,0,0,0,1,0,0,1,0.24166666666666667
时域频谱函数,0,0,0,0,1,0,0,1,0.24166666666666667
值分解,0,0,0,0,1,0,0,1,0.24166666666666667
一维谱峰搜索,0,0,0,0,1,0,0,1,0.24166666666666667
二维谱峰搜索,0,0,0,0,1,0,0,1,0.24166666666666667
时域接收信号,0,0,0,0,1,0,0,1,0.24166666666666667
干扰误差点,0,0,0,0,0,2,0,2,0.48333333333333334
距离误差,0,0,0,0,0,1,0,1,0.24166666666666667
pdr约束关系,0,0,0,0,0,1,0,1,0.24166666666666667
非视距信号,0,0,0,0,0,1,0,1,0.24166666666666667
多基站定位,0,0,0,1,0,0,0,1,0.125
基站c,0,0,0,0,0,2,0,2,0.48333333333333334
位置点信号,0,0,0,0,0,2,0,2,0.48333333333333334
积分,0,0,0,0,0,2,0,2,0.48333333333333334
加速度,0,0,0,0,0,2,0,2,0.48333333333333334
角度偏差,0,0,0,0,0,1,0,1,0.24166666666666667
正偏差,0,0,0,0,0,1,0,1,0.24166666666666667
约束参数,0,0,0,0,0,1,0,1,0.24166666666666667
dnlos,0,0,0,0,0,1,0,1,0.24166666666666667
los距离,0,0,0,0,0,1,0,1,0.24166666666666667
位移距离,0,0,0,0,0,1,0,1,0.24166666666666667
心纫,0,0,0,0,0,1,0,1,0.24166666666666667
散射,0,0,0,0,0,1,0,1,0.24166666666666667
直接传输,0,0,0,0,0,1,0,1,0.24166666666666667
线段,0,0,0,0,0,1,0,1,0.24166666666666667
导航定位,0,0,0,0,0,1,0,1,0.24166666666666667
移动设备,0,0,0,0,0,1,0,1,0.24166666666666667
运动状态参数,0,0,0,0,0,1,0,1,0.24166666666666667
重力力矩,0,0,0,0,0,1,0,1,0.24166666666666667
位移,0,0,0,0,0,1,0,1,0.24166666666666667
运动速度,0,0,0,0,0,1,0,1,0.24166666666666667
MIMO,0,1,0,0,0,0,0,1,2.0
非视距基站干扰,1,0,0,0,0,0,0,1,1.0
5g波束播发,1,0,0,0,0,0,0,1,1.0
指向,1,0,0,0,0,0,0,1,1.0
数据约束能力,1,0,0,0,0,0,0,1,1.0
多径冗余信息,1,0,0,0,0,0,0,1,1.0
位置估计,1,0,0,0,0,0,0,1,1.0
远近场角度时延估计,1,0,0,0,0,0,0,1,1.0
阵列时域,1,0,0,0,0,0,0,1,1.0
music,1,0,0,0,0,0,0,1,1.0
esprit,1,0,0,0,0,0,0,1,1.0
搜索次数,1,0,0,0,0,0,0,1,1.0
高精度角度时延,1,0,0,0,0,0,0,1,1.0
频域接收信号,1,0,0,0,0,0,0,1,1.0
无缝高精度定位,1,0,0,0,0,0,0,1,1.0
移动通信网,1,0,0,0,0,0,0,1,1.0
城市环境,1,0,0,0,0,0,0,1,1.0
定位条,1,0,0,0,0,0,0,1,1.0
商业化,1,0,0,0,0,0,0,1,1.0
5g技,1,0,0,0,0,0,0,1,1.0
