,摘要,关键词,第一章,第二章,第三章,第四章,第五章,总词频,加权得分
阻抗建模,0,0,2,0,0,0,0,2,0.25
地平面网络,0,0,1,0,0,0,0,1,0.125
电源,5,0,8,0,1,59,6,79,21.95
pcb走线串扰批量仿真,0,0,1,0,0,0,0,1,0.125
等效电路模型,2,0,5,1,0,0,0,8,2.75
反射,2,1,11,21,3,0,4,42,9.691666666666666
高频,0,0,1,1,0,2,1,5,0.975
全波仿真,2,0,2,3,1,1,1,10,3.35
pcb,2,0,3,2,2,0,0,9,3.1083333333333334
攻击线,0,0,0,0,22,0,0,22,5.316666666666666
串扰,2,1,11,2,43,0,2,61,16.5
端接,0,0,0,1,10,0,0,11,2.5416666666666665
电压,0,0,2,5,12,5,0,24,4.983333333333333
受迫线,0,0,0,0,24,0,1,25,6.041666666666667
信号,3,0,12,30,28,10,2,85,17.916666666666664
传输线,2,0,10,64,43,1,1,121,22.125
主动并行匹配,0,0,0,0,1,0,0,1,0.24166666666666667
并行ac匹,0,0,0,0,1,0,0,1,0.24166666666666667
并行匹配,0,0,0,0,1,0,0,1,0.24166666666666667
戴维南,0,0,0,0,1,0,0,1,0.24166666666666667
并联匹配,0,0,0,0,1,0,0,1,0.24166666666666667
串联匹配,0,0,0,1,1,0,0,2,0.3666666666666667
反射系数,0,0,1,3,1,0,0,5,0.7416666666666667
反射电压,0,0,0,0,1,0,0,1,0.24166666666666667
抑制,0,0,0,0,1,0,0,1,0.24166666666666667
反射参数,0,0,0,1,1,0,0,2,0.3666666666666667
拓扑结构,0,0,0,1,12,0,2,15,3.5083333333333333
终端,0,0,1,1,1,0,0,3,0.4916666666666667
攻击线拓扑结构,0,0,0,0,1,0,0,1,0.24166666666666667
无端接,0,0,0,0,1,0,0,1,0.24166666666666667
远端串扰,0,0,1,0,2,0,0,3,0.6083333333333334
近端,0,0,0,0,1,0,0,1,0.24166666666666667
电压幅值,0,0,0,0,1,0,0,1,0.24166666666666667
电磁干扰,0,0,1,0,1,0,0,2,0.3666666666666667
电磁场理论,0,0,0,0,1,0,0,1,0.24166666666666667
网络,0,0,0,0,14,0,1,15,3.625
crosstalk,0,0,0,0,4,0,0,4,0.9666666666666667
网络名,0,0,0,0,3,0,0,3,0.725
hyperlynx,0,0,0,0,6,0,0,6,1.45
走线,0,0,7,13,12,2,0,34,5.883333333333333
仿真结,1,0,0,2,2,0,0,5,1.7333333333333334
器件,0,0,3,2,15,6,1,27,5.941666666666666
非平行传输线,0,0,0,0,1,0,0,1,0.24166666666666667
平行双线,0,0,0,0,3,0,0,3,0.725
耦合,0,0,1,0,11,0,0,12,2.783333333333333
阈值,0,0,0,0,1,0,0,1,0.24166666666666667
仿真算法,0,0,0,0,1,0,0,1,0.24166666666666667
全波仿真软件,1,0,0,0,1,1,1,4,1.725
数据集,1,0,0,0,2,0,0,3,1.4833333333333334
误差,0,0,0,7,1,4,0,12,2.083333333333333
hyperlynx仿真,0,0,0,0,2,0,0,2,0.48333333333333334
引脚,0,0,0,1,1,0,0,2,0.3666666666666667
有源器件,0,0,0,1,12,1,2,16,3.75
机器学习模型,0,0,0,0,4,0,0,4,0.9666666666666667
串扰超标,0,0,0,0,1,0,0,1,0.24166666666666667
串扰阈值,0,0,0,0,3,0,1,4,0.9666666666666667
准确率,0,0,0,0,1,0,0,1,0.24166666666666667
工业,0,0,0,0,1,0,0,1,0.24166666666666667
批量化仿真时间,0,0,0,0,1,0,0,1,0.24166666666666667
建模,0,0,1,0,1,1,0,3,0.6083333333333334
时间,0,0,1,2,3,1,1,8,1.5833333333333333
仿真,1,0,9,13,3,3,1,30,5.441666666666666
仿真报告,0,0,0,0,1,0,0,1,0.24166666666666667
仿真总时间,0,0,0,0,1,0,0,1,0.24166666666666667
批处理仿真,0,0,0,0,1,0,0,1,0.24166666666666667
长传输线,0,0,0,1,1,0,0,2,0.3666666666666667
pcb制版,0,0,0,0,1,0,0,1,0.24166666666666667
周围线路,0,0,0,0,1,0,0,1,0.24166666666666667
数据,0,0,0,1,14,0,0,15,3.5083333333333333
供电导线,0,0,0,0,1,0,0,1,0.24166666666666667
stratixivgxfpga,0,0,0,1,2,0,0,3,0.6083333333333334
电路板,1,0,1,4,9,15,0,30,7.425
等效电路,1,0,3,14,2,4,2,26,5.058333333333334
参数,0,0,2,17,5,4,1,29,4.791666666666666
矩量法,1,0,3,15,0,2,0,21,3.7333333333333334
数值,0,0,0,6,1,1,0,8,1.2333333333333334
频率,1,0,2,29,7,9,0,48,8.741666666666667
电路参数,0,0,0,4,0,0,0,4,0.5
采样,0,0,0,1,0,0,0,1,0.125
全波仿真结,0,0,0,1,0,0,0,1,0.125
cadence软件,0,0,0,1,0,0,0,1,0.125
趋肤效应,1,0,0,6,0,0,0,7,1.75
低频,0,0,0,3,0,3,0,6,1.1
常规参数,0,0,0,1,0,0,0,1,0.125
印刷电路板,2,0,10,10,13,11,4,50,11.266666666666666
反射问题,0,0,2,2,3,0,0,7,1.225
s参数,0,0,0,1,0,1,0,2,0.3666666666666667
传输线理论,0,0,1,2,0,1,0,4,0.6166666666666667
传输线反射,0,0,0,2,0,0,0,2,0.25
磁场,0,0,0,0,6,1,0,7,1.6916666666666667
电流,0,0,0,19,10,14,0,43,8.175
容性耦合,0,0,0,0,6,0,0,6,1.45
感性耦合,0,0,0,0,6,0,0,6,1.45
串扰现象,0,0,0,0,1,0,0,1,0.24166666666666667
电势差,0,0,0,0,1,1,0,2,0.48333333333333334
电容器,0,0,0,0,1,1,0,2,0.48333333333333334
电容,0,0,0,4,8,25,0,37,8.475
带电线路,0,0,0,0,1,0,0,1,0.24166666666666667
感应电场,0,0,0,0,1,0,0,1,0.24166666666666667
线路,0,0,0,0,2,0,0,2,0.48333333333333334
向外辐射,0,0,0,0,1,0,0,1,0.24166666666666667
返回路径,0,0,0,0,1,0,0,1,0.24166666666666667
法拉第电磁感应定,0,0,0,0,1,0,0,1,0.24166666666666667
交流信号,0,0,0,0,2,0,0,2,0.48333333333333334
解码,0,0,0,0,2,0,0,2,0.48333333333333334
串扰对序列,0,0,0,0,3,0,0,3,0.725
pcb文件,1,0,0,1,4,0,1,7,2.333333333333333
分割比例,0,0,0,0,1,0,0,1,0.24166666666666667
深度,0,0,0,1,1,0,0,2,0.3666666666666667
seq2seq编码,0,0,0,0,1,0,0,1,0.24166666666666667
被干扰,0,0,0,0,1,0,0,1,0.24166666666666667
干扰,0,0,1,0,2,0,0,3,0.6083333333333334
串扰对,0,0,0,0,1,0,0,1,0.24166666666666667
netctosstaik,0,0,0,0,1,0,0,1,0.24166666666666667
lstm模型,0,0,0,0,2,0,0,2,0.48333333333333334
双向lstm模型,0,0,0,0,2,0,0,2,0.48333333333333334
编码,0,0,0,0,1,0,0,1,0.24166666666666667
seq2seq模型,0,0,0,0,2,0,0,2,0.48333333333333334
多层板,0,0,0,2,1,0,0,3,0.4916666666666667
层叠结构,0,0,0,2,2,0,0,4,0.7333333333333334
pcb板,1,0,1,3,8,0,0,13,3.4333333333333336
netcrosstalk,0,0,0,0,1,0,0,1,0.24166666666666667
串扰网络集,0,0,0,0,1,0,0,1,0.24166666666666667
人工标注,0,0,0,0,1,0,0,1,0.24166666666666667
串扰阈,0,0,0,0,1,0,0,1,0.24166666666666667
批量仿真,0,0,0,0,1,0,0,1,0.24166666666666667
仿真软件,1,0,1,0,1,0,0,3,1.3666666666666667
模型,0,0,0,0,1,0,0,1,0.24166666666666667
机器学习算法,1,0,0,0,1,0,0,2,1.2416666666666667
线段,0,0,0,9,39,1,0,49,10.791666666666666
顶点,0,0,0,0,5,0,0,5,1.2083333333333333
线宽,0,0,0,0,14,0,0,14,3.3833333333333333
有向图,0,0,0,0,4,0,0,4,0.9666666666666667
双向全连接,0,0,0,0,3,0,0,3,0.725
权重,0,0,0,6,3,0,0,9,1.475
距离,0,0,0,1,9,0,0,10,2.3
有向,0,0,0,0,2,0,0,2,0.48333333333333334
双向连接,0,0,0,0,2,0,0,2,0.48333333333333334
耦合对,0,0,0,0,2,0,0,2,0.48333333333333334
pcb电路板,0,0,0,0,3,0,0,3,0.725
临时网络,0,0,0,0,2,0,0,2,0.48333333333333334
平行线段,0,0,0,0,3,0,0,3,0.725
中心距离,0,0,0,0,1,0,0,1,0.24166666666666667
crosstalkco,0,0,0,0,4,0,0,4,0.9666666666666667
seg2,0,0,0,0,1,0,0,1,0.24166666666666667
sepl,0,0,0,0,1,0,0,1,0.24166666666666667
线宽信息,0,0,0,0,1,0,0,1,0.24166666666666667
双向图,0,0,0,0,1,0,0,1,0.24166666666666667
倍线宽,0,0,0,0,1,0,0,1,0.24166666666666667
节点,0,0,0,0,1,0,0,1,0.24166666666666667
全连接图,0,0,0,0,1,0,0,1,0.24166666666666667
出度命入度,0,0,0,0,1,0,0,1,0.24166666666666667
诫击线,0,0,0,0,1,0,0,1,0.24166666666666667
边和,0,0,0,0,1,0,0,1,0.24166666666666667
元素,0,0,0,2,5,0,0,7,1.4583333333333333
parallel集合,0,0,0,0,4,0,0,4,0.9666666666666667
线距,0,0,0,0,2,0,0,2,0.48333333333333334
时间复杂度,0,0,0,0,2,0,0,2,0.48333333333333334
seg,0,0,0,0,6,0,0,6,1.45
ral,0,0,0,0,1,0,0,1,0.24166666666666667
中心间距,0,0,0,0,1,0,0,1,0.24166666666666667
筛选条件,0,0,0,0,1,0,0,1,0.24166666666666667
线间距,0,0,0,0,4,0,0,4,0.9666666666666667
布线,0,0,1,2,3,0,0,6,1.1
平行线,0,0,0,0,1,0,0,1,0.24166666666666667
终止坐标,0,0,0,0,1,0,0,1,0.24166666666666667
起始坐标,0,0,0,0,2,0,0,2,0.48333333333333334
化卫,0,0,0,0,1,0,0,1,0.24166666666666667
兀人,0,0,0,0,1,0,0,1,0.24166666666666667
直线方程,0,0,0,0,1,0,0,1,0.24166666666666667
坐标,0,0,0,0,7,1,0,8,1.9333333333333333
parallel,0,0,0,0,3,0,0,3,0.725
耦合关系,0,0,0,0,1,0,0,1,0.24166666666666667
平行线集合,0,0,0,0,1,0,0,1,0.24166666666666667
存储临时网络集合,0,0,0,0,1,0,0,1,0.24166666666666667
seps集合,0,0,0,0,2,0,0,2,0.48333333333333334
nettemp,0,0,0,0,1,0,0,1,0.24166666666666667
paralle陳,0,0,0,0,1,0,0,1,0.24166666666666667
nettempo,0,0,0,0,1,0,0,1,0.24166666666666667
seg信息,0,0,0,0,1,0,0,1,0.24166666666666667
〃创集合,0,0,0,0,1,0,0,1,0.24166666666666667
para,0,0,0,0,1,0,0,1,0.24166666666666667
耦合对序列,0,0,0,0,1,0,0,1,0.24166666666666667
芯片,0,0,8,4,0,7,0,19,3.1916666666666664
板级,0,0,0,0,0,3,0,3,0.725
芯片管脚,0,0,1,0,0,3,0,4,0.85
参考回路,0,0,0,0,0,1,0,1,0.24166666666666667
低噪声,0,0,0,0,0,1,0,1,0.24166666666666667
低阻抗,0,0,0,0,0,1,0,1,0.24166666666666667
自电压源,0,0,0,0,0,1,0,1,0.24166666666666667
辐射,0,0,0,0,0,1,0,1,0.24166666666666667
导电电缆,0,0,0,0,0,1,0,1,0.24166666666666667
差模电流,0,0,0,0,0,1,0,1,0.24166666666666667
共模电流,0,0,0,0,0,1,0,1,0.24166666666666667
电磁场,0,0,0,2,0,1,1,4,0.7333333333333334
辐射电磁场,0,0,0,0,0,1,0,1,0.24166666666666667
微带线天线,0,0,0,0,0,1,0,1,0.24166666666666667
电源供电系统,0,0,0,0,0,2,0,2,0.48333333333333334
起伏,0,0,0,0,0,2,0,2,0.48333333333333334
直流电流,0,0,0,0,0,1,0,1,0.24166666666666667
去耦模块,0,0,0,0,0,1,0,1,0.24166666666666667
去耦电容,0,0,0,0,0,42,2,44,10.633333333333333
系统级,0,0,0,0,0,1,0,1,0.24166666666666667
芯片级,0,0,0,0,0,1,0,1,0.24166666666666667
电源完整性,0,0,1,0,0,1,1,3,0.6083333333333334
供电电压,0,0,2,0,0,3,0,5,0.975
谐振腔法,0,0,1,0,0,6,0,7,1.575
有限元法,0,0,1,0,0,11,0,12,2.783333333333333
小尺寸平面对,0,0,0,0,0,1,0,1,0.24166666666666667
平面对,0,0,0,0,0,4,0,4,0.9666666666666667
有限差分法,0,0,0,0,0,1,0,1,0.24166666666666667
地平面,3,0,4,1,1,44,2,55,14.983333333333334
电源地平面,0,0,5,0,0,5,0,10,1.8333333333333333
pcb2,0,0,0,0,3,0,0,3,0.725
pcb1,0,0,0,0,3,0,0,3,0.725
维度,0,0,0,0,3,0,0,3,0.725
连接线段,0,0,0,0,4,0,0,4,0.9666666666666667
接收端,0,0,0,0,3,0,0,3,0.725
驱动端,0,0,0,0,4,0,0,4,0.9666666666666667
维度拓展,0,0,0,0,2,0,0,2,0.48333333333333334
全零向量,0,0,0,0,2,0,0,2,0.48333333333333334
pcb板矩阵,0,0,0,0,2,0,0,2,0.48333333333333334
线段信息,0,0,0,0,2,0,0,2,0.48333333333333334
信息,0,0,0,0,7,0,0,7,1.6916666666666667
填充,0,0,0,0,2,0,0,2,0.48333333333333334
序列,0,0,2,0,7,0,0,9,1.9416666666666667
层叠数据信息,0,0,0,0,2,0,0,2,0.48333333333333334
端接信息,0,0,0,0,3,0,0,3,0.725
拓扑,0,0,0,0,3,0,0,3,0.725
网络模型,0,0,0,0,1,0,0,1,0.24166666666666667
pcbl,0,0,0,0,1,0,0,1,0.24166666666666667
dim,0,0,0,0,1,0,0,1,0.24166666666666667
网络拓扑结构,0,0,0,0,1,0,0,1,0.24166666666666667
训练数据,0,0,0,0,2,0,0,2,0.48333333333333334
net集令,0,0,0,0,1,0,0,1,0.24166666666666667
厚度,0,0,0,11,5,3,0,19,3.3083333333333336
层数,0,0,0,0,1,0,0,1,0.24166666666666667
宽度,0,0,0,7,5,1,0,13,2.325
长度,0,0,0,5,10,2,0,17,3.525
尺寸,1,0,0,2,2,1,0,6,1.975
pcb板信息,0,0,0,0,1,0,0,1,0.24166666666666667
网络信息,0,0,0,0,1,0,0,1,0.24166666666666667
pcb串扰,0,0,0,0,1,0,0,1,0.24166666666666667
过孔,3,0,7,14,17,19,2,62,14.808333333333334
连接线,0,0,0,0,1,0,0,1,0.24166666666666667
无源器件管脚,0,0,0,0,4,0,0,4,0.9666666666666667
驱动端管腳,0,0,0,0,1,0,0,1,0.24166666666666667
幅度,0,0,0,0,5,1,0,6,1.45
端口,0,0,0,3,2,8,0,13,2.7916666666666665
下降时间,1,0,0,0,7,0,0,8,2.6916666666666664
上升,0,0,0,0,5,0,0,5,1.2083333333333333
电压曲线,0,0,0,0,16,0,0,16,3.8666666666666667
电压波形,0,0,0,0,1,0,0,1,0.24166666666666667
方波,0,0,0,0,1,0,0,1,0.24166666666666667
频率变化,0,0,0,0,1,0,0,1,0.24166666666666667
串扰能力,0,0,0,0,1,0,0,1,0.24166666666666667
仿真分析,0,0,0,0,1,0,0,1,0.24166666666666667
ibis模型,0,0,0,4,2,0,0,6,0.9833333333333334
田is模型,0,0,0,0,1,0,0,1,0.24166666666666667
供电端口,0,0,0,0,1,0,0,1,0.24166666666666667
端|口属性,0,0,0,0,1,0,0,1,0.24166666666666667
信号幅度,0,0,0,1,1,0,0,2,0.3666666666666667
pcb走线,0,0,2,0,0,0,0,2,0.25
传输线阻抗,0,0,1,0,0,0,0,1,0.125
高频特性,0,0,1,0,0,0,0,1,0.125
管脚,0,0,1,9,17,7,1,35,7.291666666666667
传输线拓扑结构,1,0,1,0,3,0,1,6,2.091666666666667
波形,0,0,1,0,0,0,0,1,0.125
端口示波器,0,0,1,0,0,0,0,1,0.125
pcb批量仿真,0,0,1,0,0,0,0,1,0.125
坐标信息,0,0,0,0,6,0,0,6,1.45
样本数据,0,0,0,0,2,0,0,2,0.48333333333333334
区间,0,0,0,0,2,0,0,2,0.48333333333333334
缩放,0,0,0,0,2,0,0,2,0.48333333333333334
梯度,0,0,0,0,2,0,0,2,0.48333333333333334
纵坐标,0,0,0,0,3,0,0,3,0.725
横坐标,0,0,0,0,3,0,0,3,0.725
单位,0,0,0,0,1,0,0,1,0.24166666666666667
pcb尺寸,0,0,0,0,1,0,0,1,0.24166666666666667
预处理,0,0,0,0,1,0,0,1,0.24166666666666667
pcb数据,0,0,0,0,1,0,0,1,0.24166666666666667
标准正态分布,0,0,0,0,1,0,0,1,0.24166666666666667
分布,0,0,0,0,1,1,0,2,0.48333333333333334
均值,0,0,0,0,1,0,0,1,0.24166666666666667
标准差标准化,0,0,0,0,1,0,0,1,0.24166666666666667
相似性,0,0,0,0,1,0,0,1,0.24166666666666667
向量,0,0,0,0,1,0,0,1,0.24166666666666667
速度,0,0,0,1,1,1,0,3,0.6083333333333334
数据预处理,0,0,0,0,1,0,0,1,0.24166666666666667
数据归一化,0,0,0,0,1,0,0,1,0.24166666666666667
批量仿真时间,0,0,0,0,1,0,0,1,0.24166666666666667
解码器,0,0,0,0,1,0,0,1,0.24166666666666667
编码器,0,0,0,0,1,0,0,1,0.24166666666666667
数据结构,0,0,0,0,1,0,0,1,0.24166666666666667
干扰因素,0,0,1,0,2,0,0,3,0.6083333333333334
电路叠层,0,0,0,0,1,0,0,1,0.24166666666666667
导线,0,0,2,17,12,2,0,33,5.758333333333333
传输线串扰,0,0,2,0,1,0,0,3,0.4916666666666667
数据格式,1,0,0,0,1,0,0,2,1.2416666666666667
介电常数,0,0,1,1,4,2,0,8,1.7
层叠,0,0,0,1,5,0,0,6,1.3333333333333333
干扰能力,0,0,0,0,3,0,0,3,0.725
电压曲,0,0,0,0,1,0,0,1,0.24166666666666667
绿色线,0,0,0,0,1,0,0,1,0.24166666666666667
红色线,0,0,0,0,1,0,0,1,0.24166666666666667
电压变化曲线,0,0,0,0,1,0,0,1,0.24166666666666667
层厚导线,0,0,0,0,1,0,0,1,0.24166666666666667
下攻击线,0,0,0,0,1,0,0,1,0.24166666666666667
层叠参数,0,0,0,0,1,0,0,1,0.24166666666666667
存储电荷,0,0,0,0,1,0,0,1,0.24166666666666667
等效电容,0,0,0,0,3,1,0,4,0.9666666666666667
相对介电常数,0,0,0,5,1,2,0,8,1.35
环氧树脂材料,0,0,0,0,1,0,0,1,0.24166666666666667
fr4材料,0,0,0,0,1,1,0,2,0.48333333333333334
层叠參数,0,0,0,0,1,0,0,1,0.24166666666666667
输入阻抗,0,0,0,0,0,1,0,1,0.24166666666666667
级联传输矩阵,0,0,0,0,0,1,0,1,0.24166666666666667
阻抗计算,0,0,0,0,0,1,0,1,0.24166666666666667
属性参数,0,0,0,0,5,0,0,5,1.2083333333333333
拓扑结,0,0,0,0,1,0,0,1,0.24166666666666667
dq5,0,0,0,0,2,0,0,2,0.48333333333333334
信号层,0,0,0,2,1,2,0,5,0.975
hyperlynxlines,0,0,0,0,1,0,0,1,0.24166666666666667
带状线,0,0,1,8,1,0,0,10,1.3666666666666667
开发,0,0,0,0,1,0,0,1,0.24166666666666667
hyperlynxboardsim仿真软件,0,0,0,0,1,0,0,1,0.24166666666666667
层叠信息,0,0,0,2,2,0,0,4,0.7333333333333334
耦合长度,0,0,0,0,7,0,0,7,1.6916666666666667
双线,0,0,0,0,1,0,0,1,0.24166666666666667
平行段,0,0,0,0,1,0,0,1,0.24166666666666667
常规数值,0,0,0,3,0,0,0,3,0.375
频段,0,0,0,1,0,2,0,3,0.6083333333333334
咲差,0,0,0,1,0,0,0,1,0.125
低频等效方法,0,0,0,1,0,0,0,1,0.125
cadence,1,0,0,1,0,0,0,2,1.125
全波仿真法,0,0,0,1,0,0,0,1,0.125
曲线,0,0,0,2,1,2,0,5,0.975
步长,0,0,0,2,0,0,0,2,0.25
趋肤深度,0,0,0,10,0,1,0,11,1.4916666666666667
铜质材料,0,0,0,1,0,0,0,1,0.125
秦数,0,0,0,1,0,0,0,1,0.125
电路,1,0,3,13,4,7,2,30,6.141666666666667
sig,0,0,0,2,0,0,0,2,0.25
走线长度,0,0,0,5,0,0,0,5,0.625
isl54050,0,0,0,2,0,0,0,2,0.25
有源器件管脚,0,0,0,2,9,0,0,11,2.425
pin,0,0,0,2,4,0,0,6,1.2166666666666668
參数,0,0,0,1,0,0,0,1,0.125
自反射系数,0,0,0,1,0,0,0,1,0.125
仿真频率,0,0,0,1,0,0,0,1,0.125
边缘引脚,0,0,0,1,0,0,0,1,0.125
cadencesigrity,0,0,0,1,2,0,0,3,0.6083333333333334
全波仿真工具,0,0,0,1,1,0,0,2,0.3666666666666667
线程,0,0,0,1,0,0,0,1,0.125
分布式计算能,0,0,0,1,0,0,0,1,0.125
全波电磁场分析,0,0,0,1,0,0,0,1,0.125
sigrity,0,0,0,1,0,0,0,1,0.125
ence,0,0,0,1,1,0,0,2,0.3666666666666667
板级仿真工具,0,0,0,1,0,0,0,1,0.125
反射仿真,0,0,0,1,0,0,0,1,0.125
3cadencesigrity,0,0,0,1,0,0,0,1,0.125
mhz,0,0,0,1,0,0,0,1,0.125
s11参数曲线,0,0,0,1,0,0,0,1,0.125
精度,1,0,0,4,0,2,0,7,1.9833333333333334
点数,0,0,0,1,0,0,0,1,0.125
s11曲线,0,0,0,1,0,0,0,1,0.125
步长采样,0,0,0,1,0,0,0,1,0.125
拟合函数,0,0,0,1,0,0,0,1,0.125
函数,0,0,0,1,0,0,0,1,0.125
参数曲线,0,0,0,1,0,0,0,1,0.125
s1,0,0,0,1,0,0,0,1,0.125
非线性曲线,0,0,0,1,0,0,0,1,0.125
高斯积分法,0,0,0,1,0,0,0,1,0.125
su参数,0,0,0,1,0,0,0,1,0.125
termo,0,0,0,1,0,0,0,1,0.125
s参数端口,0,0,0,1,0,0,0,1,0.125
负载端,0,0,0,3,0,1,0,4,0.6166666666666667
源端,0,0,0,5,0,0,0,5,0.625
ads仿真频率,0,0,0,1,0,0,0,1,0.125
仿真验证,0,0,0,1,0,0,0,1,0.125
advanceddesignedsystem,0,0,0,1,0,0,0,1,0.125
性能,0,0,6,2,0,0,0,8,1.0
圈2-13传输线,0,0,0,1,0,0,0,1,0.125
电气模型,0,0,0,1,0,0,0,1,0.125
盧线框,0,0,0,1,0,0,0,1,0.125
过孔电容电感,0,0,0,1,0,0,0,1,0.125
损耗角,0,0,0,1,0,1,0,2,0.3666666666666667
电导率,0,0,0,5,1,0,0,6,0.8666666666666667
阻抗突变,0,0,0,4,1,0,2,7,1.225
互连线分支,0,0,0,1,0,0,0,1,0.125
分支走线,0,0,0,1,0,0,0,1,0.125
layer6,0,0,0,2,0,0,0,2,0.25
layerl,0,0,0,1,0,0,0,1,0.125
文件,0,0,0,1,1,0,0,2,0.3666666666666667
代码,0,0,1,1,2,0,0,4,0.7333333333333334
读取,0,0,0,1,1,0,0,2,0.3666666666666667
通信,0,0,0,1,0,0,0,1,0.125
选通数据信号,0,0,0,1,0,0,0,1,0.125
fpga芯片,0,0,0,1,0,0,0,1,0.125
读取pcb文件,0,0,0,1,0,0,0,1,0.125
单刀双掷模拟开关,0,0,0,1,0,0,0,1,0.125
双重低压,0,0,0,1,0,0,0,1,0.125
cpld,0,0,0,2,0,0,0,2,0.25
fpga,0,0,0,1,0,0,0,1,0.125
位置信息,0,0,1,1,4,0,0,6,1.2166666666666668
连通,0,0,0,1,0,0,0,1,0.125
po,0,0,0,1,0,0,0,1,0.125
驱动器,0,0,0,1,0,0,0,1,0.125
焊盘,0,0,0,3,3,0,0,6,1.1
封装电感,0,0,0,1,0,0,0,1,0.125
封装电容,0,0,0,1,1,0,0,2,0.3666666666666667
封装电阻,0,0,0,1,0,0,0,1,0.125
pcb仿真,0,0,0,1,0,0,0,1,0.125
电感信息,0,0,0,1,0,0,0,1,0.125
寄生电容,0,0,0,3,1,1,0,5,0.8583333333333334
管脚封装,0,0,0,1,0,0,0,1,0.125
阻抗匹配,0,0,0,1,0,0,0,1,0.125
终端负载,0,0,0,4,0,0,0,4,0.5
终端端接,0,0,0,1,0,0,0,1,0.125
gnd,0,0,0,2,0,0,0,2,0.25
地层,0,0,0,1,0,1,0,2,0.3666666666666667
vcc,0,0,0,2,0,0,0,2,0.25
电源层,0,0,0,1,0,2,0,3,0.6083333333333334
pcb线路,0,0,0,1,0,0,0,1,0.125
*效电路,0,0,0,1,0,0,0,1,0.125
寄生电容电感,0,0,0,1,0,0,0,1,0.125
导线网络,0,0,0,1,0,0,0,1,0.125
暮效电仿真,0,0,0,1,0,0,0,1,0.125
履射,0,0,0,1,0,0,0,1,0.125
电磁兼容,0,0,6,0,0,0,0,6,0.75
开关噪声,0,0,3,0,0,0,0,3,0.375
电源分配系统,0,0,4,0,0,4,0,8,1.4666666666666668
电源系统,0,0,3,0,0,0,0,3,0.375
通孔,0,0,2,0,0,1,0,3,0.4916666666666667
串扰问题,0,0,4,0,2,0,0,6,0.9833333333333334
微带线,0,0,2,11,1,0,0,14,1.8666666666666667
fem,0,0,2,0,0,1,0,3,0.4916666666666667
电源完整性分析,0,0,1,0,0,0,0,1,0.125
ssn,0,0,1,0,0,0,0,1,0.125
噪声,1,0,1,0,1,2,0,5,1.85
电源噪声,0,0,3,0,0,0,0,3,0.375
共模噪声,0,0,2,0,0,0,0,2,0.25
全波电磁仿真,0,0,1,0,0,0,0,1,0.125
电源地平面谐振腔,0,0,1,0,0,0,0,1,0.125
无穷级数,0,0,1,0,0,0,0,1,0.125
一级,0,0,1,0,0,0,0,1,0.125
二级无穷级数,0,0,1,0,0,0,0,1,0.125
阻抗矩阵,0,0,1,0,0,5,0,6,1.3333333333333333
地平面结构,0,0,1,0,0,0,0,1,0.125
谐振腔,0,0,2,0,0,8,0,10,2.1833333333333336
高频电路板,0,0,1,0,0,0,0,1,0.125
电路模型,0,0,1,0,0,0,0,1,0.125
电学属性,0,0,1,0,0,0,0,1,0.125
互联,0,0,1,0,0,0,0,1,0.125
电源分析系统,0,0,1,0,0,0,0,1,0.125
局部元件等效法,0,0,1,0,0,0,0,1,0.125
宏模型法,0,0,1,0,0,0,0,1,0.125
模型降阶法,0,0,1,0,0,0,0,1,0.125
传输矩阵法,0,0,1,0,0,0,0,1,0.125
pee,0,0,1,0,0,0,0,1,0.125
等效电路法,0,0,1,0,0,0,1,2,0.3666666666666667
局部元件,0,0,1,0,0,0,0,1,0.125
去耦,0,0,1,0,1,1,0,3,0.6083333333333334
噪声分析,0,0,1,0,0,0,0,1,0.125
pcb研,0,0,1,0,0,0,0,1,0.125
整性,0,0,1,0,0,1,2,4,0.85
高频电路,0,0,1,4,0,0,0,5,0.625
串扰噪声,0,0,1,0,0,0,0,1,0.125
极性,0,0,1,0,0,0,0,1,0.125
沟槽设计,0,0,1,0,0,0,0,1,0.125
pcb板材,0,0,1,0,0,0,0,1,0.125
水平走线,0,0,1,0,0,0,0,1,0.125
垂直走线,0,0,1,0,0,0,0,1,0.125
直走线串扰,0,0,1,0,0,0,0,1,0.125
pcb焊盘,0,0,1,0,0,0,0,1,0.125
通孔关联协矩阵,0,0,1,0,0,0,0,1,0.125
全波分析,0,0,1,0,0,0,0,1,0.125
耦合噪声,0,0,1,0,0,0,0,1,0.125
边界原,0,0,1,0,0,0,0,1,0.125
场方程积分公,0,0,1,0,0,0,0,1,0.125
pcb异面,0,0,1,0,0,0,0,1,0.125
pcb板传输线,0,0,1,0,0,0,0,1,0.125
有限差分,0,0,1,0,0,0,0,1,0.125
时域,0,0,2,0,0,0,0,2,0.25
连接路径,0,0,1,0,0,0,0,1,0.125
串扰问,0,0,1,0,0,0,0,1,0.125
物理参数变量,0,0,1,0,0,0,0,1,0.125
噪声源,0,0,1,0,0,1,0,2,0.3666666666666667
pcb信号,0,0,1,0,0,0,0,1,0.125
芯片管脚封装,0,0,1,0,0,0,0,1,0.125
ddr4印刷电路板,0,0,1,0,0,0,0,1,0.125
低电压,0,0,1,0,0,0,0,1,0.125
接时信号,0,0,1,0,0,0,0,1,0.125
终端端,0,0,1,0,0,0,0,1,0.125
寄生参数,0,0,2,0,1,0,0,3,0.4916666666666667
高频信号,2,0,2,6,0,3,1,14,3.966666666666667
内源端,0,0,1,0,0,0,0,1,0.125
基板材料,0,0,1,0,0,0,0,1,0.125
传输线模型,0,0,1,0,0,0,0,1,0.125
微波,0,0,1,0,0,0,0,1,0.125
高频时代,0,0,1,0,0,0,0,1,0.125
自然现象,0,0,1,0,0,0,0,1,0.125
电磁兼容技术,0,0,1,0,0,0,0,1,0.125
高速电路,0,0,1,1,0,0,0,2,0.25
小米,0,0,1,0,0,0,0,1,0.125
大疆,0,0,1,0,0,0,0,1,0.125
华为,0,0,1,0,0,0,0,1,0.125
准化,0,0,1,0,0,0,0,1,0.125
邮电大,0,0,1,0,0,0,0,1,0.125
电磁兼容性,0,0,1,1,0,0,0,2,0.25
linesim软件,0,0,1,0,0,0,0,1,0.125
boardsim,0,0,1,0,0,0,0,1,0.125
mentor,0,0,1,0,0,0,0,1,0.125
电磁兼容仿真功能,0,0,1,0,0,0,0,1,0.125
版图布局,0,0,1,0,0,0,0,1,0.125
原理图绘,0,0,1,0,0,0,0,1,0.125
cadencesigrity软件,0,0,1,0,0,0,0,1,0.125
oread,0,0,1,0,0,0,0,1,0.125
恺登电子公司,0,0,1,0,0,0,0,1,0.125
hfss软件,0,0,1,0,0,0,0,1,0.125
siwave,0,0,1,0,0,0,0,1,0.125
ansys,0,0,1,0,0,1,0,2,0.3666666666666667
实验室仿真,0,0,1,0,0,0,0,1,0.125
电磁,0,0,1,0,0,0,0,1,0.125
数据处理,0,0,1,0,0,0,0,1,0.125
主频率,0,0,1,0,0,0,0,1,0.125
计算机,0,0,1,0,3,0,1,5,1.0916666666666668
fdtd,0,0,1,0,0,0,0,1,0.125
时域有限积分法,0,0,1,0,0,0,0,1,0.125
时域积分法,0,0,1,0,0,0,0,1,0.125
在时域,0,0,1,0,0,0,0,1,0.125
bem,0,0,1,0,0,0,0,1,0.125
边界元法,0,0,1,0,0,0,0,1,0.125
tlm,0,0,1,0,0,0,0,1,0.125
传输线法,0,0,1,0,0,0,0,1,0.125
mom,0,0,1,0,0,0,0,1,0.125
fdm,0,0,1,0,0,0,0,1,0.125
差分法,0,0,1,0,0,1,0,2,0.3666666666666667
在频域,0,0,1,0,0,0,0,1,0.125
时域法,0,0,1,0,0,0,0,1,0.125
频域法,0,0,1,0,0,0,0,1,0.125
求解场,0,0,1,0,0,0,0,1,0.125
计算效率,0,0,1,0,0,1,0,2,0.3666666666666667
计算机辅助设计,0,0,1,0,0,0,0,1,0.125
闭环方程,0,0,1,0,0,0,0,1,0.125
天线理论,0,0,1,0,0,0,0,1,0.125
计算电磁学,0,0,1,0,0,0,0,1,0.125
segs集合,0,0,0,0,2,0,0,2,0.48333333333333334
耦合段,0,0,0,0,2,0,0,2,0.48333333333333334
activejpin,0,0,0,0,6,0,0,6,1.45
passivejptn,0,0,0,0,1,0,0,1,0.24166666666666667
gs,0,0,0,0,2,0,0,2,0.48333333333333334
器件信息,0,0,0,0,2,0,0,2,0.48333333333333334
单条网络,0,0,0,0,1,0,0,1,0.24166666666666667
序列信息,0,0,0,0,1,0,0,1,0.24166666666666667
水平,0,0,0,0,1,0,0,1,0.24166666666666667
parade!集合,0,0,0,0,1,0,0,1,0.24166666666666667
seg线段,0,0,0,0,1,0,0,1,0.24166666666666667
tan&数值,0,0,0,0,1,0,0,1,0.24166666666666667
正切,0,0,0,0,1,0,0,1,0.24166666666666667
终止坐标区,0,0,0,0,1,0,0,1,0.24166666666666667
拐角,0,0,0,0,1,0,0,1,0.24166666666666667
h面双拐,0,0,0,0,1,0,0,1,0.24166666666666667
e面双拐,0,0,0,0,1,0,0,1,0.24166666666666667
e面弯曲,0,0,0,0,1,0,0,1,0.24166666666666667
直角弯,0,0,0,0,1,0,0,1,0.24166666666666667
减小信号,0,0,0,0,1,0,0,1,0.24166666666666667
pcb布线,0,0,0,0,1,0,0,1,0.24166666666666667
数据抽取,0,0,0,0,1,0,0,1,0.24166666666666667
串扰仿真,1,0,0,0,1,0,0,2,1.2416666666666667
层叠厚度,0,0,0,0,1,0,0,1,0.24166666666666667
间距,0,0,0,0,2,1,0,3,0.725
pcb平行线段,0,0,0,0,1,0,0,1,0.24166666666666667
电阻,0,0,0,19,1,2,0,22,3.1
特征阻抗,0,0,0,8,0,0,0,8,1.0
负载,0,0,0,2,0,10,0,12,2.6666666666666665
源驱动器,0,0,0,2,0,0,0,2,0.25
并联,0,0,0,2,0,0,0,2,0.25
直径,0,0,0,2,0,0,0,2,0.25
阻抗,0,0,3,8,1,23,0,35,7.175
反射现象,0,0,0,4,0,0,0,4,0.5
输出阻抗,0,0,0,1,0,2,0,3,0.6083333333333334
传输线信息,0,0,0,1,0,0,0,1,0.125
反射信号,0,0,0,3,0,0,0,3,0.375
驱动端内阻,0,0,0,1,0,0,0,1,0.125
电阻值,0,0,0,3,0,0,0,3,0.375
电阻心,0,0,0,1,0,0,0,1,0.125
接地面,0,0,0,1,0,0,0,1,0.125
功耗,0,0,0,1,0,0,0,1,0.125
信号线,0,0,0,3,2,0,0,5,0.8583333333333334
分压,0,0,0,1,0,0,0,1,0.125
电源内阻,0,0,0,1,0,0,0,1,0.125
值心,0,0,0,1,0,0,0,1,0.125
内阻抗,0,0,0,1,0,0,0,1,0.125
并联终端,0,0,0,1,0,0,0,1,0.125
串联终端,0,0,0,1,0,0,0,1,0.125
串联,0,0,0,1,0,0,0,1,0.125
终端匹配,0,0,0,1,0,0,0,1,0.125
终端阻抗,0,0,0,1,0,0,0,1,0.125
d过孔,0,0,0,1,0,0,0,1,0.125
焊盘直径,0,0,0,1,0,0,0,1,0.125
电气间隙直径,0,0,0,1,0,0,0,1,0.125
平面,0,0,1,3,1,6,0,11,2.1916666666666664
填充物,0,0,0,1,0,0,0,1,0.125
近似值,0,0,0,1,0,0,0,1,0.125
寄生电感,0,0,0,1,0,0,0,1,0.125
分布电感,0,0,0,4,0,0,0,4,0.5
分布电容,0,0,0,3,2,0,0,5,0.8583333333333334
互感,0,0,0,5,2,0,0,7,1.1083333333333334
自感,0,0,0,4,0,0,0,4,0.5
带电体,0,0,0,1,0,0,0,1,0.125
电容效应,0,0,0,1,0,0,0,1,0.125
导体,0,0,0,16,4,1,0,21,3.208333333333333
金属焊盘,0,0,0,1,0,0,0,1,0.125
属性,0,0,0,2,0,1,0,3,0.4916666666666667
过孔结构,0,0,0,1,0,0,0,1,0.125
隔离区,0,0,0,1,0,0,0,1,0.125
平面层,0,0,0,1,0,0,0,1,0.125
圆柱体,0,0,0,1,0,0,0,1,0.125
通孔元件,0,0,0,1,0,0,0,1,0.125
跨层走线,0,0,0,1,0,0,0,1,0.125
横截面积,0,0,0,5,0,0,0,5,0.625
弧线型弯折,0,0,0,1,0,0,0,1,0.125
直角弯折,0,0,0,1,0,0,0,1,0.125
横截面,0,0,0,3,0,1,0,4,0.6166666666666667
相连导线,0,0,0,1,0,0,0,1,0.125
工程,0,0,0,1,0,0,0,1,0.125
传输线效应,0,0,0,1,0,0,0,1,0.125
周围走线,0,0,0,1,0,0,0,1,0.125
旁路,0,0,1,1,0,0,0,2,0.25
反射中传输线,0,0,0,1,0,0,0,1,0.125
pcb版图,0,0,0,1,0,0,0,1,0.125
宿号线,0,0,0,1,0,0,0,1,0.125
振幅,0,0,0,1,0,0,0,1,0.125
反射噪声,0,0,0,1,0,0,0,1,0.125
pcb电路,0,0,0,1,0,0,0,1,0.125
电感,0,0,0,12,2,6,0,20,3.4333333333333336
自电阻,0,0,0,1,0,0,0,1,0.125
布线层间过孔,0,0,0,1,0,0,0,1,0.125
走线宽度,0,0,0,1,0,0,0,1,0.125
cb,0,0,0,1,0,0,0,1,0.125
磁通,0,0,0,3,0,0,0,3,0.375
传输线厚度,0,0,0,2,0,0,0,2,0.25
截面电流,0,0,0,1,0,0,0,1,0.125
电流强度,0,0,0,1,0,0,0,1,0.125
截面,0,0,0,1,0,0,0,1,0.125
螺旋,0,0,0,1,0,0,0,1,0.125
截面电流分布图,0,0,0,1,0,0,0,1,0.125
磁通量,0,0,0,1,1,0,0,2,0.3666666666666667
高频传输线,0,0,0,2,0,0,0,2,0.25
相对磁导率,0,0,0,1,0,0,0,1,0.125
导体材料,0,0,0,1,0,0,0,1,0.125
电阻率,0,0,0,1,0,1,0,2,0.3666666666666667
长宽,0,0,0,1,0,0,0,1,0.125
集中电流,0,0,0,1,0,0,0,1,0.125
电流密度,0,0,0,5,0,0,0,5,0.625
平均分布,0,0,0,1,0,0,0,1,0.125
电荷分布,0,0,0,1,0,0,0,1,0.125
交流电,0,0,0,1,0,0,0,1,0.125
低频电路,0,0,0,2,0,0,0,2,0.25
spice模型,0,0,0,2,0,0,0,2,0.25
传输矩阵,0,0,0,0,0,8,1,9,2.175
地平面阻抗,0,0,0,0,0,5,2,7,1.6916666666666667
等效,0,0,0,0,1,2,1,4,0.9666666666666667
多节点仿真,1,0,0,0,0,1,1,3,1.4833333333333334
cadencepi,0,0,0,0,0,1,0,1,0.24166666666666667
级联二端口网络,0,0,0,0,0,1,0,1,0.24166666666666667
接地,0,0,0,0,0,1,0,1,0.24166666666666667
电源开关噪声,0,0,0,0,0,1,0,1,0.24166666666666667
不期待信号噪声,0,0,0,0,0,1,0,1,0.24166666666666667
去耦原,0,0,0,0,0,1,0,1,0.24166666666666667
vrm,0,0,0,0,0,14,0,14,3.3833333333333333
电压调节模块,0,0,0,0,0,7,0,7,1.6916666666666667
无源器件,0,0,0,0,6,3,1,10,2.4166666666666665
队列,0,0,0,0,2,0,0,2,0.48333333333333334
集合,0,0,0,0,3,0,1,4,0.9666666666666667
跨层,0,0,0,1,2,0,0,3,0.6083333333333334
vias,0,0,0,0,2,0,0,2,0.48333333333333334
passivejpirii,0,0,0,0,1,0,0,1,0.24166666666666667
时长,0,0,0,0,1,0,0,1,0.24166666666666667
modegosstaik,0,0,0,0,1,0,0,1,0.24166666666666667
拓扑结构序列,0,0,0,0,1,0,0,1,0.24166666666666667
互联线,0,0,0,0,1,0,0,1,0.24166666666666667
fifo,0,0,0,0,1,0,0,1,0.24166666666666667
dfs,0,0,0,0,1,0,0,1,0.24166666666666667
深度优先搜索,0,0,0,0,1,0,0,1,0.24166666666666667
删减操,0,0,0,0,1,0,0,1,0.24166666666666667
过孔集合,0,0,0,0,1,0,0,1,0.24166666666666667
分支,0,0,0,0,1,0,0,1,0.24166666666666667
过孔处,0,0,0,0,1,0,0,1,0.24166666666666667
坐标点,0,0,0,0,2,1,0,3,0.725
端点,0,0,0,0,1,0,0,1,0.24166666666666667
queue,0,0,0,0,1,0,0,1,0.24166666666666667
元素信息,0,0,0,0,1,0,0,1,0.24166666666666667
序列集合,0,0,0,0,1,0,0,1,0.24166666666666667
passive,0,0,0,0,1,0,0,1,0.24166666666666667
actiue,0,0,0,0,1,0,0,1,0.24166666666666667
形状规,0,0,0,0,0,1,0,1,0.24166666666666667
场分析法,1,0,0,1,0,2,0,4,1.6083333333333334
波动方程,0,0,0,0,0,1,0,1,0.24166666666666667
电磁学,0,0,0,0,0,1,0,1,0.24166666666666667
误差补偿,0,0,0,0,0,1,0,1,0.24166666666666667
降维过程,0,0,0,0,0,1,0,1,0.24166666666666667
46姆霍兹方程,0,0,0,0,0,1,0,1,0.24166666666666667
二维,0,0,0,0,0,1,0,1,0.24166666666666667
计算资源,0,0,0,0,0,1,0,1,0.24166666666666667
分量,0,0,0,1,0,1,0,2,0.3666666666666667
频域,0,0,1,0,0,1,0,2,0.3666666666666667
表面电阻率,0,0,0,0,0,1,0,1,0.24166666666666667
导电层,0,0,0,0,0,1,0,1,0.24166666666666667
表面阻抗,0,0,0,0,0,1,0,1,0.24166666666666667
磁导率,0,0,0,0,0,1,0,1,0.24166666666666667
平面中间介质,0,0,0,0,0,1,0,1,0.24166666666666667
复横向波数,0,0,0,0,0,1,0,1,0.24166666666666667
计算系数,0,0,0,0,0,1,0,1,0.24166666666666667
波长,0,0,0,3,0,1,0,4,0.6166666666666667
截止频率,0,0,0,0,0,1,0,1,0.24166666666666667
xbyhxj,0,0,0,0,0,1,0,1,0.24166666666666667
smc,0,0,0,0,0,1,0,1,0.24166666666666667
亥姆霍兹方程,0,0,0,0,0,1,0,1,0.24166666666666667
格林函数,0,0,0,0,0,2,0,2,0.48333333333333334
磁壁,0,0,0,0,0,1,0,1,0.24166666666666667
边界,0,0,1,1,0,3,0,5,0.975
二维亥姆霍兹方程,0,0,0,0,0,1,0,1,0.24166666666666667
矩形谐振腔,0,0,0,0,0,1,0,1,0.24166666666666667
lc振荡回路,0,0,0,0,0,1,0,1,0.24166666666666667
集中参数,0,0,0,0,0,1,0,1,0.24166666666666667
储能,0,0,0,0,0,1,0,1,0.24166666666666667
选频,0,0,0,0,0,1,0,1,0.24166666666666667
波导,0,0,0,0,0,1,0,1,0.24166666666666667
微波传输,0,0,0,0,0,1,0,1,0.24166666666666667
高斯点,0,0,0,4,0,0,0,4,0.5
细丝,0,0,0,6,0,0,0,6,0.75
电感矩阵,0,0,0,4,0,0,0,4,0.5
求和,0,0,0,2,0,0,0,2,0.25
横纵坐标,0,0,0,2,0,0,0,2,0.25
坐标差,0,0,0,2,0,0,0,2,0.25
序号,0,0,0,2,0,1,0,3,0.4916666666666667
二维高斯点,0,0,0,2,0,0,0,2,0.25
系数,0,0,0,2,0,0,0,2,0.25
电阻矩阵,0,0,0,3,0,0,0,3,0.375
高斯定义域,0,0,0,1,0,0,0,1,0.125
细丝数,0,0,0,1,0,0,0,1,0.125
thickness,0,0,0,1,0,0,0,1,0.125
width,0,0,0,1,2,0,0,3,0.6083333333333334
数量,0,0,0,1,0,0,0,1,0.125
细线,0,0,0,1,0,0,0,1,0.125
高斯积分点,0,0,0,1,0,0,0,1,0.125
jmnm,0,0,0,1,0,0,0,1,0.125
nrn2,0,0,0,1,0,0,0,1,0.125
采样点,0,0,0,1,0,1,0,2,0.3666666666666667
采样点数,0,0,0,1,0,0,0,1,0.125
解积分,0,0,0,1,0,0,0,1,0.125
高斯积分,0,0,0,1,0,0,0,1,0.125
高斯积分采样点,0,0,0,1,0,0,0,1,0.125
勒让德取点,0,0,0,1,0,0,0,1,0.125
二维高斯积分,0,0,0,1,0,0,0,1,0.125
高斯积分函数,0,0,0,1,0,0,0,1,0.125
积分,0,0,0,2,0,0,0,2,0.25
矩阵元素,0,0,0,1,0,0,0,1,0.125
对数函数,0,0,0,1,0,0,0,1,0.125
对称矩阵,0,0,0,1,0,0,0,1,0.125
表达式,0,0,0,2,0,0,0,2,0.25
细丝横截面积,0,0,0,1,0,0,0,1,0.125
检验函数,0,0,0,4,0,0,0,4,0.5
基函数,0,0,0,10,0,0,0,10,1.25
对角矩阵,0,0,0,1,0,0,0,1,0.125
对角元素,0,0,0,1,0,0,0,1,0.125
互电阻,0,0,0,1,0,0,0,1,0.125
解析,0,0,0,0,0,0,2,2,0.48333333333333334
等效模型,0,0,0,0,0,0,1,1,0.24166666666666667
级联分析,0,0,0,0,0,0,1,1,0.24166666666666667
最终阻抗,0,0,0,0,0,0,1,1,0.24166666666666667
rlcg参数,0,0,0,0,0,0,1,1,0.24166666666666667
转移阻抗,0,0,0,0,0,1,1,2,0.48333333333333334
级联,0,0,0,0,0,2,1,3,0.725
二端口网络,0,0,0,2,0,5,1,8,1.7
攻击网络,0,0,0,0,0,0,1,1,0.24166666666666667
数据序列,0,0,0,0,0,0,1,1,0.24166666666666667
批量化串扰预测,0,0,0,0,0,0,1,1,0.24166666666666667
硬件条件,0,0,0,0,0,0,1,1,0.24166666666666667
运算时间,0,0,0,0,0,0,1,1,0.24166666666666667
布线跨层,0,0,0,0,0,0,1,1,0.24166666666666667
发射,0,0,0,0,0,0,1,1,0.24166666666666667
想传输线,0,0,0,0,0,0,1,1,0.24166666666666667
负载阻抗,0,0,0,0,0,0,1,1,0.24166666666666667
等效分析,0,0,1,0,0,0,1,2,0.3666666666666667
有源管脚,0,0,0,0,0,0,1,1,0.24166666666666667
深度优先搜索算法,0,0,0,0,0,0,1,1,0.24166666666666667
导线线段,0,0,0,0,0,0,1,1,0.24166666666666667
数字化建模,0,0,0,0,1,0,1,2,0.48333333333333334
地平面建模,0,0,0,0,0,0,1,1,0.24166666666666667
等效路,0,0,0,0,0,0,1,1,0.24166666666666667
仿真时间,1,0,0,0,3,1,1,6,2.208333333333333
批量化仿真,1,0,1,0,2,0,1,5,1.85
电荷,0,0,0,0,3,0,0,3,0.725
电容值,0,0,0,0,3,2,0,5,1.2083333333333333
攻击线传输,0,0,0,0,2,0,0,2,0.48333333333333334
平板电容器,0,0,0,0,2,1,0,3,0.725
近端串扰,0,0,0,0,1,0,0,1,0.24166666666666667
充放电操,0,0,0,0,1,0,0,1,0.24166666666666667
电容仓,0,0,0,0,1,0,0,1,0.24166666666666667
干扰电流,0,0,0,0,1,0,0,1,0.24166666666666667
电容分布,0,0,0,0,1,0,0,1,0.24166666666666667
内传输线,0,0,0,0,1,0,0,1,0.24166666666666667
aui,0,0,0,0,1,0,0,1,0.24166666666666667
电压跳变量,0,0,0,0,1,0,0,1,0.24166666666666667
电流值,0,0,0,0,1,0,0,1,0.24166666666666667
发射电流,0,0,0,0,1,0,0,1,0.24166666666666667
转移,0,0,0,0,1,1,0,2,0.48333333333333334
comp,0,0,0,0,1,0,0,1,0.24166666666666667
电平幅度,0,0,0,0,1,0,0,1,0.24166666666666667
电平,0,0,0,1,1,0,0,2,0.3666666666666667
电平变化,0,0,0,0,1,0,0,1,0.24166666666666667
电平转换,0,0,0,0,1,0,0,1,0.24166666666666667
电平跳变,0,0,0,0,2,1,0,3,0.725
方波信号,0,0,0,0,6,0,0,6,1.45
电压值,0,0,0,0,1,0,0,1,0.24166666666666667
断路,0,0,0,0,1,0,0,1,0.24166666666666667
输线,0,0,0,1,1,0,0,2,0.3666666666666667
微带,0,0,0,0,1,0,0,1,0.24166666666666667
双传输线,0,0,0,0,1,0,0,1,0.24166666666666667
平行双导线,0,0,0,0,1,0,0,1,0.24166666666666667
分布式,0,0,0,1,1,0,0,2,0.3666666666666667
传输,0,0,1,0,1,0,0,2,0.3666666666666667
电容极板,0,0,0,0,1,0,0,1,0.24166666666666667
面积,0,0,0,0,2,1,0,3,0.725
电源分配网络,0,0,3,0,0,5,0,8,1.5833333333333333
电源地平面建模,0,0,1,0,0,0,0,1,0.125
边缘,0,0,1,0,0,0,0,1,0.125
电源平面分割,0,0,1,0,0,0,0,1,0.125
电压幅度,0,0,1,0,0,0,0,1,0.125
谐振频率,0,0,0,0,0,11,0,11,2.658333333333333
分析速度,0,0,0,0,0,1,0,1,0.24166666666666667
总电容,0,0,0,0,0,1,0,1,0.24166666666666667
边界条件,0,0,0,0,0,2,0,2,0.48333333333333334
helmholtz方程,0,0,0,1,0,1,0,2,0.3666666666666667
自由空间磁导率,0,0,0,0,0,1,0,1,0.24166666666666667
谐振模式,0,0,0,0,0,1,0,1,0.24166666666666667
电源平面,0,0,0,2,0,2,0,4,0.7333333333333334
矩阵pcb,0,0,0,0,0,1,0,1,0.24166666666666667
身电感,0,0,0,0,0,1,0,1,0.24166666666666667
高频分析,0,0,0,0,0,1,0,1,0.24166666666666667
过滤,0,0,0,0,0,2,0,2,0.48333333333333334
纹波,0,0,0,0,0,5,0,5,1.2083333333333333
fr4,0,0,0,0,0,1,0,1,0.24166666666666667
垂直间隔,0,0,0,0,0,1,0,1,0.24166666666666667
中间隔离材料,0,0,0,0,0,1,0,1,0.24166666666666667
自由空间,0,0,0,0,0,1,0,1,0.24166666666666667
隔离材料,0,0,0,0,0,1,0,1,0.24166666666666667
分区,0,0,0,0,0,1,0,1,0.24166666666666667
多层电路板,0,0,0,0,0,1,0,1,0.24166666666666667
介质,0,0,0,3,0,1,0,4,0.6166666666666667
等效介电常数,0,0,0,2,0,0,0,2,0.25
边界条,0,0,0,1,0,0,0,1,0.125
参考平面,0,0,0,1,0,0,0,1,0.125
介质隔离,0,0,0,1,0,0,0,1,0.125
基板,0,0,0,1,0,0,0,1,0.125
bottom,0,0,0,1,0,0,0,1,0.125
hyperlynx仿真软件,0,0,1,0,1,0,0,2,0.3666666666666667
大批量仿真,0,0,0,0,1,0,0,1,0.24166666666666667
单根导线,0,0,0,0,1,0,0,1,0.24166666666666667
分散程度,0,0,0,0,1,1,0,2,0.48333333333333334
波动,0,0,0,0,4,0,0,4,0.9666666666666667
完整性,0,0,0,0,1,0,0,1,0.24166666666666667
pcb全波仿真,0,0,1,1,0,0,0,2,0.25
低频参数,0,0,0,1,0,0,0,1,0.125
高频时参数,0,0,0,1,0,0,0,1,0.125
spice参数,0,0,0,1,0,0,0,1,0.125
pcb设计,0,0,1,1,0,0,0,2,0.25
布局布线,0,0,0,1,0,0,0,1,0.125
pcb工程,0,0,0,1,0,0,0,1,0.125
电子设备,0,0,0,1,0,0,0,1,0.125
电压振荡,0,0,0,1,0,0,0,1,0.125
延时,0,0,0,1,0,0,0,1,0.125
过冲,0,0,0,1,0,0,0,1,0.125
电压幅度振荡,0,0,0,1,0,0,0,1,0.125
高速印刷电路板,1,0,4,1,0,0,0,6,1.625
源端信号源,0,0,0,1,0,0,0,1,0.125
信号回路,0,0,0,1,0,0,0,1,0.125
振荡,0,0,0,2,0,0,0,2,0.25
失真,0,0,0,1,0,0,0,1,0.125
瞬态阻抗,0,0,0,2,0,0,0,2,0.25
layer,0,0,0,10,2,0,0,12,1.7333333333333334
pwr,0,0,0,3,0,0,0,3,0.375
开发板,0,0,0,3,0,0,0,3,0.375
工作电压,0,0,1,2,0,2,0,5,0.8583333333333334
era,0,0,0,2,0,0,0,2,0.25
展叠结构,0,0,0,1,0,0,0,1,0.125
xfpga,0,0,0,1,0,0,0,1,0.125
gno,0,0,0,1,0,0,0,1,0.125
ghffl,0,0,0,1,0,0,0,1,0.125
layer2,0,0,0,1,0,0,0,1,0.125
xivgxfpga,0,0,0,1,0,0,0,1,0.125
多电平控制,0,0,0,1,0,0,0,1,0.125
epm2,0,0,0,1,0,0,0,1,0.125
单片内存,0,0,0,1,0,0,0,1,0.125
64位差分信号,0,0,0,1,0,0,0,1,0.125
工怡电压,0,0,0,1,0,0,0,1,0.125
41,0,0,0,1,0,0,0,1,0.125
dd3,0,0,0,1,0,0,0,1,0.125
内存,0,0,0,1,0,0,0,1,0.125
逻辑数组块,0,0,0,1,0,0,0,1,0.125
ep4,0,0,0,1,0,0,0,1,0.125
stratixivgx,0,0,0,1,0,0,0,1,0.125
相对,0,0,0,1,0,0,0,1,0.125
介质材料,0,0,0,2,0,0,0,2,0.25
高速多层印刷电路板,0,0,0,1,0,0,0,1,0.125
模块,0,0,0,1,0,0,0,1,0.125
lcd,0,0,0,1,0,0,0,1,0.125
flash,0,0,0,1,0,0,0,1,0.125
hdmi,0,0,0,1,0,0,0,1,0.125
ddr3,0,0,0,1,0,0,0,1,0.125
仿真简介,0,0,0,1,0,0,0,1,0.125
pcb性能,0,0,0,0,1,0,0,1,0.24166666666666667
导线布线,0,0,0,0,1,0,0,1,0.24166666666666667
元器件布局,0,0,0,0,1,0,0,1,0.24166666666666667
版图,0,0,0,0,1,0,0,1,0.24166666666666667
高频属性,0,0,0,0,1,0,0,1,0.24166666666666667
传输特性,0,0,0,0,1,0,0,1,0.24166666666666667
测试调试,0,0,0,0,1,0,0,1,0.24166666666666667
样板制作,0,0,0,0,1,0,0,1,0.24166666666666667
布线后仿真,0,0,0,0,1,0,0,1,0.24166666666666667
布线前仿真,0,0,0,0,1,0,0,1,0.24166666666666667
版图设计,0,0,0,0,1,0,0,1,0.24166666666666667
原理图设计,0,0,0,0,1,0,0,1,0.24166666666666667
工业化pcb,0,0,0,0,1,0,0,1,0.24166666666666667
pcb板上信息,0,0,0,0,1,0,0,1,0.24166666666666667
结束层,0,0,0,0,3,0,0,3,0.725
开始层,0,0,0,0,2,0,0,2,0.48333333333333334
弧线,0,0,0,0,2,0,0,2,0.48333333333333334
管脚名,0,0,0,0,2,0,0,2,0.48333333333333334
passivejpin,0,0,0,0,2,0,0,2,0.48333333333333334
passivejpins,0,0,0,0,2,0,0,2,0.48333333333333334
pcb信息,0,0,0,0,4,0,0,4,0.9666666666666667
过孔序列,0,0,0,0,1,0,0,1,0.24166666666666667
封装,0,0,0,0,1,0,0,1,0.24166666666666667
过孔信息,0,0,0,0,1,0,0,1,0.24166666666666667
过孔类型,0,0,0,0,1,0,0,1,0.24166666666666667
pcb拓扑结构,0,0,0,0,1,0,0,1,0.24166666666666667
右纵坐标,0,0,0,0,1,0,0,1,0.24166666666666667
右横坐标,0,0,0,0,1,0,0,1,0.24166666666666667
左纵坐标,0,0,0,0,1,0,0,1,0.24166666666666667
左横坐标,0,0,0,0,1,0,0,1,0.24166666666666667
伯数字,0,0,0,0,1,0,0,1,0.24166666666666667
终止点坐标,0,0,0,0,1,0,0,1,0.24166666666666667
起始点坐标,0,0,0,0,1,0,0,1,0.24166666666666667
seg序列,0,0,0,0,1,0,0,1,0.24166666666666667
线段序列,0,0,0,0,1,0,0,1,0.24166666666666667
直连线,0,0,0,0,1,0,0,1,0.24166666666666667
存储空间,0,0,0,0,1,0,0,1,0.24166666666666667
圆弧,0,0,0,0,1,0,0,1,0.24166666666666667
段线段,0,0,0,0,1,0,0,1,0.24166666666666667
平滑曲线,0,0,0,0,1,0,0,1,0.24166666666666667
倒角,0,0,0,0,1,0,0,1,0.24166666666666667
直拐,0,0,0,0,1,0,0,1,0.24166666666666667
器件名称,0,0,0,0,1,0,0,1,0.24166666666666667
passive_pin序列,0,0,0,0,1,0,0,1,0.24166666666666667
存储,0,0,0,0,1,0,0,1,0.24166666666666667
开关,0,0,0,0,1,0,0,1,0.24166666666666667
导通,0,0,0,0,1,1,0,2,0.48333333333333334
pf,0,0,0,0,1,0,0,1,0.24166666666666667
active_pino,0,0,0,0,1,0,0,1,0.24166666666666667
activej,0,0,0,0,1,0,0,1,0.24166666666666667
altiumdesigner,0,0,0,0,1,0,0,1,0.24166666666666667
电能,0,0,0,2,1,3,0,6,1.2166666666666668
区域,0,0,0,0,0,3,0,3,0.725
剖分,0,0,0,0,0,3,0,3,0.725
单元分析,0,0,0,0,0,2,0,2,0.48333333333333334
收敛,0,0,0,0,0,2,0,2,0.48333333333333334
偏微分方程,0,0,0,0,0,2,0,2,0.48333333333333334
未知数,0,0,0,0,0,1,0,1,0.24166666666666667
矩量法测试函数,0,0,0,0,0,1,0,1,0.24166666666666667
测试函数,0,0,0,0,0,1,0,1,0.24166666666666667
线性三角形函数,0,0,0,0,0,1,0,1,0.24166666666666667
自适应网络,0,0,0,0,0,1,0,1,0.24166666666666667
方程,0,0,0,0,0,1,0,1,0.24166666666666667
加权残量,0,0,0,0,0,1,0,1,0.24166666666666667
二维波动方程,0,0,0,0,0,1,0,1,0.24166666666666667
形状,0,0,0,0,0,1,0,1,0.24166666666666667
四边形,0,0,0,0,0,1,0,1,0.24166666666666667
等边三角形,0,0,0,0,0,1,0,1,0.24166666666666667
二维电源,0,0,0,0,0,1,0,1,0.24166666666666667
收敛性,0,0,0,0,0,1,0,1,0.24166666666666667
有限元,0,0,0,0,0,1,0,1,0.24166666666666667
求解方程,0,0,0,0,0,1,0,1,0.24166666666666667
迭代,0,0,0,0,0,1,0,1,0.24166666666666667
cadencesi,0,0,0,0,0,1,0,1,0.24166666666666667
电磁计算器,0,0,0,0,0,1,0,1,0.24166666666666667
稀疏矩阵,0,0,0,0,0,1,0,1,0.24166666666666667
数值技术,0,0,0,0,0,1,0,1,0.24166666666666667
近似解,0,0,0,0,0,1,0,1,0.24166666666666667
边值,0,0,0,0,0,1,0,1,0.24166666666666667
网格,0,0,0,0,0,1,0,1,0.24166666666666667
pdn,0,0,4,0,0,1,0,5,0.7416666666666667
sdn,0,0,3,0,0,0,0,3,0.375
集成电路,0,0,3,0,0,0,0,3,0.375
数字信号,0,0,2,0,0,0,0,2,0.25
逻辑,0,0,2,0,0,0,0,2,0.25
时钟信号,0,0,2,1,0,0,0,3,0.375
加工,0,0,1,0,0,0,0,1,0.125
供电系统,0,0,1,0,0,0,0,1,0.125
回路,0,0,1,0,0,2,0,3,0.6083333333333334
目标阻抗,0,0,1,0,0,8,0,9,2.0583333333333336
功率,0,0,1,0,0,1,0,2,0.3666666666666667
地回路,0,0,1,0,0,0,0,1,0.125
供电线,0,0,1,0,0,0,0,1,0.125
空间,0,0,1,1,0,0,0,2,0.25
地线,0,0,1,0,0,0,0,1,0.125
供电电流,0,0,1,0,0,0,0,1,0.125
供电平面,0,0,1,0,0,0,0,1,0.125
轨道塌陷,0,0,1,0,0,0,0,1,0.125
串扰相应,0,0,1,0,0,0,0,1,0.125
反射效应,0,0,1,0,0,0,0,1,0.125
信号传输,0,0,1,0,0,0,0,1,0.125
材质,0,0,1,1,0,0,0,2,0.25
高频时钟信号,0,0,1,0,0,0,0,1,0.125
失真现,0,0,1,0,0,0,0,1,0.125
低电平,0,0,1,0,0,0,0,1,0.125
高电平,0,0,1,0,0,0,0,1,0.125
振铃,0,0,1,0,0,0,0,1,0.125
振铃现,0,0,1,0,0,0,0,1,0.125
状态,0,0,1,0,0,0,0,1,0.125
逻辑门,0,0,1,0,0,0,0,1,0.125
数字芯片,0,0,1,0,0,0,0,1,0.125
pcb导线,0,0,1,0,0,0,0,1,0.125
低频信号,0,0,1,0,0,0,0,1,0.125
电源电压,0,0,1,0,0,0,0,1,0.125
电路传输信号,0,0,1,0,0,0,0,1,0.125
电源分配网络系统,0,0,1,0,0,0,0,1,0.125
信号分配网络系统,0,0,1,0,0,0,0,1,0.125
高性能器件,0,0,1,0,0,0,0,1,0.125
核心供电电压,0,0,1,0,0,0,0,1,0.125
高端芯片,0,0,1,0,0,0,0,1,0.125
芯片功率,0,0,1,0,0,0,0,1,0.125
7nm制程,0,0,1,0,0,0,0,1,0.125
芯片制造工艺,0,0,1,0,0,0,0,1,0.125
运行时钟频率,0,0,1,0,0,0,0,1,0.125
芯片结构,0,0,1,0,0,0,0,1,0.125
运行速率,0,0,1,0,0,0,0,1,0.125
ic,0,0,1,0,0,0,0,1,0.125
单位芯片,0,0,1,0,0,0,0,1,0.125
晶体管,0,0,1,0,0,0,0,1,0.125
摩尔定律,0,0,1,0,0,0,0,1,0.125
摩尔,0,0,1,0,0,0,0,1,0.125
英特尔,0,0,1,0,0,0,0,1,0.125
机器学习,0,0,1,0,0,0,0,1,0.125
可控条件,0,0,1,0,0,0,0,1,0.125
资源,0,0,1,0,0,0,0,1,0.125
反射分析,0,0,1,1,0,0,0,2,0.25
走线串扰批量仿真,0,0,1,0,0,0,0,1,0.125
扼流圈,0,0,0,0,0,7,0,7,1.6916666666666667
场效应管,0,0,0,0,0,2,0,2,0.48333333333333334
电压电流,0,0,0,0,0,1,0,1,0.24166666666666667
感应点,0,0,0,0,3,1,0,4,0.9666666666666667
输出电感,0,0,0,0,0,1,0,1,0.24166666666666667
rcl电路,0,0,0,0,0,1,0,1,0.24166666666666667
功能,0,0,0,0,0,1,0,1,0.24166666666666667
电气属性,0,0,0,1,0,1,0,2,0.3666666666666667
电信号,0,0,0,0,0,1,0,1,0.24166666666666667
容量,0,0,0,0,0,1,0,1,0.24166666666666667
增益,0,0,0,0,0,1,0,1,0.24166666666666667
高频段,0,0,0,1,0,1,0,2,0.3666666666666667
低频段,0,0,0,0,0,1,0,1,0.24166666666666667
直流,0,0,0,0,0,1,0,1,0.24166666666666667
输岀阻抗,0,0,0,0,0,1,0,1,0.24166666666666667
无用热量,0,0,0,0,0,1,0,1,0.24166666666666667
供电功率,0,0,0,0,0,1,0,1,0.24166666666666667
超高频,0,0,0,0,0,1,0,1,0.24166666666666667
额定电流,0,0,0,0,0,1,0,1,0.24166666666666667
供电电源,0,0,0,0,0,2,0,2,0.48333333333333334
漏级,0,0,0,0,0,1,0,1,0.24166666666666667
场效应管栅极,0,0,0,0,0,1,0,1,0.24166666666666667
电压控制元件,0,0,0,0,0,1,0,1,0.24166666666666667
场效应晶体管,0,0,0,0,0,1,0,1,0.24166666666666667
mos型,0,0,0,0,0,1,0,1,0.24166666666666667
等级电压,0,0,0,0,0,1,0,1,0.24166666666666667
电源接口,0,0,0,0,0,1,0,1,0.24166666666666667
工作电压源,0,0,0,0,0,1,0,1,0.24166666666666667
供电电压幅度,0,0,0,0,0,1,0,1,0.24166666666666667
工作频率,0,0,0,0,0,2,0,2,0.48333333333333334
goundplanes,0,0,0,0,0,1,0,1,0.24166666666666667
power,0,0,0,0,0,1,0,1,0.24166666666666667
总线结构,0,0,0,0,0,1,0,1,0.24166666666666667
多层平行平面,0,0,0,0,0,1,0,1,0.24166666666666667
接地线,0,0,0,0,0,1,0,1,0.24166666666666667
低速电源线,0,0,0,0,0,1,0,1,0.24166666666666667
贴片,0,0,0,0,0,1,0,1,0.24166666666666667
感应电动势,0,0,0,0,3,1,0,4,0.9666666666666667
单位长度传输线,0,0,0,1,2,0,0,3,0.6083333333333334
感应电流,0,0,0,0,2,0,0,2,0.48333333333333334
互感值,0,0,0,0,1,0,0,1,0.24166666666666667
平行传输线,0,0,0,0,1,0,0,1,0.24166666666666667
分布式参数,0,0,0,0,1,1,0,2,0.48333333333333334
型空业,0,0,0,0,1,0,0,1,0.24166666666666667
延长线,0,0,0,0,1,0,0,1,0.24166666666666667
sin,0,0,0,0,1,0,0,1,0.24166666666666667
毕奥-沙伐尔定律,0,0,0,0,1,0,0,1,0.24166666666666667
磁感应强度,0,0,0,0,2,0,0,2,0.48333333333333334
电磁感应,0,0,0,0,1,0,0,1,0.24166666666666667
法拉第,0,0,0,0,1,0,0,1,0.24166666666666667
奥斯特,0,0,0,0,1,0,0,1,0.24166666666666667
地平面集总模型,0,0,0,0,0,2,0,2,0.48333333333333334
阻抗值,0,0,0,0,0,1,0,1,0.24166666666666667
阻抗曲线,0,0,0,0,0,3,0,3,0.725
虚线,0,0,0,0,0,1,0,1,0.24166666666666667
x-型电路,0,0,0,0,0,1,0,1,0.24166666666666667
填充材料,0,0,0,0,0,1,0,1,0.24166666666666667
输出端口,0,0,0,0,0,1,0,1,0.24166666666666667
测试电路板,0,0,0,0,0,1,0,1,0.24166666666666667
容抗,0,0,0,0,0,1,0,1,0.24166666666666667
地平面电感,0,0,0,0,0,1,0,1,0.24166666666666667
阻值,0,0,0,0,0,1,0,1,0.24166666666666667
铜质,0,0,0,0,0,1,0,1,0.24166666666666667
zc,0,0,0,0,0,1,0,1,0.24166666666666667
集总参数,0,0,0,0,0,1,0,1,0.24166666666666667
分布式回路,0,0,0,0,0,1,0,1,0.24166666666666667
理想通路,0,0,0,0,0,1,0,1,0.24166666666666667
舒生参数,0,0,0,0,0,1,0,1,0.24166666666666667
信号层线段,0,0,0,0,0,1,0,1,0.24166666666666667
平板导体,0,0,0,0,0,1,0,1,0.24166666666666667
建模方法,0,0,1,0,0,0,0,1,0.125
cadencepi仿真软件,0,0,1,0,0,1,0,2,0.3666666666666667
不规则电源,0,0,1,0,0,0,0,1,0.125
批量化判决,0,0,1,0,0,0,0,1,0.125
监督学习,0,0,1,0,0,0,0,1,0.125
板材,0,0,1,0,0,0,0,1,0.125
元素序列,0,0,1,0,0,0,0,1,0.125
拓扑结构信息,0,0,1,0,0,0,0,1,0.125
pcb文档,0,0,1,0,0,0,0,1,0.125
cadencesigrity软,0,0,1,0,0,0,0,1,0.125
模型仿真,0,0,1,0,0,0,0,1,0.125
等效寄生参数,0,0,1,0,0,0,0,1,0.125
pcb传输线,0,0,1,0,0,0,0,1,0.125
信号反射,0,0,1,0,0,0,0,1,0.125
对称带状线结构,0,0,0,1,0,0,0,1,0.125
中间层,0,0,0,1,0,0,0,1,0.125
頻率,0,0,0,1,0,0,0,1,0.125
奇生电感,0,0,0,1,0,0,0,1,0.125
低频时,0,0,0,2,0,0,0,2,0.25
耦合电容,0,0,0,0,0,3,0,3,0.725
感性,0,0,0,1,0,2,0,3,0.6083333333333334
去耦效果,0,0,0,0,0,1,0,1,0.24166666666666667
器件管脚,0,0,0,0,0,1,0,1,0.24166666666666667
工作电流,0,0,0,0,0,1,0,1,0.24166666666666667
低阻抗性,0,0,0,0,0,1,0,1,0.24166666666666667
纯阻性,0,0,0,0,0,1,0,1,0.24166666666666667
阻抗乙,0,0,0,0,0,1,0,1,0.24166666666666667
谐振,0,0,0,0,0,1,0,1,0.24166666666666667
电容串联电感,0,0,0,0,0,1,0,1,0.24166666666666667
性质,0,0,0,1,0,1,0,2,0.3666666666666667
高频线路,0,0,0,0,0,1,0,1,0.24166666666666667
容性,0,0,0,2,0,1,0,3,0.4916666666666667
高频交流电,0,0,0,0,0,1,0,1,0.24166666666666667
去耦电容放电,0,0,0,0,0,1,0,1,0.24166666666666667
突变,0,0,0,0,0,1,0,1,0.24166666666666667
负载电流,0,0,0,0,0,1,0,1,0.24166666666666667
负载管脚,0,0,0,0,0,1,0,1,0.24166666666666667
数据标注,0,0,0,0,3,0,0,3,0.725
flag,0,0,0,0,1,0,0,1,0.24166666666666667
标志位,0,0,0,0,1,0,0,1,0.24166666666666667
网络序列,0,0,0,0,1,0,0,1,0.24166666666666667
串扰信号,0,0,0,0,1,0,0,1,0.24166666666666667
毫伏,0,0,0,0,1,0,0,1,0.24166666666666667
hyperlynxboardsim,0,0,0,0,1,0,0,1,0.24166666666666667
pcb全波仿真软件,0,0,0,0,1,0,0,1,0.24166666666666667
机器系统,0,0,0,0,1,0,0,1,0.24166666666666667
人工贴标,0,0,0,0,1,0,0,1,0.24166666666666667
麦克斯韦方程组,0,0,0,2,0,1,0,3,0.4916666666666667
内积,0,0,0,1,0,0,0,1,0.125
分段常数函数,0,0,0,1,0,0,0,1,0.125
伽略金法,0,0,0,1,0,0,0,1,0.125
分段常数,0,0,0,1,0,0,0,1,0.125
分段线性基函数,0,0,0,1,0,0,0,1,0.125
分段常数基函数,0,0,0,1,0,0,0,1,0.125
二维形状,0,0,0,1,0,0,0,1,0.125
swg,0,0,0,1,0,0,0,1,0.125
rwg,0,0,0,1,0,0,0,1,0.125
三维不规则形状,0,0,0,1,0,0,0,1,0.125
权值,0,0,0,1,0,0,0,1,0.125
离散电流密度,0,0,0,1,0,0,0,1,0.125
平均分配,0,0,0,1,0,0,0,1,0.125
连续方程,0,0,0,1,0,0,0,1,0.125
积分方程,0,0,0,1,0,0,0,1,0.125
非齐次微分方程,0,0,0,1,0,0,0,1,0.125
洛伦兹条件,0,0,0,1,0,0,0,1,0.125
恒等式,0,0,0,1,0,0,0,1,0.125
拉普拉斯算子,0,0,0,1,0,0,0,1,0.125
vxa,0,0,0,1,0,0,0,1,0.125
标量式,0,0,0,1,0,0,0,1,0.125
矢量磁位,0,0,0,1,0,0,0,1,0.125
旋度,0,0,0,1,0,0,0,1,0.125
矢量,0,0,0,1,0,0,0,1,0.125
无散场,0,0,0,1,0,0,0,1,0.125
磁场强度,0,0,0,2,0,0,0,2,0.25
血应,0,0,0,1,0,0,0,1,0.125
太赫兹频率,0,0,0,1,0,0,0,1,0.125
传输线参数,0,0,0,1,0,0,0,1,0.125
高频传输线电阻,0,0,0,1,0,0,0,1,0.125
敏感度,0,0,0,0,0,1,0,1,0.24166666666666667
总功率,0,0,0,0,0,1,0,1,0.24166666666666667
最大噪声幅度,0,0,0,0,0,1,0,1,0.24166666666666667
平均电流,0,0,0,0,0,1,0,1,0.24166666666666667
地面,0,0,0,0,0,1,0,1,0.24166666666666667
欧姆,0,0,0,1,0,1,0,2,0.3666666666666667
输出端,0,0,0,0,0,5,0,5,1.2083333333333333
输出端短路,0,0,0,0,0,2,0,2,0.48333333333333334
竺塑丝蟲,0,0,0,0,0,1,0,1,0.24166666666666667
出端,0,0,0,0,0,1,0,1,0.24166666666666667
输出电流,0,0,0,0,0,1,0,1,0.24166666666666667
输入电流,0,0,0,0,0,1,0,1,0.24166666666666667
输入端,0,0,0,0,0,1,0,1,0.24166666666666667
t矩阵,0,0,0,0,0,1,0,1,0.24166666666666667
电氐电流,0,0,0,0,0,1,0,1,0.24166666666666667
m列二端口网络,0,0,0,0,0,1,0,1,0.24166666666666667
损耗,0,0,0,0,0,1,0,1,0.24166666666666667
相灵等效参血,0,0,0,0,0,1,0,1,0.24166666666666667
正方形电路板,0,0,0,0,0,1,0,1,0.24166666666666667
电躍分析,0,0,0,0,0,1,0,1,0.24166666666666667
效率,2,0,0,0,0,1,0,3,2.2416666666666667
特征参数,2,0,0,1,0,1,0,4,2.3666666666666667
基尔霍夫定律,0,0,0,1,0,1,0,2,0.3666666666666667
路分析法,0,0,0,0,0,1,0,1,0.24166666666666667
仿真硬件,0,0,0,0,0,1,0,1,0.24166666666666667
分析法,0,0,0,0,0,2,0,2,0.48333333333333334
padstack,0,0,0,0,1,0,0,1,0.24166666666666667
器件型号,0,0,0,0,1,0,0,1,0.24166666666666667
devices,0,0,0,0,1,0,0,1,0.24166666666666667
stackup,0,0,0,0,1,0,0,1,0.24166666666666667
hyp文件,0,0,0,0,1,0,0,1,0.24166666666666667
加密算法,0,0,0,0,1,0,0,1,0.24166666666666667
eda文件,0,0,0,0,1,0,0,1,0.24166666666666667
brd,0,0,0,0,1,0,0,1,0.24166666666666667
pcbdoc,0,0,0,0,1,0,0,1,0.24166666666666667
hyp,0,0,0,0,1,0,0,1,0.24166666666666667
pcb板上,0,0,0,0,1,0,0,1,0.24166666666666667
文件读取,0,0,0,0,1,0,0,1,0.24166666666666667
复杂电路,0,0,0,1,1,0,0,2,0.3666666666666667
多层结构,0,0,0,0,1,0,0,1,0.24166666666666667
pcb文件信息,0,0,0,0,1,1,0,2,0.48333333333333334
短路,0,0,0,0,0,1,0,1,0.24166666666666667
输出端断路,0,0,0,0,0,1,0,1,0.24166666666666667
ccoup,0,0,0,0,0,1,0,1,0.24166666666666667
不均匀分割,0,0,0,0,0,1,0,1,0.24166666666666667
分格数,0,0,0,0,0,1,0,1,0.24166666666666667
纵向,0,0,0,0,0,1,0,1,0.24166666666666667
无源器件集合,0,0,0,0,0,1,0,1,0.24166666666666667
去耦电容器件,0,0,0,0,0,1,0,1,0.24166666666666667
h7端口,0,0,0,0,6,0,0,6,1.45
占空比,0,0,0,0,3,0,0,3,0.725
红色曲线,0,0,0,0,2,0,0,2,0.48333333333333334
电位,0,0,0,0,2,0,0,2,0.48333333333333334
时延,0,0,0,2,2,0,0,4,0.7333333333333334
白色信号线,0,0,0,0,2,0,0,2,0.48333333333333334
白色曲线,0,0,0,0,2,0,0,2,0.48333333333333334
攻击线线宽,0,0,0,0,1,0,0,1,0.24166666666666667
两电压曲线,0,0,0,0,1,0,0,1,0.24166666666666667
线寬,0,0,0,0,1,0,0,1,0.24166666666666667
绿色曲线,0,0,0,0,1,0,0,1,0.24166666666666667
数值法,0,0,0,0,1,0,0,1,0.24166666666666667
集总参数线,0,0,0,0,1,0,0,1,0.24166666666666667
电感耦合,0,0,0,0,1,0,0,1,0.24166666666666667
印刷电路板导线,0,0,0,0,1,0,0,1,0.24166666666666667
三倍线宽,0,0,0,0,1,0,0,1,0.24166666666666667
噪声耦合,0,0,0,0,1,0,0,1,0.24166666666666667
波动形状,0,0,0,0,1,0,0,1,0.24166666666666667
亮蓝色曲线,0,0,0,0,1,0,0,1,0.24166666666666667
电压幅度曲线,0,0,0,0,1,0,0,1,0.24166666666666667
tl7,0,0,0,0,1,0,0,1,0.24166666666666667
tl3,0,0,0,0,1,0,0,1,0.24166666666666667
单位时间,0,0,0,0,1,0,0,1,0.24166666666666667
容值,0,0,0,0,1,0,0,1,0.24166666666666667
中距离,0,0,0,0,1,0,0,1,0.24166666666666667
感性电容,0,0,0,0,1,0,0,1,0.24166666666666667
方位,0,0,0,0,1,0,0,1,0.24166666666666667
平行距离,0,0,0,0,1,0,0,1,0.24166666666666667
强度,0,0,0,0,1,0,0,1,0.24166666666666667
紫色线,0,0,0,0,1,0,0,1,0.24166666666666667
紫色信号线,0,0,0,0,1,0,0,1,0.24166666666666667
紫色曲线,0,0,0,0,1,0,0,1,0.24166666666666667
耦合传输线,0,0,0,0,1,0,0,1,0.24166666666666667
tl12,0,0,0,0,1,0,0,1,0.24166666666666667
l9,0,0,0,0,1,0,0,1,0.24166666666666667
两线拓扑结构,0,0,0,0,1,0,0,1,0.24166666666666667
耦合电流,0,0,0,0,1,0,0,1,0.24166666666666667
传导电流,0,0,0,0,1,0,0,1,0.24166666666666667
干行双导线,0,0,0,0,1,0,0,1,0.24166666666666667
导域發数,0,0,0,0,1,0,0,1,0.24166666666666667
数字,0,0,0,0,1,0,0,1,0.24166666666666667
拓扑结构仿真,0,0,0,0,1,0,0,1,0.24166666666666667
hyperlynxlinesim,0,0,0,0,1,0,0,1,0.24166666666666667
批量化分析,0,0,0,0,1,0,0,1,0.24166666666666667
集总电路,0,0,0,3,0,0,0,3,0.375
分布式电路,0,0,0,2,0,0,0,2,0.25
地线回路,0,0,0,1,0,0,0,1,0.125
传输线等效电路,0,0,0,1,0,0,0,1,0.125
传输线电路,0,0,0,1,0,0,0,1,0.125
信号波长,0,0,0,1,0,0,0,1,0.125
导线长度,0,0,0,1,0,0,0,1,0.125
米量级,0,0,0,1,0,0,0,1,0.125
吉赫兹,0,0,0,1,0,0,0,1,0.125
兆赫兹,0,0,0,1,0,0,0,1,0.125
高频印刷电路板,0,0,0,1,0,0,0,1,0.125
解线上电压,0,0,0,1,0,0,0,1,0.125
空间维度,0,0,0,1,0,0,0,1,0.125
时间维度,0,0,0,1,0,0,0,1,0.125
磁场量,0,0,0,1,0,0,0,1,0.125
传输线电场,0,0,0,1,0,0,0,1,0.125
解传输线,0,0,0,1,0,0,0,1,0.125
maxwell方程组,0,0,0,1,0,0,0,1,0.125
磁场能量,0,0,0,1,0,0,0,1,0.125
电场能量,0,0,0,1,0,0,0,1,0.125
传导,0,0,0,1,0,0,0,1,0.125
电路分析,0,0,0,1,0,0,0,1,0.125
场分析,0,0,0,1,0,0,0,1,0.125
导波传输系统,0,0,0,1,0,0,0,1,0.125
感性元件,0,0,0,1,0,0,0,1,0.125
微波元件,0,0,0,1,0,0,0,1,0.125
衰减系数,0,0,0,1,0,0,0,1,0.125
传播,0,0,0,1,0,0,0,1,0.125
分布式参数回路,0,0,0,1,0,0,0,1,0.125
金属导体,0,0,0,1,0,0,0,1,0.125
叠层导线,0,0,0,1,0,0,0,1,0.125
分布电阻,0,0,0,1,0,0,0,1,0.125
温度,0,0,0,1,0,0,0,1,0.125
分布参数,0,0,0,1,0,0,0,1,0.125
电动势差,0,0,0,1,0,0,0,1,0.125
电流差,0,0,0,1,0,0,0,1,0.125
分布性,0,0,0,1,0,0,0,1,0.125
理想导体,0,0,0,1,0,0,0,1,0.125
组件尺寸,0,0,0,1,0,0,0,1,0.125
组件,0,0,0,1,0,0,0,1,0.125
磁能,0,0,0,1,0,0,0,1,0.125
断路电势,0,0,0,1,0,0,0,1,0.125
热能,0,0,0,1,0,0,0,1,0.125
电路元件,0,0,0,1,0,0,0,1,0.125
集中电路,0,0,0,1,0,0,0,1,0.125
直流电路,0,0,0,1,0,0,0,1,0.125
双层,0,0,0,1,0,0,0,1,0.125
单层,0,0,0,1,0,0,0,1,0.125
不对称,0,0,0,1,0,0,0,1,0.125
对称型,0,0,0,1,0,0,0,1,0.125
普通,0,0,0,1,0,0,0,1,0.125
嵌入型,0,0,0,1,0,0,0,1,0.125
传输线电阻,0,0,0,1,0,0,0,1,0.125
沟槽,0,0,0,1,0,0,0,1,0.125
金属导线材料,0,0,0,1,0,0,0,1,0.125
铜等,0,0,0,1,0,0,0,1,0.125
化学工艺,0,0,0,1,0,0,0,1,0.125
电解,0,0,0,1,0,0,0,1,0.125
走线沟槽,0,0,0,1,0,0,0,1,0.125
光学,0,0,0,2,0,0,0,2,0.25
化学,0,0,0,1,0,0,0,1,0.125
内阻,0,0,0,2,0,0,0,2,0.25
电压血,0,0,0,1,0,0,0,1,0.125
现实电路,0,0,0,1,0,0,0,1,0.125
t传输线,0,0,0,1,0,0,0,1,0.125
分界面,0,0,0,1,0,0,0,1,0.125
段宽度,0,0,0,1,0,0,0,1,0.125
信号强度,0,0,0,1,0,0,0,1,0.125
发射端,0,0,0,1,0,0,0,1,0.125
返回信号,0,0,0,1,0,0,0,1,0.125
电压源,0,0,0,1,0,0,0,1,0.125
源端电压源,0,0,0,1,0,0,0,1,0.125
均匀传输线,0,0,0,1,0,0,0,1,0.125
量化,1,0,0,0,0,1,0,2,1.2416666666666667
中间介质,0,0,0,0,0,1,0,1,0.24166666666666667
电平面,0,0,0,0,0,1,0,1,0.24166666666666667
误差偏移程度,0,0,0,0,0,1,0,1,0.24166666666666667
级联网络,0,0,0,0,0,1,0,1,0.24166666666666667
路分析,0,0,0,0,0,1,0,1,0.24166666666666667
噪声响应,0,0,0,0,0,1,0,1,0.24166666666666667
去耦电容离,0,0,0,0,0,1,0,1,0.24166666666666667
距离噪声源,0,0,0,0,0,1,0,1,0.24166666666666667
电源阻,0,0,0,0,0,1,0,1,0.24166666666666667
红色线段,0,0,0,0,0,1,0,1,0.24166666666666667
干扰源,0,0,0,0,0,1,0,1,0.24166666666666667
节点仿真,0,0,0,0,0,1,0,1,0.24166666666666667
单节点,0,0,0,0,0,1,0,1,0.24166666666666667
黑色线,0,0,0,0,0,1,0,1,0.24166666666666667
蓝色线,0,0,0,0,0,1,0,1,0.24166666666666667
长方形印刷电路板,0,0,0,0,0,1,0,1,0.24166666666666667
PCB,0,1,0,0,0,0,0,1,2.0
电源/地平面,0,1,0,0,0,0,0,1,2.0
pcb电源分配系统,1,0,0,0,0,0,0,1,1.0
低频驱动,1,0,0,0,0,0,0,1,1.0
平行双片,1,0,0,0,0,0,0,1,1.0
电特性,1,0,0,0,0,0,0,1,1.0
电路仿真,1,0,0,0,0,0,0,1,1.0
地平面仿真,1,0,0,0,0,0,0,1,1.0
控制变量法,1,0,0,0,0,0,0,1,1.0
元素集合,1,0,0,0,0,0,0,1,1.0
pcb网络,1,0,0,0,0,0,0,1,1.0
拓扑拓扑结构,1,0,0,0,0,0,0,1,1.0
读取结,1,0,0,0,0,0,0,1,1.0
仿真效率,1,0,0,0,0,0,0,1,1.0
电子工业,1,0,0,0,0,0,0,1,1.0
驱动电压幅度,1,0,0,0,0,0,0,1,1.0
设计,1,0,0,0,0,0,0,1,1.0
pcb反射,1,0,0,0,0,0,0,1,1.0
