,摘要,关键词,第一章,第二章,第三章,第四章,第五章,总词频,加权得分
性能,1,0,14,4,12,7,4,42,8.808333333333334
功率放大器,2,0,10,56,0,0,5,73,11.458333333333334
特性,1,0,8,1,7,3,0,20,4.541666666666666
i/q不平衡,2,0,20,0,23,7,2,54,12.233333333333334
功率,0,0,5,6,0,0,0,11,1.375
信号,1,0,7,31,113,21,3,176,38.858333333333334
功耗,0,0,4,0,0,0,0,4,0.5
通信系统,0,0,8,4,1,2,1,16,2.466666666666667
功放非线性,3,0,6,2,1,1,0,13,4.483333333333333
输出功率,0,0,2,0,0,0,0,2,0.25
回退法,0,0,2,0,0,0,0,2,0.25
非线性失真,0,0,2,3,0,0,1,6,0.8666666666666667
sc-fde,2,0,8,0,0,2,0,12,3.4833333333333334
非线性,2,0,4,5,0,0,1,12,3.3666666666666667
系统,0,0,4,2,4,0,1,11,1.9583333333333333
补偿,3,0,8,0,15,2,1,29,8.35
功放线性化技术,0,0,1,0,0,0,0,1,0.125
环保性能,0,0,1,0,0,0,0,1,0.125
器件,0,0,1,0,0,0,0,1,0.125
硬件,1,0,1,0,0,3,0,5,1.85
晶体管功放,0,0,1,0,0,0,0,1,0.125
晶体管,0,0,1,0,0,0,0,1,0.125
直流,0,0,1,1,0,0,0,2,0.25
晶体管功率放大器,0,0,1,0,0,0,0,1,0.125
线性度,0,0,5,3,0,1,0,9,1.2416666666666667
线性,0,0,2,1,0,0,0,3,0.375
功放,0,0,3,14,0,0,0,17,2.125
互调分量,0,0,1,2,0,0,0,3,0.375
饱和点,0,0,1,1,0,0,0,2,0.25
输入功率,0,0,1,0,0,0,0,1,0.125
功率回退法,0,0,2,1,0,0,0,3,0.375
功放线性化,0,0,1,2,0,0,0,3,0.375
频段,0,0,1,1,0,0,0,2,0.25
符号间干扰,0,0,1,1,2,0,0,4,0.7333333333333334
绝对,0,0,1,1,0,0,0,2,0.25
失真信号,0,0,1,1,0,0,0,2,0.25
射频发射机,0,0,1,1,0,0,0,2,0.25
干扰,0,0,1,2,1,0,0,4,0.6166666666666667
信道,0,0,1,1,4,1,0,7,1.4583333333333333
传播,0,0,1,1,0,0,0,2,0.25
发送信号,0,0,1,1,5,0,0,7,1.4583333333333333
基带补偿算法,0,0,1,0,0,0,0,1,0.125
系统效率,0,0,1,0,0,0,0,1,0.125
数字矫正,0,0,1,0,0,0,0,1,0.125
电路,0,0,1,0,0,0,0,1,0.125
缓解器件,0,0,1,0,0,0,0,1,0.125
镜像频率衰减,0,0,1,0,3,1,0,5,1.0916666666666668
接收机,0,0,4,0,0,2,0,6,0.9833333333333334
失配,0,0,1,0,0,0,0,1,0.125
相位,0,0,1,5,6,11,0,23,4.858333333333333
幅度,0,0,1,10,6,0,0,17,2.825
分支,0,0,1,0,3,0,0,4,0.85
通信链路,0,0,3,1,1,1,2,8,1.4666666666666668
通信接收机,0,0,1,0,0,0,0,1,0.125
i/q下变频,0,0,1,0,1,0,0,2,0.3666666666666667
宽带多信道信号,0,0,1,0,0,0,0,1,0.125
高阶调制波形,0,0,1,0,0,0,0,1,0.125
功放线性化性能,0,0,1,0,0,0,0,1,0.125
预失真,0,0,3,2,1,0,0,6,0.8666666666666667
镜像频率干扰,0,0,1,0,8,3,1,13,3.025
镜像频率,0,0,1,0,3,0,0,4,0.85
收发器,0,0,1,0,0,0,0,1,0.125
上下变频转换,0,0,1,0,0,0,0,1,0.125
i/q,1,0,3,0,11,6,0,21,5.483333333333333
直接转换原,0,0,1,0,0,0,0,1,0.125
无线电收发机,0,0,1,0,0,0,0,1,0.125
检测,1,0,2,0,1,1,1,6,1.975
峰平比,1,0,1,0,0,0,0,2,1.125
ofdm,1,0,7,0,0,0,0,8,1.875
复杂度,1,0,1,4,0,2,0,8,2.1083333333333334
码间干扰,1,0,1,1,0,3,0,6,1.975
频域均衡,1,0,1,0,0,1,0,3,1.3666666666666667
时域均衡,1,0,1,0,0,0,0,2,1.125
频域均衡系统,1,0,1,0,0,0,0,2,1.125
单载波,1,0,1,0,2,0,0,4,1.6083333333333334
低信噪比,1,1,1,1,0,4,1,9,4.458333333333333
传输效率,0,0,1,0,0,0,0,1,0.125
高阶调制,0,0,1,0,0,0,0,1,0.125
相位噪声,0,0,1,0,0,0,0,1,0.125
iq不平衡,3,0,6,0,9,0,1,19,6.166666666666666
硬件系统,0,0,2,0,0,1,0,3,0.4916666666666667
基带,0,0,1,2,7,0,0,10,2.0666666666666664
滤波处,0,0,1,0,0,0,0,1,0.125
放大,0,0,1,0,0,0,0,1,0.125
一般通信系统,0,0,1,0,0,0,0,1,0.125
开发资源,0,0,1,0,0,0,0,1,0.125
通信性能,0,0,1,0,0,0,0,1,0.125
质量,2,0,1,0,0,0,0,3,2.125
通信,1,0,1,0,3,0,0,5,1.85
模拟器件,1,0,5,0,4,0,0,10,2.591666666666667
ofdm系统,0,0,6,0,0,0,0,6,0.75
fft,0,0,4,0,0,1,0,5,0.7416666666666667
sc-fde系统,0,0,6,0,1,0,0,7,0.9916666666666667
mimo技术,0,0,3,0,0,4,0,7,1.3416666666666668
快速傅里叶变换,0,0,2,0,0,1,0,3,0.4916666666666667
可靠性,0,0,2,0,0,0,0,2,0.25
模块,0,0,2,0,0,2,0,4,0.7333333333333334
接收端,2,0,3,0,7,2,2,16,5.033333333333333
发射端,2,0,2,0,3,7,1,15,4.908333333333333
tsc-fde,0,0,1,0,0,0,0,1,0.125
sc-f,0,0,1,0,0,0,0,1,0.125
纠错码,0,0,1,0,0,0,0,1,0.125
编码,0,0,1,0,0,3,0,4,0.85
dm,0,0,1,0,0,0,0,1,0.125
cfo,0,0,1,0,0,0,0,1,0.125
载波频率偏移,0,0,1,0,0,0,0,1,0.125
效率,0,0,4,1,0,0,0,5,0.625
高功率放大器,0,0,1,0,0,0,0,1,0.125
papr,0,0,1,0,0,0,0,1,0.125
峰均功率比,0,0,1,0,0,0,0,1,0.125
频域,0,0,1,0,1,1,0,3,0.6083333333333334
信道失真,0,0,1,0,2,0,0,3,0.6083333333333334
信道均衡技术,0,0,1,0,0,0,0,1,0.125
ifft模块,0,0,1,0,0,0,0,1,0.125
传输,0,0,1,0,1,1,0,3,0.6083333333333334
并行信号,0,0,1,0,0,0,0,1,0.125
多载波信号,0,0,1,0,0,0,0,1,0.125
调制,0,0,1,0,1,3,1,6,1.3333333333333333
ifft/fft模块,0,0,1,0,0,0,0,1,0.125
ifft,0,0,1,0,0,1,0,2,0.3666666666666667
快速傅里叶逆变换,0,0,1,0,0,0,0,1,0.125
transform,0,0,1,0,0,0,0,1,0.125
inversefastfourier,0,0,1,0,0,0,0,1,0.125
fastfouriertransform,0,0,1,0,0,0,0,1,0.125
流程,0,0,1,0,0,0,0,1,0.125
上行链路,0,0,1,0,0,0,0,1,0.125
lte标准,0,0,1,0,0,0,0,1,0.125
dvb,0,0,1,0,0,0,0,1,0.125
wimax,0,0,1,0,0,0,0,1,0.125
wlan,0,0,1,0,0,0,0,1,0.125
均衡复杂度,0,0,1,0,0,0,0,1,0.125
频率,0,0,8,7,27,3,0,45,9.125
信令,0,0,1,0,0,0,0,1,0.125
单载波频域均衡,0,0,2,0,0,0,0,2,0.25
正交频分复用,0,0,1,0,0,0,0,1,0.125
数据速率,0,0,1,0,0,0,0,1,0.125
宽带无线通信系统,0,0,1,0,0,1,0,2,0.3666666666666667
精准度,0,0,1,0,0,0,0,1,0.125
抗干扰能力,0,0,1,0,0,0,0,1,0.125
接收范,0,0,1,0,0,0,0,1,0.125
天线,0,0,1,0,0,3,0,4,0.85
传输距离,0,0,1,0,0,0,0,1,0.125
通信信号,0,0,1,0,3,0,0,4,0.85
干扰对消处理,0,0,1,0,0,0,0,1,0.125
联合分集,0,0,1,0,0,0,0,1,0.125
时域,0,0,1,0,1,1,0,3,0.6083333333333334
空、,0,0,1,0,0,0,0,1,0.125
频谱利用率,0,0,1,1,0,0,0,2,0.25
通信容量,0,0,1,0,0,0,0,1,0.125
mimo系统,0,0,1,0,0,0,0,1,0.125
无线通信,4,0,2,0,1,1,1,9,4.975
衰落,0,0,1,0,0,0,0,1,0.125
scfde系,0,0,1,0,0,0,0,1,0.125
imo,0,0,1,0,0,0,0,1,0.125
数字域,0,0,4,0,3,0,0,7,1.225
收发端,0,0,2,0,3,0,0,5,0.975
iq,0,0,2,0,1,0,0,3,0.4916666666666667
模拟域,0,0,2,0,0,0,0,2,0.25
幅度增益,0,0,2,0,0,0,0,2,0.25
信噪比,0,0,1,0,0,7,0,8,1.8166666666666667
发射机,0,0,2,1,3,6,1,13,2.7916666666666665
uq不平衡,0,0,1,0,0,0,1,2,0.3666666666666667
变频器,0,0,1,0,0,0,0,1,0.125
发送端,0,0,2,0,4,0,0,6,1.2166666666666668
芯片工艺,0,0,1,0,0,0,0,1,0.125
补偿成本,0,0,1,0,0,0,0,1,0.125
性能优化,0,0,1,0,0,0,0,1,0.125
补偿算法,1,0,1,0,3,0,0,5,1.85
数字信号处理,0,0,1,0,0,0,0,1,0.125
平衡,0,0,1,0,0,0,0,1,0.125
抑制,0,0,1,0,1,0,0,2,0.3666666666666667
数字信号,0,0,1,0,0,1,0,2,0.3666666666666667
性能矫正,0,0,1,0,0,0,0,1,0.125
滤波器,0,0,1,4,6,1,0,12,2.3166666666666664
模数数模转换器,0,0,1,0,0,0,0,1,0.125
放大器,0,0,2,3,0,0,0,5,0.625
误码率,0,0,1,1,0,2,1,5,0.975
地影响符号,0,0,1,0,0,0,0,1,0.125
镜像干扰,0,0,1,0,1,0,0,2,0.3666666666666667
宽带通信系统,0,0,1,2,0,0,0,3,0.375
选择性,0,0,1,0,0,0,0,1,0.125
窄带通信系统,0,0,1,2,0,0,0,3,0.375
fd,0,0,1,0,0,0,0,1,0.125
fi,0,0,1,0,0,0,0,1,0.125
相移偏差,0,0,1,0,0,0,0,1,0.125
数模转换器,0,0,1,0,0,1,0,2,0.3666666666666667
低通滤波器,0,0,1,0,0,0,0,1,0.125
相移差,0,0,1,0,0,0,0,1,0.125
vq不平衡,0,0,2,0,1,0,0,3,0.4916666666666667
数字预失真,0,1,4,4,0,1,1,11,3.4833333333333334
非线性器件,0,0,2,0,0,0,0,2,0.25
线性化,0,0,2,2,0,0,0,4,0.5
记忆预失真器,0,0,1,0,0,0,0,1,0.125
数学,0,0,1,0,0,0,0,1,0.125
神经网络,0,0,1,0,0,0,0,1,0.125
hammerstein模型,0,0,1,13,0,0,0,14,1.75
volterra级数,0,0,1,0,0,0,0,1,0.125
多项式预失真,0,0,1,0,0,0,0,1,0.125
非线性特性,1,0,2,14,0,0,4,21,3.966666666666667
查询,0,0,1,0,0,0,0,1,0.125
多项式,0,0,1,5,0,1,0,7,0.9916666666666667
预失真查询表,0,0,1,0,0,0,0,1,0.125
查询表,0,0,1,0,0,0,0,1,0.125
数字预失真技术,2,0,1,0,0,0,1,4,2.3666666666666667
模拟预失真,0,0,1,0,0,0,0,1,0.125
dpd,0,0,1,2,0,0,0,3,0.375
预失真技术,0,0,1,4,0,0,0,5,0.625
带宽特性,0,0,1,0,0,0,0,1,0.125
自适应性差,0,0,1,0,0,0,0,1,0.125
窄带通信,0,0,1,0,0,0,0,1,0.125
线性化技,0,0,1,2,0,0,0,3,0.375
尺寸,0,0,1,0,0,0,0,1,0.125
宽带系统,0,0,1,2,2,0,0,5,0.8583333333333334
前馈法,0,0,1,0,0,0,1,2,0.3666666666666667
线性区域,0,0,1,0,0,0,0,1,0.125
饱和区,0,0,1,2,0,0,0,3,0.375
预失真法,0,0,1,1,0,0,2,4,0.7333333333333334
前馈法口,0,0,1,0,0,0,0,1,0.125
功率回退技术,0,0,1,0,0,0,0,1,0.125
线性化技术,0,0,1,1,0,0,0,2,0.25
峰均比,0,0,1,1,0,0,0,2,0.25
输入信号,0,0,1,4,1,0,0,6,0.8666666666666667
传输信号,1,0,1,1,0,1,0,4,1.4916666666666667
软件无线电,0,0,1,0,0,0,0,1,0.125
自适应天线系统,0,0,1,0,0,0,0,1,0.125
移动通信技术,0,0,1,0,0,0,0,1,0.125
功放额效率,0,0,1,0,0,0,0,1,0.125
回退,0,0,1,0,0,0,0,1,0.125
wcdma,0,0,1,0,0,0,0,1,0.125
大功率放大器,0,0,1,0,0,0,0,1,0.125
非线性功放,0,0,1,0,0,0,0,1,0.125
fpga硬件,0,0,2,0,0,0,0,2,0.25
无线通信系统,0,0,2,0,0,0,1,3,0.4916666666666667
c语言平台,0,0,1,0,0,0,0,1,0.125
信噪比通信环境,0,0,1,0,0,0,0,1,0.125
mimosc-fde系统模型,0,0,1,0,0,0,0,1,0.125
mimo,0,0,1,0,0,0,0,1,0.125
迭代,0,0,1,0,1,0,0,2,0.3666666666666667
自适应滤波原理,0,0,1,0,0,0,0,1,0.125
循环复杂随机信号,0,0,1,0,0,0,0,1,0.125
vq不平衡干扰,0,0,1,0,0,0,0,1,0.125
预畸变,0,0,1,0,2,1,0,4,0.85
发端信号,0,0,1,0,2,0,0,3,0.6083333333333334
下变频,0,0,1,0,4,0,0,5,1.0916666666666668
上变频,0,0,1,0,1,0,0,2,0.3666666666666667
时域模型,0,0,1,0,1,0,0,2,0.3666666666666667
vq,0,0,1,0,0,0,0,1,0.125
宽带功放建模,0,0,1,0,0,0,0,1,0.125
dpd应用系统,0,0,1,0,0,0,0,1,0.125
记忆功放模型,0,0,1,0,0,0,0,1,0.125
mimosc-fde系统,3,0,1,3,0,13,0,20,6.641666666666667
功放模型,0,0,1,0,0,0,0,1,0.125
畸变,0,0,1,0,0,0,0,1,0.125
宽带信号,0,0,1,0,0,0,0,1,0.125
非理想特性,0,0,1,0,0,0,0,1,0.125
低信噪比通信链路,0,0,1,0,3,0,0,4,0.85
谐波,0,0,0,3,0,0,0,3,0.375
基波,0,0,0,2,0,0,0,2,0.25
输出信号,0,0,0,9,4,1,0,14,2.333333333333333
非线性系统,0,0,0,2,0,0,0,2,0.25
谐波失真,0,0,0,3,0,0,0,3,0.375
谐波功率,0,0,0,1,0,0,0,1,0.125
基波频率,0,0,0,1,0,0,0,1,0.125
谐波项,0,0,0,1,0,0,0,1,0.125
sfiv,0,0,0,1,0,0,0,1,0.125
单频信号,0,0,0,1,0,0,0,1,0.125
功率过滤放大器,0,0,0,1,0,0,0,1,0.125
功率回退,0,0,0,1,0,0,0,1,0.125
系数,0,0,0,7,1,1,0,9,1.3583333333333334
幕级数,0,0,0,1,0,0,0,1,0.125
级数,0,0,0,1,0,0,0,1,0.125
频率分量,0,0,0,4,0,0,0,4,0.5
交调失真,0,0,0,4,0,0,0,4,0.5
互调失真,0,0,0,4,0,0,0,4,0.5
失真,0,0,0,4,0,0,0,4,0.5
互调干扰,0,0,0,2,0,0,0,2,0.25
干扰信号,0,0,0,2,1,0,0,3,0.4916666666666667
三阶交调,0,0,0,1,0,0,0,1,0.125
线性化功放,0,0,0,1,0,0,0,1,0.125
基波信号,0,0,0,1,0,0,0,1,0.125
三阶交调分量,0,0,0,1,0,0,0,1,0.125
互调项,0,0,0,1,0,0,0,1,0.125
产物,0,0,0,1,0,0,0,1,0.125
三阶,0,0,0,1,0,0,0,1,0.125
三阶失真,0,0,0,1,0,0,0,1,0.125
二阶失真,0,0,0,1,0,0,0,1,0.125
非线性输出信号,0,0,0,1,0,0,0,1,0.125
多频信号,0,0,0,1,0,0,0,1,0.125
频谱失真,0,0,0,1,0,0,0,1,0.125
幅度失真,0,0,0,1,0,0,1,2,0.3666666666666667
交调干扰,0,0,0,1,0,0,0,1,0.125
差拍,0,0,0,1,0,0,0,1,0.125
扬声器,0,0,0,1,0,0,0,1,0.125
幅度调制,0,0,0,3,0,0,0,3,0.375
am-am,0,0,0,3,0,0,0,3,0.375
am/pm曲线,0,0,0,2,0,0,0,2,0.25
am/am曲线,0,0,0,2,0,0,0,2,0.25
it,0,0,0,2,0,0,0,2,0.25
ma,0,0,0,2,0,0,0,2,0.25
np,0,0,0,2,0,0,0,2,0.25
ze,0,0,0,2,0,0,0,2,0.25
norma,0,0,0,2,0,0,0,2,0.25
非线性函数,0,0,0,2,0,0,0,2,0.25
am-pm,0,0,0,2,0,0,0,2,0.25
非线性区,0,0,0,1,0,0,0,1,0.125
曲线,0,0,0,3,0,0,0,3,0.375
相移,0,0,0,1,0,0,0,1,0.125
无记忆非线性特性,0,0,0,1,0,0,0,1,0.125
带通,0,0,0,1,0,0,0,1,0.125
相位调制,0,0,0,1,0,0,0,1,0.125
非线性行为,0,0,0,1,0,0,0,1,0.125
相位ampm失真,0,0,0,1,0,0,0,1,0.125
幅度amam,0,0,0,1,0,0,0,1,0.125
非线性程度,0,0,0,3,0,0,0,3,0.375
特性曲线,0,0,0,4,0,0,0,4,0.5
波形,0,0,0,2,2,0,0,4,0.7333333333333334
线性区,0,0,0,2,0,0,0,2,0.25
截止区,0,0,0,2,0,0,0,2,0.25
工作,0,0,0,2,0,0,0,2,0.25
am/pm失真,0,0,0,1,0,0,0,1,0.125
am/am,0,0,0,1,0,0,0,1,0.125
非线性功放非线性,0,0,0,1,0,0,0,1,0.125
线性失真,0,0,0,1,1,0,0,2,0.3666666666666667
静态直流,0,0,0,1,0,0,0,1,0.125
模拟放大器,0,0,0,1,0,0,0,1,0.125
射频频段,0,0,0,1,0,1,0,2,0.3666666666666667
电路系统,0,0,0,1,0,0,0,1,0.125
近似线性系统,0,0,0,1,0,0,0,1,0.125
电子线路系统,0,0,0,1,0,0,0,1,0.125
强非线性关系,0,0,0,1,0,0,0,1,0.125
特征曲线,0,0,0,1,0,0,0,1,0.125
通信发射机,0,0,0,1,0,0,0,1,0.125
基带信号,0,0,0,2,4,1,0,7,1.4583333333333333
带通信号,0,0,0,2,0,0,0,2,0.25
带宽,0,0,0,2,4,1,0,7,1.4583333333333333
无记忆功率放大器,0,0,0,2,0,0,0,2,0.25
奇数阶信号,0,0,0,1,0,0,0,1,0.125
载波频率,0,0,0,2,0,0,0,2,0.25
偶数阶信号,0,0,0,1,0,0,0,1,0.125
基带模型,0,0,0,1,0,0,0,1,0.125
atkodd,0,0,0,1,0,0,0,1,0.125
实系数,0,0,0,1,0,0,0,1,0.125
塞级数,0,0,0,1,0,0,0,1,0.125
记忆效应,0,0,0,5,0,0,0,5,0.625
入信号,0,0,0,1,0,0,0,1,0.125
多项式模型,1,0,0,3,0,0,0,4,1.375
vblterra级数模型,0,0,0,3,0,0,0,3,0.375
记忆深度,0,0,0,3,0,0,0,3,0.375
阶数,0,0,0,3,1,0,0,4,0.6166666666666667
非对角线,0,0,0,1,0,0,0,1,0.125
对角线,0,0,0,1,1,0,0,2,0.3666666666666667
vblterra级数内核,0,0,0,1,0,0,0,1,0.125
wiener模型,0,0,0,11,0,0,0,11,1.375
无记忆非线性系统,0,0,0,5,0,0,0,5,0.625
线性时不变系统,0,0,0,5,0,0,0,5,0.625
记忆多项式模型,0,0,0,2,0,0,0,2,0.25
多项式数字预失真算法,0,0,0,2,0,0,1,3,0.4916666666666667
项数,0,0,0,1,0,0,0,1,0.125
简化结构,0,0,0,1,0,0,0,1,0.125
vblterra级数,0,0,0,3,0,0,0,3,0.375
模型,0,0,0,2,1,0,0,3,0.4916666666666667
偶项系数,0,0,0,1,0,0,0,1,0.125
交调信号,0,0,0,1,0,0,0,1,0.125
偶次谐波,0,0,0,1,0,0,0,1,0.125
偶数,0,0,0,1,0,0,0,1,0.125
mimosc-fde,1,0,0,1,0,2,1,5,1.85
记忆长度,0,0,0,1,0,0,0,1,0.125
功放系数,0,0,0,1,0,0,0,1,0.125
常数,0,0,0,2,1,0,0,3,0.4916666666666667
对角核,0,0,0,1,0,0,0,1,0.125
离散形式,0,0,0,1,0,0,0,1,0.125
实数,0,0,0,1,0,0,0,1,0.125
dtk,0,0,0,1,0,0,0,1,0.125
等效关系,0,0,0,1,0,0,0,1,0.125
精度,0,0,0,1,0,0,0,1,0.125
指数,0,0,0,1,0,0,0,1,0.125
建模误差,0,0,0,1,0,0,0,1,0.125
非线性系统模型,0,0,0,1,0,0,0,1,0.125
wlterra级数模型,0,0,0,1,0,0,0,1,0.125
volterra级数模型,0,0,0,1,0,0,0,1,0.125
记忆功率放大器模,0,0,0,1,0,0,0,1,0.125
非线性模型,0,0,0,1,0,0,0,1,0.125
误差,0,0,0,1,0,0,0,1,0.125
无记忆模型,0,0,0,3,0,0,0,3,0.375
记忆功率放大器,0,0,0,1,0,0,0,1,0.125
有记忆模型,0,0,0,3,0,0,0,3,0.375
系统信号,0,0,0,1,1,0,0,2,0.3666666666666667
计算量,0,0,0,1,0,0,0,1,0.125
仿真,1,0,0,3,13,4,2,23,5.966666666666667
行为模型,0,0,0,1,0,0,0,1,0.125
预失真器,0,0,0,6,0,0,0,6,0.75
特性函数,0,0,0,2,0,0,0,2,0.25
低信噪比系统,1,0,0,4,5,3,0,13,3.4333333333333336
性能仿真,0,0,0,2,0,0,1,3,0.4916666666666667
数字预失真算法,0,0,0,3,0,1,0,4,0.6166666666666667
增益,0,0,0,1,5,1,0,7,1.575
非线性单元,0,0,0,1,0,0,0,1,0.125
射频信号,0,0,0,1,1,0,0,2,0.3666666666666667
基带预失真技术,0,0,0,1,0,0,0,1,0.125
射频预失真,0,0,0,1,0,0,0,1,0.125
中频预失真,0,0,0,1,0,0,0,1,0.125
基带预失真,0,0,0,1,0,0,0,1,0.125
前反馈法,0,0,0,1,0,0,0,1,0.125
负反馈法,0,0,0,1,0,0,0,1,0.125
信号速率,0,0,0,1,0,0,0,1,0.125
抗误码能力,0,0,0,1,0,0,0,1,0.125
噪声,0,0,0,1,1,1,0,3,0.6083333333333334
带内失真,0,0,0,1,0,0,2,3,0.6083333333333334
频带利用率,0,0,0,2,0,1,1,4,0.7333333333333334
带外失真,0,0,0,1,0,0,2,3,0.6083333333333334
带内带外失真,0,0,0,1,0,0,0,1,0.125
功率效率,0,0,0,1,0,0,0,1,0.125
信源,0,0,0,8,0,1,0,9,1.2416666666666667
evm,0,0,0,4,0,0,0,4,0.5
数字预失真滤波器,0,0,0,4,0,5,0,9,1.7083333333333333
x轴,0,0,0,2,0,0,0,2,0.25
星座图,0,0,0,2,1,0,0,3,0.4916666666666667
数字预失真器,0,0,0,2,0,0,0,2,0.25
功率谱密度,0,0,0,2,0,0,0,2,0.25
维纳功放模型,0,0,0,2,0,0,0,2,0.25
矩阵,0,0,0,2,8,0,0,10,2.1833333333333336
预失真滤波器,1,0,0,2,8,0,1,12,3.425
星座,0,0,0,1,0,0,0,1,0.125
星座点,0,0,0,1,0,0,0,1,0.125
数据点,0,0,0,1,0,0,0,1,0.125
qpsk星座图,0,0,0,1,0,0,0,1,0.125
evm指标,0,0,0,1,0,0,0,1,0.125
数字预失真补偿,0,0,0,1,0,0,0,1,0.125
evm补偿,0,0,0,1,0,0,0,1,0.125
信号星座,0,0,0,1,0,0,0,1,0.125
evm畸变,0,0,0,1,0,0,0,1,0.125
维纳功放,0,0,0,1,0,0,0,1,0.125
补偿效果,0,0,0,1,2,0,0,3,0.6083333333333334
误差向量幅度,0,0,0,1,0,0,0,1,0.125
errorvectormagnitude,0,0,0,1,0,0,0,1,0.125
仿真功率谱,0,0,0,1,0,0,0,1,0.125
数字预畸变算法,0,0,0,1,0,0,0,1,0.125
frequency,0,0,0,1,0,0,0,1,0.125
信号曲线,0,0,0,1,0,0,0,1,0.125
绿线,0,0,0,1,0,0,0,1,0.125
红线,0,0,0,1,0,0,0,1,0.125
信源功率谱密度,0,0,0,1,0,0,0,1,0.125
蓝线,0,0,0,1,0,0,0,1,0.125
功率谱图,0,0,0,1,0,0,0,1,0.125
功放输出信号,0,0,0,1,0,0,0,1,0.125
数字滤波器,0,0,0,1,0,0,0,1,0.125
数字预失真滤波,0,0,0,1,0,2,0,3,0.6083333333333334
初始化,0,0,0,1,1,0,0,2,0.3666666666666667
加载信源,0,0,0,1,0,0,0,1,0.125
数字预失真系统,0,0,0,1,0,0,0,1,0.125
dpd训练算法,0,0,0,1,0,0,0,1,0.125
浮点仿真,0,0,0,1,0,0,0,1,0.125
方程组,0,0,0,1,0,0,0,1,0.125
乔莱斯基分解,0,0,0,1,0,0,0,1,0.125
反函数,0,0,0,1,0,0,0,1,0.125
线性性能,0,0,0,1,0,0,0,1,0.125
线性化性能,0,0,0,1,0,0,0,1,0.125
浮点仿真结,0,0,0,1,0,0,0,1,0.125
多项式功放模型,0,0,0,1,0,0,0,1,0.125
有记忆功放,0,0,0,1,0,0,0,1,0.125
无记忆功放,0,0,0,1,0,0,0,1,0.125
失真性能,0,0,0,1,0,0,0,1,0.125
信号幅度,0,0,0,1,0,0,0,1,0.125
性能曲线,0,0,0,0,4,6,0,10,2.4166666666666665
发射端幅度,0,0,0,0,1,0,0,1,0.24166666666666667
i/q不,0,0,0,0,3,1,0,4,0.9666666666666667
幅度不平衡参数,0,0,0,0,1,0,0,1,0.24166666666666667
能量,0,0,0,0,3,0,0,3,0.725
/q,0,0,0,0,1,0,0,1,0.24166666666666667
坐标,0,0,0,0,1,0,0,1,0.24166666666666667
横纵坐标,0,0,0,0,1,0,0,1,0.24166666666666667
i/q不平衡模型,0,0,0,0,2,0,0,2,0.48333333333333334
振幅,0,0,0,0,1,0,0,1,0.24166666666666667
本振信号,0,0,0,0,2,0,0,2,0.48333333333333334
幅度不,0,0,0,0,1,0,0,1,0.24166666666666667
幅度不平衡,0,0,0,0,1,0,0,1,0.24166666666666667
相位不,0,0,0,0,2,0,0,2,0.48333333333333334
相位不平衡,0,0,0,0,2,0,0,2,0.48333333333333334
snr,0,0,0,0,1,0,0,1,0.24166666666666667
相位不平衡参数,0,0,0,0,1,0,0,1,0.24166666666666667
相位差,0,0,0,0,1,0,0,1,0.24166666666666667
镜像信号,0,0,0,0,6,0,0,6,1.45
频谱,0,0,0,0,15,1,0,16,3.8666666666666667
不平衡,0,0,0,0,5,0,0,5,1.2083333333333333
接收信号,0,0,0,0,4,0,0,4,0.9666666666666667
图像衰减,0,0,0,0,4,0,0,4,0.9666666666666667
混频器,0,0,0,0,2,0,0,2,0.48333333333333334
网区,0,0,0,0,1,0,0,1,0.24166666666666667
rejection,0,0,0,0,1,0,0,1,0.24166666666666667
图像抑制比,0,0,0,0,5,0,0,5,1.2083333333333333
分贝,0,0,0,0,2,0,0,2,0.48333333333333334
缩放滤波,0,0,0,0,1,0,0,1,0.24166666666666667
不平衡信号,0,0,0,0,1,0,0,1,0.24166666666666667
复共,0,0,0,0,1,0,0,1,0.24166666666666667
复共短信号,0,0,0,0,1,0,0,1,0.24166666666666667
串扰,0,0,0,0,1,0,0,1,0.24166666666666667
变频信号,0,0,0,0,1,0,0,1,0.24166666666666667
脉冲信号,0,0,0,0,1,0,0,1,0.24166666666666667
xp,0,0,0,0,1,0,0,1,0.24166666666666667
i/q信号,0,0,0,0,1,0,0,1,0.24166666666666667
脉冲响应,0,0,0,0,4,0,0,4,0.9666666666666667
频率响应,0,0,0,0,3,3,1,7,1.6916666666666667
dq不平衡干扰,0,0,0,0,1,0,0,1,0.24166666666666667
频谱响应,0,0,0,0,1,0,0,1,0.24166666666666667
i/q分支,0,0,0,0,1,0,0,1,0.24166666666666667
adc,0,0,0,0,1,0,0,1,0.24166666666666667
有效值,0,0,0,0,1,0,0,1,0.24166666666666667
记忆,0,0,0,0,1,0,0,1,0.24166666666666667
瞬时,0,0,0,0,1,0,0,1,0.24166666666666667
基带理想信号,0,0,0,0,1,0,0,1,0.24166666666666667
i/q平衡,0,0,0,0,1,0,0,1,0.24166666666666667
变频号,0,0,0,0,1,0,0,1,0.24166666666666667
不平衡干扰源,0,0,0,0,1,0,0,1,0.24166666666666667
i/q混频器,0,0,0,0,1,0,0,1,0.24166666666666667
混频,0,0,0,0,1,0,0,1,0.24166666666666667
正交混合,0,0,0,0,1,0,0,1,0.24166666666666667
lquad,0,0,0,0,1,0,0,1,0.24166666666666667
干扰参数,0,0,0,0,1,0,0,1,0.24166666666666667
q路通道,0,0,0,0,1,0,0,1,0.24166666666666667
本地振荡器信号,0,0,0,0,1,0,0,1,0.24166666666666667
不平衡参数,0,0,0,0,3,0,0,3,0.725
等效复振荡器,0,0,0,0,1,0,0,1,0.24166666666666667
in,0,0,0,0,1,0,0,1,0.24166666666666667
本地振荡器,0,0,0,0,1,0,0,1,0.24166666666666667
模拟,0,0,0,0,3,0,0,3,0.725
ix,0,0,0,0,1,0,0,1,0.24166666666666667
图像信号,0,0,0,0,1,0,0,1,0.24166666666666667
i/q处理,0,0,0,0,1,0,0,1,0.24166666666666667
不平衡模型,0,0,0,0,2,0,0,2,0.48333333333333334
频选特性,0,0,0,0,1,0,0,1,0.24166666666666667
低频段系统,0,0,0,0,1,0,0,1,0.24166666666666667
频率选择性iq不平衡,0,0,0,0,1,0,0,1,0.24166666666666667
响应,0,0,0,0,2,0,0,2,0.48333333333333334
窄带系统,0,0,0,0,1,0,0,1,0.24166666666666667
相位失配,0,0,0,0,1,0,0,1,0.24166666666666667
a/d转换器,0,0,0,0,1,0,0,1,0.24166666666666667
iq不平衡系统模型,0,0,0,0,1,0,0,1,0.24166666666666667
反馈信号,1,0,0,0,9,1,1,12,3.658333333333333
反馈环路,0,0,0,0,3,0,0,3,0.725
变频,2,0,0,0,8,0,2,12,4.416666666666666
直流偏移,0,0,0,0,10,0,0,10,2.4166666666666665
调制器,1,0,0,0,3,0,1,5,1.9666666666666668
l0信号,0,0,0,0,2,0,0,2,0.48333333333333334
iq不平衡预补偿技术,0,0,0,0,2,0,0,2,0.48333333333333334
同步算法,0,0,0,0,2,0,0,2,0.48333333333333334
低通滤波,0,0,0,0,2,0,0,2,0.48333333333333334
i/q不平衡补偿,1,0,0,0,9,1,1,12,3.658333333333333
间接参数,0,0,0,0,1,0,0,1,0.24166666666666667
参数,1,0,0,0,5,3,1,10,3.175
直流偏量,0,0,0,0,1,0,0,1,0.24166666666666667
延迟,0,0,0,0,2,1,0,3,0.725
基带转换,0,0,0,0,1,0,0,1,0.24166666666666667
a/d转换,0,0,0,0,1,0,0,1,0.24166666666666667
lo泄漏,0,0,0,0,1,0,0,1,0.24166666666666667
q信号,0,0,0,0,1,0,0,1,0.24166666666666667
样本均值,0,0,0,0,2,0,0,2,0.48333333333333334
反馈信号块,0,0,0,0,1,0,0,1,0.24166666666666667
i/q校准参数,0,0,0,0,1,0,0,1,0.24166666666666667
偏差,0,0,0,0,2,0,0,2,0.48333333333333334
影响,0,0,0,0,1,0,0,1,0.24166666666666667
反馈基带信号,0,0,0,0,2,0,0,2,0.48333333333333334
杂散信号,0,0,0,0,1,0,0,1,0.24166666666666667
传输频带,0,0,0,0,1,0,0,1,0.24166666666666667
rf输出信号,0,0,0,0,1,0,0,1,0.24166666666666667
i/q路信号,0,0,0,0,1,0,0,1,0.24166666666666667
反馈,0,0,0,0,1,0,0,1,0.24166666666666667
母振荡器,0,0,0,0,1,0,0,1,0.24166666666666667
频率同步,0,0,0,0,2,0,0,2,0.48333333333333334
反馈链,0,0,0,0,1,0,0,1,0.24166666666666667
数据辅助算法,0,0,0,0,1,0,0,1,0.24166666666666667
定时同步,0,0,0,0,1,0,0,1,0.24166666666666667
校准系数,0,0,0,0,1,0,0,1,0.24166666666666667
内部反馈分支,0,0,0,0,1,0,0,1,0.24166666666666667
wl预失真滤波,0,0,0,0,1,0,0,1,0.24166666666666667
宽带多信道发射机,0,0,0,0,1,0,0,1,0.24166666666666667
i/q上,0,0,0,0,1,0,0,1,0.24166666666666667
频谱图,0,0,0,0,3,2,0,5,1.2083333333333333
预失真处理,0,0,0,0,1,0,0,1,0.24166666666666667
等效值,0,0,0,0,1,0,0,1,0.24166666666666667
i/q调制器,0,0,0,0,1,0,0,1,0.24166666666666667
频移,0,0,0,0,1,0,0,1,0.24166666666666667
采样,0,0,0,0,1,0,0,1,0.24166666666666667
模数转换器,0,0,0,0,1,0,0,1,0.24166666666666667
反馈分支,0,0,0,0,1,0,0,1,0.24166666666666667
gjq,0,0,0,0,1,0,0,1,0.24166666666666667
i/q不平衡参数,0,0,0,0,3,0,0,3,0.725
傅里叶变化,0,0,0,0,1,0,0,1,0.24166666666666667
预畸变冲击响应信号,0,0,0,0,1,0,0,1,0.24166666666666667
预畸变信号模型,0,0,0,0,1,0,0,1,0.24166666666666667
线性信号转换,0,0,0,0,1,0,0,1,0.24166666666666667
共扼信号,0,0,0,0,1,0,0,1,0.24166666666666667
数字基带,1,0,0,0,2,0,1,4,1.725
wl,0,0,0,0,3,0,0,3,0.725
广义线性,0,0,0,0,2,0,0,2,0.48333333333333334
抑制技术,0,0,0,0,1,0,0,1,0.24166666666666667
数据信号,0,0,0,0,1,0,0,1,0.24166666666666667
i/q上变频发射机,0,0,0,0,1,0,0,1,0.24166666666666667
校准性能,0,0,0,0,1,0,0,1,0.24166666666666667
线性最小二乘模型,0,0,0,0,1,0,0,1,0.24166666666666667
二阶统计量,0,0,0,0,13,0,0,13,3.1416666666666666
复杂通信信号,0,0,0,0,1,0,0,1,0.24166666666666667
校准参数,0,0,0,0,1,0,0,1,0.24166666666666667
校准,0,0,0,0,1,0,0,1,0.24166666666666667
宽带线性校准结构,0,0,0,0,1,0,0,1,0.24166666666666667
i/q不平衡预畸变,0,0,0,0,1,0,0,1,0.24166666666666667
iq不平衡算法,0,0,0,0,1,0,0,1,0.24166666666666667
相关量,0,0,0,0,1,0,0,1,0.24166666666666667
块长度,0,0,0,0,1,0,0,1,0.24166666666666667
样本数据,0,0,0,0,1,0,0,1,0.24166666666666667
发端数据,0,0,0,0,1,0,0,1,0.24166666666666667
卷积矩阵,0,0,0,0,2,0,0,2,0.48333333333333334
时域矩阵,0,0,0,0,1,0,0,1,0.24166666666666667
傅里叶变换,0,0,0,0,3,0,0,3,0.725
参数矩阵,0,0,0,0,1,0,0,1,0.24166666666666667
自相关参数,0,0,0,0,1,0,0,1,0.24166666666666667
autocorrelationfunction,0,0,0,0,2,0,0,2,0.48333333333333334
complementary,0,0,0,0,1,0,0,1,0.24166666666666667
互补自相关函数,0,0,0,0,1,0,0,1,0.24166666666666667
原始基带信号,0,0,0,0,1,0,0,1,0.24166666666666667
自相关函数,0,0,0,0,3,1,0,4,0.9666666666666667
反馈模型,0,0,0,0,1,0,0,1,0.24166666666666667
全零矩阵,0,0,0,0,1,0,0,1,0.24166666666666667
长度,0,0,0,0,8,6,0,14,3.3833333333333333
矢量,0,0,0,0,4,0,0,4,0.9666666666666667
预畸变滤波器,0,0,0,0,1,0,0,1,0.24166666666666667
矩阵长度,0,0,0,0,1,0,0,1,0.24166666666666667
冲激响应矢量矩阵,0,0,0,0,1,0,0,1,0.24166666666666667
基带矢量信号,0,0,0,0,1,0,0,1,0.24166666666666667
离散时间矢量矩阵,0,0,0,0,1,0,0,1,0.24166666666666667
二阶统计法,1,0,0,0,10,3,1,15,4.383333333333333
补偿性能,0,0,0,0,5,0,0,5,1.2083333333333333
ls,0,0,0,0,3,1,0,4,0.9666666666666667
预补偿,0,0,0,0,4,1,1,6,1.45
估计器,0,0,0,0,4,0,0,4,0.9666666666666667
镜像抑制比,0,0,0,0,2,0,0,2,0.48333333333333334
i/q不平衡预补偿算法,0,0,0,0,2,0,0,2,0.48333333333333334
ml-ls,0,0,0,0,2,0,0,2,0.48333333333333334
wl-ls法,0,0,0,0,2,0,0,2,0.48333333333333334
抽头系数,0,0,0,0,4,2,0,6,1.45
参数化,0,0,0,0,2,0,0,2,0.48333333333333334
wl-ls技术,0,0,0,0,2,0,0,2,0.48333333333333334
广义逆阵,0,0,0,0,2,0,0,2,0.48333333333333334
附加信息,0,0,0,0,1,0,0,1,0.24166666666666667
cacf,0,0,0,0,8,0,0,8,1.9333333333333333
样本,0,0,0,0,2,0,0,2,0.48333333333333334
ca,0,0,0,0,2,0,0,2,0.48333333333333334
非正则特性,0,0,0,0,2,0,0,2,0.48333333333333334
原始序列,0,0,0,0,1,0,0,1,0.24166666666666667
有限长度样本,0,0,0,0,1,0,0,1,0.24166666666666667
中频特性,0,0,0,0,1,0,0,1,0.24166666666666667
抑制比,0,0,0,0,1,0,0,1,0.24166666666666667
有限频谱特性,0,0,0,0,1,0,0,1,0.24166666666666667
原始信号,0,0,0,0,1,1,0,2,0.48333333333333334
镜像频率衰,0,0,0,0,1,0,0,1,0.24166666666666667
irr,0,0,0,0,1,0,0,1,0.24166666666666667
低频发射机,0,0,0,0,1,0,0,1,0.24166666666666667
预补偿滤波器,0,0,0,0,1,2,0,3,0.725
mhz,0,0,0,0,2,0,0,2,0.48333333333333334
-iq不平衡不补偿,0,0,0,0,1,0,0,1,0.24166666666666667
仿真性能,0,0,0,0,1,0,0,1,0.24166666666666667
仿真结,0,0,0,0,2,0,0,2,0.48333333333333334
衰减,0,0,0,0,1,0,0,1,0.24166666666666667
仿真预失真滤波器,0,0,0,0,1,0,0,1,0.24166666666666667
计系统,0,0,0,0,1,0,0,1,0.24166666666666667
采样率,0,0,0,0,1,0,0,1,0.24166666666666667
样本块,0,0,0,0,1,0,0,1,0.24166666666666667
反馈支路,0,0,0,0,1,0,0,1,0.24166666666666667
反馈链路,0,0,0,0,1,0,0,1,0.24166666666666667
非零抽头,0,0,0,0,1,0,0,1,0.24166666666666667
波动,0,0,0,0,1,0,0,1,0.24166666666666667
imagerejectionra,0,0,0,0,1,0,0,1,0.24166666666666667
线性qpsk调制,0,0,0,0,1,0,0,1,0.24166666666666667
低中频发射信号,0,0,0,0,1,0,0,1,0.24166666666666667
发射中频,0,0,0,0,1,0,0,1,0.24166666666666667
信号带宽,0,0,0,0,1,0,0,1,0.24166666666666667
镜像频率幅度,0,0,0,0,1,0,0,1,0.24166666666666667
预补偿算法,0,0,0,0,1,0,0,1,0.24166666666666667
波器,0,0,0,0,1,0,0,1,0.24166666666666667
预失真滤,0,0,0,0,1,0,0,1,0.24166666666666667
频率混合信号,0,0,0,0,1,0,0,1,0.24166666666666667
仿真信号,0,0,0,0,1,0,0,1,0.24166666666666667
l0泄漏,0,0,0,0,1,0,0,1,0.24166666666666667
计算机模拟,0,0,0,0,2,0,0,2,0.48333333333333334
计算,0,0,0,0,1,0,0,1,0.24166666666666667
预期模型,0,0,0,0,1,0,0,1,0.24166666666666667
ls估计器,0,0,0,0,1,0,0,1,0.24166666666666667
ls结构,0,0,0,0,1,0,0,1,0.24166666666666667
顺序递归,0,0,0,0,1,0,0,1,0.24166666666666667
调节矩阵,0,0,0,0,1,0,0,1,0.24166666666666667
对角系数,0,0,0,0,1,0,0,1,0.24166666666666667
低幅度循环白噪声信号,0,0,0,0,1,0,0,1,0.24166666666666667
可计算性能,0,0,0,0,1,0,0,1,0.24166666666666667
发射信号,0,0,0,0,4,3,0,7,1.6916666666666667
信号波形,0,0,0,0,1,0,0,1,0.24166666666666667
cacf特性,0,0,0,0,1,0,0,1,0.24166666666666667
数据样本,0,0,0,0,1,0,0,1,0.24166666666666667
统计,0,0,0,0,1,0,0,1,0.24166666666666667
自相关矩阵,0,0,0,0,1,0,0,1,0.24166666666666667
信号矢量,0,0,0,0,1,0,0,1,0.24166666666666667
逆矩阵,0,0,0,0,1,0,0,1,0.24166666666666667
非方阵,0,0,0,0,1,0,0,1,0.24166666666666667
可逆矩阵,0,0,0,0,1,0,0,1,0.24166666666666667
不平衡预畸变参数,0,0,0,0,1,0,0,1,0.24166666666666667
伪逆矩阵,0,0,0,0,1,0,0,1,0.24166666666666667
l/q不平衡滤波器,0,0,0,0,1,0,0,1,0.24166666666666667
观测信号块,0,0,0,0,1,0,0,1,0.24166666666666667
i/q不平衡预失真,0,0,0,0,1,0,0,1,0.24166666666666667
观测信号序列,0,0,0,0,1,0,0,1,0.24166666666666667
原始信号序列,0,0,0,0,1,0,0,1,0.24166666666666667
直接,0,0,0,0,1,0,0,1,0.24166666666666667
中频信号,0,0,0,0,10,1,0,11,2.658333333333333
随机相位,0,0,0,0,4,0,0,4,0.9666666666666667
等效基带信号,0,0,0,0,3,0,0,3,0.725
中频复信号,0,0,0,0,2,0,0,2,0.48333333333333334
单频率,0,0,0,0,2,0,0,2,0.48333333333333334
二阶统计特性,1,0,0,0,9,2,1,13,3.9
正则基带信号,0,0,0,0,1,0,0,1,0.24166666666666667
单位圆,0,0,0,0,1,0,0,1,0.24166666666666667
复数调制指数,0,0,0,0,1,0,0,1,0.24166666666666667
循环特性,0,0,0,0,8,1,0,9,2.175
正则特性,2,0,0,0,32,6,1,41,11.425
中频频谱,0,0,0,0,1,0,0,1,0.24166666666666667
多频率射频信号,0,0,0,0,1,0,0,1,0.24166666666666667
单频率信号,0,0,0,0,1,0,0,1,0.24166666666666667
相位项,0,0,0,0,2,0,0,2,0.48333333333333334
正则信号,0,0,0,0,23,1,0,24,5.8
多频率,0,0,0,0,2,0,0,2,0.48333333333333334
复合信号,0,0,0,0,1,0,0,1,0.24166666666666667
月风小丁,0,0,0,0,1,0,0,1,0.24166666666666667
源信号,0,0,0,0,2,1,0,3,0.725
复合中频信号,0,0,0,0,2,0,0,2,0.48333333333333334
模拟相位,0,0,0,0,1,0,0,1,0.24166666666666667
复中频信号,0,0,0,0,1,0,0,1,0.24166666666666667
复合多频率,0,0,0,0,1,0,0,1,0.24166666666666667
等效信号,0,0,0,0,1,0,0,1,0.24166666666666667
等效波形,0,0,0,0,1,0,0,1,0.24166666666666667
n维中频信号,0,0,0,0,1,0,0,1,0.24166666666666667
复合中频接收信号,0,0,0,0,1,0,0,1,0.24166666666666667
多频率信号,0,0,0,0,2,0,0,2,0.48333333333333334
频带,0,0,0,0,2,0,0,2,0.48333333333333334
补偿技术,0,0,0,0,1,0,0,1,0.24166666666666667
实数基带信号,0,0,0,0,1,0,0,1,0.24166666666666667
平稳性,0,0,0,0,1,0,0,1,0.24166666666666667
回归信号,0,0,0,0,1,0,0,1,0.24166666666666667
交叉谱密度,0,0,0,0,1,0,0,1,0.24166666666666667
频谱密度,0,0,0,0,1,0,0,1,0.24166666666666667
广义平稳,0,0,0,0,2,0,0,2,0.48333333333333334
复杂随机信号,1,0,0,0,4,1,1,7,2.45
共轲信号,0,0,0,0,1,0,0,1,0.24166666666666667
频率中频信号,0,0,0,0,1,0,0,1,0.24166666666666667
解析带通信号,0,0,0,0,1,0,0,1,0.24166666666666667
复共拆信号,0,0,0,0,1,0,0,1,0.24166666666666667
也能度量信号,0,0,0,0,1,0,0,1,0.24166666666666667
石口,0,0,0,0,1,0,0,1,0.24166666666666667
度量,0,0,0,0,1,0,0,1,0.24166666666666667
循环信号,0,0,0,0,7,0,0,7,1.6916666666666667
时间差,0,0,0,0,5,0,0,5,1.2083333333333333
acf,0,0,0,0,5,0,0,5,1.2083333333333333
i/q不平衡信号,0,0,0,0,4,0,0,4,0.9666666666666667
互相关函数,0,0,0,0,6,0,0,6,1.45
多载波中频信号,0,0,0,0,2,0,0,2,0.48333333333333334
基带等效信号,0,0,0,0,3,0,0,3,0.725
rf载波,0,0,0,0,2,0,0,2,0.48333333333333334
非对角线元素,0,0,0,0,2,0,0,2,0.48333333333333334
向量,0,0,0,0,2,0,0,2,0.48333333333333334
元素,0,0,0,0,2,0,0,2,0.48333333333333334
时延,0,0,0,0,2,0,0,2,0.48333333333333334
广义平稳信号,0,0,0,0,2,0,0,2,0.48333333333333334
均值,0,0,0,0,3,0,0,3,0.725
复数随机信号,0,0,0,0,2,0,0,2,0.48333333333333334
基带波形,0,0,0,0,1,0,0,1,0.24166666666666667
等效基带,0,0,0,0,1,0,0,1,0.24166666666666667
vq不平衡补偿技术,0,0,0,0,1,0,0,1,0.24166666666666667
多载波复合接收信号,0,0,0,0,1,0,0,1,0.24166666666666667
通用接收机,0,0,0,0,1,0,0,1,0.24166666666666667
digitalbaseband,0,0,0,0,1,0,0,1,0.24166666666666667
i/q不平衡补偿技术,0,0,0,0,2,1,0,3,0.725
模拟转换器件,0,0,0,0,1,0,0,1,0.24166666666666667
变频转换,0,0,0,0,1,0,0,1,0.24166666666666667
正则特性信号,0,0,0,0,1,0,0,1,0.24166666666666667
循环,0,0,0,0,1,0,0,1,0.24166666666666667
正则/循环信号,0,0,0,0,1,0,0,1,0.24166666666666667
i/q接收器,0,0,0,0,1,0,0,1,0.24166666666666667
文献刀,0,0,0,0,1,0,0,1,0.24166666666666667
q路信号数据,0,0,0,0,1,0,0,1,0.24166666666666667
i/q线性调制,0,0,0,0,1,0,0,1,0.24166666666666667
接收器,0,0,0,0,3,1,1,5,1.2083333333333333
窄带,0,0,0,0,1,1,0,2,0.48333333333333334
单信道,0,0,0,0,1,0,0,1,0.24166666666666667
盲补偿,0,0,0,0,1,1,0,2,0.48333333333333334
循环假设特性,0,0,0,0,1,0,0,1,0.24166666666666667
理想平衡信号,0,0,0,0,1,0,0,1,0.24166666666666667
代入符号,0,0,0,0,1,0,0,1,0.24166666666666667
acfo,0,0,0,0,1,0,0,1,0.24166666666666667
平衡源信号,0,0,0,0,1,0,0,1,0.24166666666666667
信号模型,0,0,0,0,1,0,0,1,0.24166666666666667
基本统计量,0,0,0,0,1,0,0,1,0.24166666666666667
二阶,0,0,0,0,1,0,0,1,0.24166666666666667
向量信号,0,0,0,0,1,0,0,1,0.24166666666666667
零均值信号源,0,0,0,0,1,0,0,1,0.24166666666666667
复杂随机向量信号,0,0,0,0,1,0,0,1,0.24166666666666667
标量信号,0,0,0,0,1,0,0,1,0.24166666666666667
对角线上元素,0,0,0,0,1,0,0,1,0.24166666666666667
nxn,0,0,0,0,1,0,0,1,0.24166666666666667
互补统计特性,0,0,0,0,1,0,0,1,0.24166666666666667
二阶表征特性,0,0,0,0,1,0,0,1,0.24166666666666667
金耳,0,0,0,0,1,0,0,1,0.24166666666666667
矢量值,0,0,0,0,1,0,0,1,0.24166666666666667
pam,0,0,0,0,1,0,0,1,0.24166666666666667
m-pulse-amplitudemodulation,0,0,0,0,1,0,0,1,0.24166666666666667
m阶脉冲幅度调制,0,0,0,0,1,0,0,1,0.24166666666666667
二进制psk信号,0,0,0,0,1,0,0,1,0.24166666666666667
实数调制信号,0,0,0,0,1,0,0,1,0.24166666666666667
key,0,0,0,0,1,0,0,1,0.24166666666666667
m-phaseshift,0,0,0,0,1,0,0,1,0.24166666666666667
m相移键控,0,0,0,0,1,0,0,1,0.24166666666666667
qam,0,0,0,0,1,0,0,1,0.24166666666666667
quadrature-amplitudemodulation,0,0,0,0,1,0,0,1,0.24166666666666667
普通正交幅度调制,0,0,0,0,1,0,0,1,0.24166666666666667
复信号,0,0,0,0,4,0,0,4,0.9666666666666667
不平衡补偿技术,0,0,0,0,1,0,0,1,0.24166666666666667
时间偏移点,0,0,0,0,1,0,0,1,0.24166666666666667
复杂信号,0,0,0,0,1,0,0,1,0.24166666666666667
奇函数,0,0,0,0,1,0,0,1,0.24166666666666667
二阶循环特性,0,0,0,0,1,0,0,1,0.24166666666666667
实数信号,0,0,0,0,1,0,0,1,0.24166666666666667
复杂随机循环信号,0,0,0,0,1,0,0,1,0.24166666666666667
二阶平稳信号,0,0,0,0,1,0,0,1,0.24166666666666667
关系函数,0,0,0,0,1,0,0,1,0.24166666666666667
pseudo-acf,0,0,0,0,1,0,0,1,0.24166666666666667
伪自相关函数,0,0,0,0,1,0,0,1,0.24166666666666667
complementaryacf,0,0,0,0,1,0,0,1,0.24166666666666667
自相关补充函数,0,0,0,0,1,0,0,1,0.24166666666666667
八全,0,0,0,0,1,0,0,1,0.24166666666666667
wide-sensestationary,0,0,0,0,1,0,0,1,0.24166666666666667
补偿器,0,0,0,0,14,2,0,16,3.8666666666666667
观察信号,0,0,0,0,4,0,0,4,0.9666666666666667
信道均衡,0,0,0,0,3,0,0,3,0.725
相位同步,0,0,0,0,2,0,0,2,0.48333333333333334
增益控制,0,0,0,0,2,0,0,2,0.48333333333333334
相位旋转,0,0,0,0,2,0,0,2,0.48333333333333334
i/q不平衡盲补偿技术,0,0,0,0,2,0,0,2,0.48333333333333334
补偿结构,0,0,0,0,3,1,1,5,1.2083333333333333
盲补偿技术,0,0,0,0,2,1,0,3,0.725
训练数据,0,0,0,0,1,0,0,1,0.24166666666666667
采样信号,0,0,0,0,1,0,0,1,0.24166666666666667
信号缩放,0,0,0,0,1,0,0,1,0.24166666666666667
数据调制,0,0,0,0,1,0,0,1,0.24166666666666667
数据,0,0,0,0,1,6,1,8,1.9333333333333333
残留项,0,0,0,0,1,0,0,1,0.24166666666666667
inter-symbolinter,0,0,0,0,1,0,0,1,0.24166666666666667
幅度缩放,0,0,0,0,1,0,0,1,0.24166666666666667
表达式,0,0,0,0,1,0,0,1,0.24166666666666667
最优解参数,0,0,0,0,1,0,0,1,0.24166666666666667
自适应滤波,0,0,0,0,1,0,0,1,0.24166666666666667
补偿滤波,0,0,0,0,1,0,0,1,0.24166666666666667
wl补偿器模型,0,0,0,0,1,0,0,1,0.24166666666666667
dq不平衡,0,0,0,0,1,0,0,1,0.24166666666666667
多抽头系数,0,0,0,0,1,0,0,1,0.24166666666666667
补偿器模型,0,0,0,0,1,0,0,1,0.24166666666666667
最优解,0,0,0,0,1,0,0,1,0.24166666666666667
wl补偿结构,0,0,0,0,1,0,0,1,0.24166666666666667
迭代模块,0,0,0,0,1,0,0,1,0.24166666666666667
处理模块,0,0,0,0,1,0,0,1,0.24166666666666667
filter,0,0,0,0,1,0,0,1,0.24166666666666667
wl补偿器,0,0,0,0,2,0,0,2,0.48333333333333334
不平衡补偿系数,0,0,0,0,1,0,0,1,0.24166666666666667
共辗项,0,0,0,0,1,0,0,1,0.24166666666666667
共朝项,0,0,0,0,1,0,0,1,0.24166666666666667
系数估计结构,0,0,0,0,1,0,0,1,0.24166666666666667
不平衡补偿结构,0,0,0,0,1,0,0,1,0.24166666666666667
共轨信号,0,0,0,0,1,0,0,1,0.24166666666666667
镜像频率抑制比,0,0,0,0,1,0,0,1,0.24166666666666667
多信道宽带接收机,0,0,0,0,1,0,0,1,0.24166666666666667
多载波,0,0,0,0,1,0,0,1,0.24166666666666667
基本,0,0,0,0,1,0,0,1,0.24166666666666667
收敛速度,0,0,0,0,3,0,0,3,0.725
自适应滤波器,0,0,0,0,3,1,0,4,0.9666666666666667
平滑参数,0,0,0,0,2,0,0,2,0.48333333333333334
步长,0,0,0,0,3,0,0,3,0.725
稳态系数,0,0,0,0,1,0,0,1,0.24166666666666667
自适应,0,0,0,0,1,3,0,4,0.9666666666666667
存储深度,0,0,0,0,1,0,0,1,0.24166666666666667
平滑系数,0,0,0,0,1,0,0,1,0.24166666666666667
基带补偿器,0,0,0,0,1,0,0,1,0.24166666666666667
自适应迭代算法,0,0,0,0,1,0,0,1,0.24166666666666667
残余波动,0,0,0,0,1,0,0,1,0.24166666666666667
稳态点,0,0,0,0,1,0,0,1,0.24166666666666667
稳态,0,0,0,0,1,0,0,1,0.24166666666666667
平滑运算,0,0,0,0,1,0,0,1,0.24166666666666667
自适应滤波算法,0,0,0,0,1,0,0,1,0.24166666666666667
有用信号,0,0,0,0,1,0,0,1,0.24166666666666667
正则二阶统计特性,0,0,0,0,1,0,0,1,0.24166666666666667
自适应算法,0,0,0,0,4,1,1,6,1.45
线性函数,0,0,0,0,1,0,0,1,0.24166666666666667
驱动机制,0,0,0,0,1,0,0,1,0.24166666666666667
抽头系数补偿器,0,0,0,0,1,0,0,1,0.24166666666666667
i/q不平衡系数,0,0,0,0,1,0,0,1,0.24166666666666667
瞬时采样数据样本,0,0,0,0,1,0,0,1,0.24166666666666667
自适应滤波补偿,0,0,0,0,1,0,0,1,0.24166666666666667
频率偏移,0,0,0,0,6,0,0,6,1.45
信道失真信号,0,0,0,0,2,0,0,2,0.48333333333333334
通信复信号,0,0,0,0,2,0,0,2,0.48333333333333334
不平衡补偿,0,0,0,0,2,0,0,2,0.48333333333333334
载波同步,0,0,0,0,1,0,0,1,0.24166666666666667
i/q不平衡补偿算法,0,0,0,0,2,0,1,3,0.725
频移信号,0,0,0,0,1,0,0,1,0.24166666666666667
二阶统计特征,0,0,0,0,1,0,0,1,0.24166666666666667
频率选择性信道,0,0,0,0,1,0,0,1,0.24166666666666667
初步补偿算法,0,0,0,0,1,0,0,1,0.24166666666666667
复合二阶统计特性,0,0,0,0,1,0,0,1,0.24166666666666667
卷积运算,0,0,0,0,1,0,0,1,0.24166666666666667
基带收信号,0,0,0,0,1,0,0,1,0.24166666666666667
基带等效信道,0,0,0,0,1,0,0,1,0.24166666666666667
等效发送信号,0,0,0,0,1,0,0,1,0.24166666666666667
信道线性失真,0,0,0,0,2,0,0,2,0.48333333333333334
衰落信道,0,0,0,0,3,0,0,3,0.725
数字i/q不平衡补偿,0,0,0,0,1,0,0,1,0.24166666666666667
鲁棒性,0,0,0,0,1,0,0,1,0.24166666666666667
正则特性特征,0,0,0,0,1,0,0,1,0.24166666666666667
循环复高斯信道,0,0,0,0,1,0,0,1,0.24166666666666667
衰落路径,0,0,0,0,1,0,0,1,0.24166666666666667
衰落特性,0,0,0,0,1,0,0,1,0.24166666666666667
延迟分辨率,0,0,0,0,1,0,0,1,0.24166666666666667
时间延迟,0,0,0,0,1,0,0,1,0.24166666666666667
复脉冲响应增益,0,0,0,0,1,0,0,1,0.24166666666666667
基带发送信号,0,0,0,0,1,0,0,1,0.24166666666666667
基本多径模型,0,0,0,0,1,0,0,1,0.24166666666666667
路径,0,0,0,0,2,0,0,2,0.48333333333333334
时变,0,0,0,0,1,0,0,1,0.24166666666666667
移动通信,0,0,0,0,1,0,0,1,0.24166666666666667
信道脉冲响应,0,0,0,0,1,0,0,1,0.24166666666666667
信道失真分析,0,0,0,0,1,0,0,1,0.24166666666666667
衰落无线信道,0,0,0,0,1,0,0,1,0.24166666666666667
移动性,0,0,0,0,1,0,0,1,0.24166666666666667
时变特征,0,0,0,0,3,0,0,3,0.725
识别,0,0,0,0,1,0,0,1,0.24166666666666667
时变差异,0,0,0,0,1,0,0,1,0.24166666666666667
的自动增益控制机,0,0,0,0,1,0,0,1,0.24166666666666667
i、q信,0,0,0,0,1,0,0,1,0.24166666666666667
效应,0,0,0,0,1,0,0,1,0.24166666666666667
衰落环,0,0,0,0,1,0,0,1,0.24166666666666667
温度,0,0,0,0,1,0,0,1,0.24166666666666667
模拟前端特性,0,0,0,0,1,0,0,1,0.24166666666666667
不平衡特性,0,0,0,0,1,0,0,1,0.24166666666666667
迭代补偿器,0,0,0,0,1,0,0,1,0.24166666666666667
自适应特性,0,0,0,0,1,0,0,1,0.24166666666666667
跟踪模,0,0,0,0,1,0,0,1,0.24166666666666667
时变iq不平衡,0,0,0,0,1,0,0,1,0.24166666666666667
直流偏移干扰,0,0,0,0,2,0,0,2,0.48333333333333334
零均值,0,0,0,0,1,0,0,1,0.24166666666666667
残余偏置,0,0,0,0,1,0,0,1,0.24166666666666667
消除器,0,0,0,0,1,0,0,1,0.24166666666666667
偏置影响,0,0,0,0,1,0,0,1,0.24166666666666667
衰落无线电信道,0,0,0,0,1,0,0,1,0.24166666666666667
择性,0,0,0,0,1,0,0,1,0.24166666666666667
加性噪声,0,0,0,0,1,0,0,1,0.24166666666666667
射频干扰,0,0,0,0,1,0,0,1,0.24166666666666667
目标信号,0,0,0,0,1,0,0,1,0.24166666666666667
概率分布,0,0,0,0,1,0,0,1,0.24166666666666667
信号调制,0,0,0,0,1,1,0,2,0.48333333333333334
系统结构,0,0,0,0,1,0,0,1,0.24166666666666667
训练序列,0,0,0,0,1,0,0,1,0.24166666666666667
自适应盲补偿算法,0,0,0,0,3,2,1,6,1.45
收端盲补偿技术,0,0,0,0,1,0,0,1,0.24166666666666667
算法仿真,0,0,0,0,1,0,0,1,0.24166666666666667
三抽头系数,0,0,0,0,2,0,0,2,0.48333333333333334
自适应滤波补偿算法,0,0,0,0,2,0,0,2,0.48333333333333334
迭代补偿滤波器,0,0,0,0,1,0,0,1,0.24166666666666667
三抽头,0,0,0,0,1,0,0,1,0.24166666666666667
单抽头,0,0,0,0,1,0,0,1,0.24166666666666667
时间,0,0,0,0,2,2,1,5,1.2083333333333333
三抽头补偿曲线,0,0,0,0,1,0,0,1,0.24166666666666667
单抽头补偿曲线,0,0,0,0,1,0,0,1,0.24166666666666667
平均数,0,0,0,0,1,0,0,1,0.24166666666666667
仿真数据,0,0,0,0,1,0,0,1,0.24166666666666667
单抽头系数,0,0,0,0,1,0,0,1,0.24166666666666667
irr波动,0,0,0,0,1,0,0,1,0.24166666666666667
误比特率,0,0,0,0,1,0,0,1,0.24166666666666667
实验室仿真,0,0,0,0,1,0,0,1,0.24166666666666667
模拟前端,0,0,0,0,1,1,0,2,0.48333333333333334
测量数据,0,0,0,0,1,0,0,1,0.24166666666666667
ioiog,0,0,0,0,1,0,0,1,0.24166666666666667
数字处理,0,0,0,0,1,0,0,1,0.24166666666666667
拟前端镜像频率衰减,0,0,0,0,1,0,0,1,0.24166666666666667
总镜像频率衰减,0,0,0,0,1,0,0,1,0.24166666666666667
性能指,0,0,0,0,1,0,0,1,0.24166666666666667
irr指数,0,0,0,0,1,0,0,1,0.24166666666666667
迭代次数,0,0,0,0,1,0,0,1,0.24166666666666667
模拟仿真,0,0,0,0,1,0,0,1,0.24166666666666667
盲补偿算法,0,0,0,0,1,1,0,2,0.48333333333333334
载波同步误差,0,0,0,0,1,1,1,3,0.725
频率选择性衰落,0,0,0,0,1,1,1,3,0.725
选择性衰落,0,0,0,0,1,3,1,5,1.2083333333333333
基础通信信道,0,0,0,0,1,1,1,3,0.725
自适应盲补偿,0,0,0,0,1,1,1,3,0.725
通信系统信号,0,0,0,0,1,1,1,3,0.725
二阶特性,0,0,0,0,1,1,0,2,0.48333333333333334
信号调制条件,0,0,0,0,1,1,0,2,0.48333333333333334
i/q不平衡效应,0,0,0,0,1,1,0,2,0.48333333333333334
动态,0,0,0,0,1,1,0,2,0.48333333333333334
时变性,0,0,0,0,1,1,1,3,0.725
不平衡属性,0,0,0,0,1,1,1,3,0.725
静态不平衡场,0,0,0,0,1,1,1,3,0.725
共视信号,0,0,0,0,1,0,0,1,0.24166666666666667
i/q不平衡盲补偿,0,0,0,0,1,1,0,2,0.48333333333333334
观测信号,1,0,0,0,1,1,0,3,1.4833333333333334
宽带复合中频信号,0,0,0,0,1,1,0,2,0.48333333333333334
调制频率,0,0,0,0,1,1,0,2,0.48333333333333334
i/q不平衡补偿校准性能,0,0,0,0,1,1,1,3,0.725
wl-ls算法,0,0,0,0,1,1,1,3,0.725
发送数据,0,0,0,0,1,1,0,2,0.48333333333333334
wl-ls模型,0,0,0,0,1,1,0,2,0.48333333333333334
移动发射机,0,0,0,0,1,1,1,3,0.725
低中频型,0,0,0,0,1,1,1,3,0.725
二阶统计算法,0,0,0,0,1,1,1,3,0.725
反馈路径,0,0,0,0,1,1,1,3,0.725
ls估计法,1,0,0,0,1,0,1,3,1.4833333333333334
dq不平衡预补偿,0,0,0,0,1,0,0,1,0.24166666666666667
非理性特性,0,0,0,0,1,0,1,2,0.48333333333333334
i/q不平衡系统,0,0,0,0,1,0,1,2,0.48333333333333334
单载波频域,0,0,0,0,0,3,0,3,0.725
imosc-fde系统,0,0,0,0,0,3,0,3,0.725
发射天线,0,0,0,0,0,3,0,3,0.725
循环前缀,0,0,0,0,0,3,0,3,0.725
符号映射,0,0,0,0,0,2,0,2,0.48333333333333334
比特序列,0,0,0,0,0,2,0,2,0.48333333333333334
多径干扰,0,0,0,0,0,2,0,2,0.48333333333333334
误码率性能,0,0,0,0,0,1,0,1,0.24166666666666667
系统传输,0,0,0,0,0,1,0,1,0.24166666666666667
空间分集技术,0,0,0,0,0,1,0,1,0.24166666666666667
空间复用技术,0,0,0,0,0,1,0,1,0.24166666666666667
平坦衰落信道,0,0,0,0,0,1,0,1,0.24166666666666667
频率选择性衰落信道,0,0,0,0,0,1,0,1,0.24166666666666667
宽带,0,0,0,0,1,1,0,2,0.48333333333333334
sc-fde技,0,0,0,0,0,1,0,1,0.24166666666666667
单载波频域技术,0,0,0,0,0,1,0,1,0.24166666666666667
串并转换,0,0,0,0,0,1,0,1,0.24166666666666667
解调译码,0,0,0,0,0,1,0,1,0.24166666666666667
傅里叶逆变换,0,0,0,0,0,1,0,1,0.24166666666666667
快速,0,0,0,0,0,1,0,1,0.24166666666666667
有效信号数据,0,0,0,0,0,1,0,1,0.24166666666666667
信号发射,0,0,0,0,0,1,0,1,0.24166666666666667
转换信号,0,0,0,0,0,1,0,1,0.24166666666666667
单载波频域系统,0,0,0,0,0,1,0,1,0.24166666666666667
系统复杂度,0,0,0,0,0,1,0,1,0.24166666666666667
信道均衡环节,0,0,0,0,0,1,0,1,0.24166666666666667
分块传输技术,0,0,0,0,0,1,0,1,0.24166666666666667
信息传输性能,0,0,0,0,0,1,0,1,0.24166666666666667
多天线技术,0,0,0,0,0,1,0,1,0.24166666666666667
远距离低信噪比,0,0,0,0,0,1,0,1,0.24166666666666667
实验室,0,0,0,0,0,1,1,2,0.48333333333333334
发送带宽,0,0,0,0,0,1,0,1,0.24166666666666667
发送功率,0,0,0,0,0,1,0,1,0.24166666666666667
mimo技,0,0,0,0,0,1,0,1,0.24166666666666667
频率选择性,0,0,0,0,1,2,0,3,0.725
imo-scfde系统,0,0,0,0,0,2,0,2,0.48333333333333334
ise,0,0,0,0,0,2,0,2,0.48333333333333334
veriloghdl,0,0,0,0,0,2,0,2,0.48333333333333334
硬件描述语言,0,0,0,0,0,2,0,2,0.48333333333333334
virtex-6芯片,0,0,0,0,0,1,0,1,0.24166666666666667
xilinx,0,0,0,0,0,1,0,1,0.24166666666666667
反面,0,0,0,0,0,1,0,1,0.24166666666666667
实物环境,0,0,0,0,0,1,0,1,0.24166666666666667
测试平台,0,0,0,0,0,1,0,1,0.24166666666666667
数据时隙,0,0,0,0,0,18,0,18,4.35
数据块,0,0,0,0,0,7,0,7,1.6916666666666667
符号,0,0,0,0,0,6,0,6,1.45
qpsk映射,0,0,0,0,0,6,0,6,1.45
编码器,0,0,0,0,0,5,0,5,1.2083333333333333
turbo编码器,0,0,0,0,0,7,0,7,1.6916666666666667
turbo编码,0,0,0,0,0,6,0,6,1.45
导频,0,0,0,0,0,15,0,15,3.625
帧头,0,0,0,0,0,14,0,14,3.3833333333333333
奇偶数据时隙,0,0,0,0,0,3,0,3,0.725
数据采集,0,0,0,0,0,6,0,6,1.45
数模转换,0,0,0,0,0,2,0,2,0.48333333333333334
fifo缓存,0,0,0,0,0,2,0,2,0.48333333333333334
根升余弦滤波器,0,0,0,0,0,2,0,2,0.48333333333333334
格雷序列,0,0,0,0,0,9,0,9,2.175
stbc,0,0,0,0,0,2,0,2,0.48333333333333334
qpsk映射单元,0,0,0,0,0,2,0,2,0.48333333333333334
qpp,0,0,0,0,0,2,0,2,0.48333333333333334
传输速率,0,0,0,0,0,4,0,4,0.9666666666666667
中频调制,0,0,0,0,0,2,0,2,0.48333333333333334
空时块编码,0,0,0,0,0,3,0,3,0.725
速率匹配,0,0,0,0,0,3,0,3,0.725
发信机,0,0,0,0,0,1,0,1,0.24166666666666667
累加,0,0,0,0,0,2,0,2,0.48333333333333334
插值滤波,0,0,0,0,0,1,0,1,0.24166666666666667
频谱搬移,0,0,0,0,0,1,0,1,0.24166666666666667
数据位宽,0,0,0,0,0,1,0,1,0.24166666666666667
深度,0,0,0,0,0,3,0,3,0.725
rrc滤波,0,0,0,0,0,2,0,2,0.48333333333333334
中频接口,0,0,0,0,0,1,0,1,0.24166666666666667
双通道,0,0,0,0,0,1,0,1,0.24166666666666667
ad9125,0,0,0,0,0,1,0,1,0.24166666666666667
ncy,0,0,0,0,0,2,0,2,0.48333333333333334
rrc,0,0,0,0,0,2,0,2,0.48333333333333334
3db带宽,0,0,0,0,0,1,0,1,0.24166666666666667
符号传输速率,0,0,0,0,0,1,0,1,0.24166666666666667
取值,0,0,0,0,0,1,0,1,0.24166666666666667
滚降系数,0,0,0,0,0,1,0,1,0.24166666666666667
滤波,0,0,0,0,0,1,0,1,0.24166666666666667
fir型,0,0,0,0,0,1,0,1,0.24166666666666667
插入帧头,0,0,0,0,0,1,0,1,0.24166666666666667
同步,0,0,0,0,0,3,0,3,0.725
收端信号,0,0,0,0,0,2,0,2,0.48333333333333334
格雷同步序列,0,0,0,0,0,1,0,1,0.24166666666666667
8192长度,0,0,0,0,0,1,0,1,0.24166666666666667
导频块,0,0,0,0,0,1,0,1,0.24166666666666667
短循环前缀符号,0,0,0,0,0,1,0,1,0.24166666666666667
81,0,0,0,0,0,2,0,2,0.48333333333333334
单元帧结构,0,0,0,0,0,1,0,1,0.24166666666666667
业务数据,0,0,0,0,0,7,0,7,1.6916666666666667
时序,0,0,0,0,0,8,0,8,1.9333333333333333
成帧操,0,0,0,0,0,1,0,1,0.24166666666666667
数据码块,0,0,0,0,0,1,0,1,0.24166666666666667
数学表达式,0,0,0,0,0,1,0,1,0.24166666666666667
逆序,0,0,0,0,0,1,0,1,0.24166666666666667
符号向量,0,0,0,0,0,1,0,1,0.24166666666666667
天线2,0,0,0,0,0,1,0,1,0.24166666666666667
天线1,0,0,0,0,0,1,0,1,0.24166666666666667
串行传输,0,0,0,0,0,1,0,1,0.24166666666666667
符号周期,0,0,0,0,0,1,0,1,0.24166666666666667
帧单元,0,0,0,0,0,1,0,1,0.24166666666666667
串行码块,0,0,0,0,0,1,0,1,0.24166666666666667
空时编码,0,0,0,0,0,1,0,1,0.24166666666666667
alamouti,0,0,0,0,0,1,0,1,0.24166666666666667
单元,0,0,0,0,0,1,0,1,0.24166666666666667
数据传输速率,0,0,0,0,0,1,0,1,0.24166666666666667
q路信号,0,0,0,0,0,1,0,1,0.24166666666666667
i路信号,0,0,0,0,0,1,0,1,0.24166666666666667
qpsk,0,0,0,0,0,3,0,3,0.725
映射,0,0,0,0,0,3,0,3,0.725
比特映射,0,0,0,0,0,1,0,1,0.24166666666666667
速率,0,0,0,0,0,3,0,3,0.725
码块长度,0,0,0,0,0,1,0,1,0.24166666666666667
比特数,0,0,0,0,0,1,0,1,0.24166666666666667
尾比特,0,0,0,0,0,1,0,1,0.24166666666666667
28比特,0,0,0,0,0,1,0,1,0.24166666666666667
数据块长度,0,0,0,0,0,1,0,1,0.24166666666666667
业务信息数据块,0,0,0,0,0,1,0,1,0.24166666666666667
2比特校验位,0,0,0,0,0,1,0,1,0.24166666666666667
比特校验位,0,0,0,0,0,1,0,1,0.24166666666666667
比特信息,0,0,0,0,0,1,0,1,0.24166666666666667
比特,0,0,0,0,0,1,0,1,0.24166666666666667
比特码元,0,0,0,0,0,1,0,1,0.24166666666666667
码率,0,0,0,0,0,1,0,1,0.24166666666666667
前向纠错卷积码子编码器,0,0,0,0,0,1,0,1,0.24166666666666667
rsc,0,0,0,0,0,1,0,1,0.24166666666666667
前向纠错卷积码,0,0,0,0,0,1,0,1,0.24166666666666667
oturbo编码器,0,0,0,0,0,1,0,1,0.24166666666666667
交织地址,0,0,0,0,0,1,0,1,0.24166666666666667
码长,0,0,0,0,0,1,0,1,0.24166666666666667
交织,0,0,0,0,0,1,0,1,0.24166666666666667
turbo码,0,0,0,0,0,1,0,1,0.24166666666666667
ccsds,0,0,0,0,0,1,0,1,0.24166666666666667
信道编码,0,0,0,0,0,1,0,1,0.24166666666666667
比特源信息,0,0,0,0,0,1,0,1,0.24166666666666667
kb,0,0,0,0,0,1,0,1,0.24166666666666667
比特流,0,0,0,0,0,2,0,2,0.48333333333333334
业务信息数据,0,0,0,0,0,1,0,1,0.24166666666666667
比特源信号,0,0,0,0,0,1,0,1,0.24166666666666667
dac,0,0,0,0,0,1,0,1,0.24166666666666667
成型滤波,0,0,0,0,0,2,0,2,0.48333333333333334
成帧,0,0,0,0,0,3,0,3,0.725
发送端架,0,0,0,0,0,1,0,1,0.24166666666666667
帧结构,0,0,0,0,0,15,0,15,3.625
格雷互补序列,0,0,0,0,0,12,0,12,2.9
序列,0,0,0,0,0,5,0,5,1.2083333333333333
导频序列,0,0,0,0,0,5,0,5,1.2083333333333333
时隙,0,0,0,0,0,8,0,8,1.9333333333333333
小m序列,0,0,0,0,0,2,0,2,0.48333333333333334
对流层散射信道,0,0,0,0,0,2,0,2,0.48333333333333334
扩频增益,0,0,0,0,0,2,0,2,0.48333333333333334
信息数据调制符号,0,0,0,0,0,2,0,2,0.48333333333333334
循环前缀符号,0,0,0,0,0,2,0,2,0.48333333333333334
对位,0,0,0,0,0,1,0,1,0.24166666666666667
码片,0,0,0,0,0,1,0,1,0.24166666666666667
信号映射,0,0,0,0,0,1,0,1,0.24166666666666667
大序列m,0,0,0,0,0,1,0,1,0.24166666666666667
伪随机序列,0,0,0,0,0,1,0,1,0.24166666666666667
游程长度,0,0,0,0,0,1,0,1,0.24166666666666667
mimo天线架构,0,0,0,0,0,1,0,1,0.24166666666666667
mimosc-fde通信系统,0,0,0,0,0,1,0,1,0.24166666666666667
连接,0,0,0,0,0,1,0,1,0.24166666666666667
同步性能,0,0,0,0,0,1,0,1,0.24166666666666667
捕获操作,0,0,0,0,0,1,0,1,0.24166666666666667
自相关旁瓣值,0,0,0,0,0,1,0,1,0.24166666666666667
互相关值,0,0,0,0,0,1,0,1,0.24166666666666667
互相关性能,0,0,0,0,0,1,0,1,0.24166666666666667
自相关性能,0,0,0,0,0,1,0,1,0.24166666666666667
帧头导频,0,0,0,0,0,2,0,2,0.48333333333333334
速率匹,0,0,0,0,0,2,0,2,0.48333333333333334
调制符号,0,0,0,0,0,1,0,1,0.24166666666666667
信道时延扩展,0,0,0,0,0,1,0,1,0.24166666666666667
时fft,0,0,0,0,0,1,0,1,0.24166666666666667
系统性能,0,0,0,0,0,1,0,1,0.24166666666666667
时间长度,0,0,0,0,0,1,0,1,0.24166666666666667
干扰特性,0,0,0,0,0,1,0,1,0.24166666666666667
远距离通信,0,0,0,0,0,1,0,1,0.24166666666666667
导频时长,0,0,0,0,0,1,0,1,0.24166666666666667
导频间隔,0,0,0,0,0,1,0,1,0.24166666666666667
传输性能,0,0,0,0,0,1,0,1,0.24166666666666667
时域间隔,0,0,0,0,0,1,0,1,0.24166666666666667
帧头时隙时间长,0,0,0,0,0,1,0,1,0.24166666666666667
互补序列,0,0,0,0,0,1,0,1,0.24166666666666667
格雷,0,0,0,0,0,1,0,1,0.24166666666666667
帧头时隙,0,0,0,0,0,1,0,1,0.24166666666666667
半帧,0,0,0,0,0,1,0,1,0.24166666666666667
时间长,0,0,0,0,0,1,0,1,0.24166666666666667
时钟频率,0,0,0,0,0,1,0,1,0.24166666666666667
frame,0,0,0,0,0,7,0,7,1.6916666666666667
rame,0,0,0,0,0,6,0,6,1.45
帧头序列,0,0,0,0,0,6,0,6,1.45
成帧模块,0,0,0,0,0,6,0,6,1.45
pilot,0,0,0,0,0,5,0,5,1.2083333333333333
数据流,0,0,0,0,0,5,0,5,1.2083333333333333
缓存ram,0,0,0,0,0,4,0,4,0.9666666666666667
成帧状态机,0,0,0,0,0,4,0,4,0.9666666666666667
前级stbc模块,0,0,0,0,0,3,0,3,0.725
读数,0,0,0,0,0,3,0,3,0.725
状态机,0,0,0,0,0,3,0,3,0.725
stbc模块,0,0,0,0,0,3,0,3,0.725
位宽,0,0,0,0,0,3,0,3,0.725
data,0,0,0,0,0,3,0,3,0.725
data2,0,0,0,0,0,2,0,2,0.48333333333333334
数据帧,0,0,0,0,0,2,0,2,0.48333333333333334
同步定位偏差,0,0,0,0,0,2,0,2,0.48333333333333334
导频状态,0,0,0,0,0,2,0,2,0.48333333333333334
子状态机,0,0,0,0,0,2,0,2,0.48333333333333334
前级模块,0,0,0,0,0,2,0,2,0.48333333333333334
编码调制,0,0,0,0,0,3,0,3,0.725
状态转换,0,0,0,0,0,2,0,2,0.48333333333333334
cp,0,0,0,0,0,2,0,2,0.48333333333333334
head,0,0,0,0,0,2,0,2,0.48333333333333334
idle,0,0,0,0,0,2,0,2,0.48333333333333334
状态,0,0,0,0,0,2,0,2,0.48333333333333334
stbc单元,0,0,0,0,0,2,0,2,0.48333333333333334
标志信号,0,0,0,0,0,2,0,2,0.48333333333333334
硬件资源,0,0,0,0,0,2,1,3,0.725
接口单元,0,0,0,0,0,2,0,2,0.48333333333333334
pilot2,0,0,0,0,0,1,0,1,0.24166666666666667
framedata,0,0,0,0,0,1,0,1,0.24166666666666667
循环读,0,0,0,0,0,1,0,1,0.24166666666666667
puls,0,0,0,0,0,1,0,1,0.24166666666666667
be,0,0,0,0,0,1,0,1,0.24166666666666667
初始,0,0,0,0,0,1,0,1,0.24166666666666667
工程发射端,0,0,0,0,0,1,0,1,0.24166666666666667
初始状态,0,0,0,0,0,1,0,1,0.24166666666666667
工作机制,0,0,0,0,0,1,0,1,0.24166666666666667
状态转化流程,0,0,0,0,0,1,0,1,0.24166666666666667
状态转化,0,0,0,0,0,1,0,1,0.24166666666666667
数据乒乓操作,0,0,0,0,0,1,0,1,0.24166666666666667
daia,0,0,0,0,0,1,0,1,0.24166666666666667
调制处理,0,0,0,0,0,1,0,1,0.24166666666666667
匹配,0,0,0,0,0,1,0,1,0.24166666666666667
分布式ramostbc模块,0,0,0,0,0,1,0,1,0.24166666666666667
ram,0,0,0,0,0,1,0,1,0.24166666666666667
乒乓操作,0,0,0,0,0,1,0,1,0.24166666666666667
顺序循环读数,0,0,0,0,0,1,0,1,0.24166666666666667
指示标志信号,0,0,0,0,0,1,0,1,0.24166666666666667
ram10,0,0,0,0,0,1,0,1,0.24166666666666667
ramo,0,0,0,0,0,1,0,1,0.24166666666666667
turbo,0,0,0,0,0,1,0,1,0.24166666666666667
缓冲ram,0,0,0,0,0,1,0,1,0.24166666666666667
乒乓操,0,0,0,0,0,1,0,1,0.24166666666666667
尾比特28bit,0,0,0,0,0,1,0,1,0.24166666666666667
信号交织,0,0,0,0,0,1,0,1,0.24166666666666667
qpp交织器,0,0,0,0,0,1,0,1,0.24166666666666667
比特数据,0,0,0,0,0,1,0,1,0.24166666666666667
采数标志信号,0,0,0,0,0,1,0,1,0.24166666666666667
低速率比特流,0,0,0,0,0,1,0,1,0.24166666666666667
控制速率切换,0,0,0,0,0,1,0,1,0.24166666666666667
模块化,0,0,0,0,0,1,1,2,0.48333333333333334
并行处理技术,0,0,0,0,0,1,0,1,0.24166666666666667
流水,0,0,0,0,0,1,0,1,0.24166666666666667
mimosc-fde硬件,0,0,0,0,0,1,0,1,0.24166666666666667
处理效率,0,0,0,0,0,1,1,2,0.48333333333333334
资源,0,0,0,0,0,1,0,1,0.24166666666666667
t1rrcdata,0,0,0,0,0,1,0,1,0.24166666666666667
tlframedatal,0,0,0,0,0,1,0,1,0.24166666666666667
cdatal,0,0,0,0,0,1,0,1,0.24166666666666667
framedataq,0,0,0,0,0,1,0,1,0.24166666666666667
dataq,0,0,0,0,0,1,0,1,0.24166666666666667
or,0,0,0,0,0,1,0,1,0.24166666666666667
framedatal,0,0,0,0,0,1,0,1,0.24166666666666667
torrcdatal,0,0,0,0,0,1,0,1,0.24166666666666667
amedatavalid,0,0,0,0,0,1,0,1,0.24166666666666667
datavalid,0,0,0,0,0,1,0,1,0.24166666666666667
interfacepulse,0,0,0,0,0,1,0,1,0.24166666666666667
owpjqls,0,0,0,0,0,1,0,1,0.24166666666666667
stbc编码,0,0,0,0,0,1,0,1,0.24166666666666667
qpskdata,0,0,0,0,0,1,0,1,0.24166666666666667
qpskdatavalid,0,0,0,0,0,1,0,1,0.24166666666666667
turbo编石马器,0,0,0,0,0,1,0,1,0.24166666666666667
信号处理,0,0,0,0,0,1,0,1,0.24166666666666667
fpga,0,0,0,0,0,1,0,1,0.24166666666666667
乘法器,0,0,0,0,0,6,0,6,1.45
ipcore,0,0,0,0,0,5,0,5,1.2083333333333333
硬核乘法器,0,0,0,0,0,4,0,4,0.9666666666666667
数字预失真模块,0,0,0,0,0,3,0,3,0.725
平方根,0,0,0,0,0,3,0,3,0.725
cordic算法,0,0,0,0,0,3,0,3,0.725
网口采数,0,0,0,0,0,3,0,3,0.725
cordic,0,0,0,0,0,2,0,2,0.48333333333333334
时钟,0,0,0,0,0,2,0,2,0.48333333333333334
发射波形,0,0,0,0,0,1,0,1,0.24166666666666667
发射波形频谱图,0,0,0,0,0,1,0,1,0.24166666666666667
quency,0,0,0,0,0,1,0,1,0.24166666666666667
硬件设计,0,0,0,0,0,1,0,1,0.24166666666666667
扩展边带,0,0,0,0,0,1,0,1,0.24166666666666667
dpd非线性,0,0,0,0,0,1,0,1,0.24166666666666667
单载波频域均衡系统,0,0,0,0,0,1,0,1,0.24166666666666667
dsp48e1,0,0,0,0,0,1,0,1,0.24166666666666667
fgc,0,0,0,0,0,1,0,1,0.24166666666666667
fo,0,0,0,0,0,1,0,1,0.24166666666666667
lices,0,0,0,0,0,1,0,1,0.24166666666666667
使用率,0,0,0,0,0,1,0,1,0.24166666666666667
总量,0,0,0,0,0,1,0,1,0.24166666666666667
使用量,0,0,0,0,0,1,0,1,0.24166666666666667
资源名,0,0,0,0,0,1,0,1,0.24166666666666667
fpga资源,0,0,0,0,0,1,0,1,0.24166666666666667
逻辑资源,0,0,0,0,0,1,0,1,0.24166666666666667
运算,0,0,0,0,0,1,0,1,0.24166666666666667
文本文件,0,0,0,0,0,1,0,1,0.24166666666666667
输出数据,0,0,0,0,0,1,0,1,0.24166666666666667
modelsim仿真,0,0,0,0,0,1,0,1,0.24166666666666667
输入数据,0,0,0,0,0,1,0,1,0.24166666666666667
仿真模块,0,0,0,0,0,1,0,1,0.24166666666666667
仿真固定源信源,0,0,0,0,0,1,0,1,0.24166666666666667
顶层模块,0,0,0,0,0,1,0,1,0.24166666666666667
代码,0,0,0,0,0,1,0,1,0.24166666666666667
配置,0,0,0,0,0,1,0,1,0.24166666666666667
反三角函数,0,0,0,0,0,1,0,1,0.24166666666666667
三角函数,0,0,0,0,0,1,0,1,0.24166666666666667
坐标旋转,0,0,0,0,0,1,0,1,0.24166666666666667
复杂运算,0,0,0,0,0,1,0,1,0.24166666666666667
仿真波形,0,0,0,0,0,1,0,1,0.24166666666666667
三级流水线,0,0,0,0,0,1,0,1,0.24166666666666667
流水线,0,0,0,0,0,1,0,1,0.24166666666666667
计算时间,0,0,0,0,0,1,0,1,0.24166666666666667
ipcore配置,0,0,0,0,0,1,0,1,0.24166666666666667
路由资源,0,0,0,0,0,1,0,1,0.24166666666666667
逻辑,0,0,0,0,0,1,0,1,0.24166666666666667
xilinxxtremedsp,0,0,0,0,0,1,0,1,0.24166666666666667
功放数字预失真滤波器,0,0,0,0,0,1,0,1,0.24166666666666667
实数加法运算,0,0,0,0,0,4,0,4,0.9666666666666667
实数乘法运算,0,0,0,0,0,4,0,4,0.9666666666666667
预补偿技术,0,0,0,0,0,3,0,3,0.725
单抽头算法,0,0,0,0,0,2,0,2,0.48333333333333334
样本信号,0,0,0,0,0,2,0,2,0.48333333333333334
ber,0,0,0,0,0,2,0,2,0.48333333333333334
误码仪,0,0,0,0,0,2,0,2,0.48333333333333334
帧头数据,0,0,0,0,0,2,0,2,0.48333333333333334
同步原理,0,0,0,0,0,2,0,2,0.48333333333333334
信噪,0,0,0,0,0,2,0,2,0.48333333333333334
码块,0,0,0,0,0,1,0,1,0.24166666666666667
共聊信号,0,0,0,0,0,1,0,1,0.24166666666666667
误差率,0,0,0,0,0,1,0,1,0.24166666666666667
三抽头算法,0,0,0,0,0,1,0,1,0.24166666666666667
单抽头补偿器,0,0,0,0,0,1,0,1,0.24166666666666667
窄带特性,0,0,0,0,0,1,0,1,0.24166666666666667
多抽头算法,0,0,0,0,0,1,0,1,0.24166666666666667
不平衡盲补偿,1,0,0,0,0,1,0,2,1.2416666666666667
更新,0,0,0,0,0,1,0,1,0.24166666666666667
停止系数,0,0,0,0,0,1,0,1,0.24166666666666667
自适应模式,0,0,0,0,0,1,0,1,0.24166666666666667
迭代算法,0,0,0,0,0,1,0,1,0.24166666666666667
补偿滤波器,0,0,0,0,0,1,0,1,0.24166666666666667
自适应解决,0,0,0,0,0,1,0,1,0.24166666666666667
时隙叠加,0,0,0,0,0,1,0,1,0.24166666666666667
补偿曲线,0,0,0,0,0,1,0,1,0.24166666666666667
补偿特性,0,0,0,0,0,1,0,1,0.24166666666666667
不平衡预补偿,0,0,0,0,0,1,0,1,0.24166666666666667
wl-ls补偿算法,0,0,0,0,0,1,0,1,0.24166666666666667
二阶统计补偿,0,0,0,0,0,1,0,1,0.24166666666666667
发端,0,0,0,0,0,1,0,1,0.24166666666666667
收端,0,0,0,0,0,1,0,1,0.24166666666666667
同步技术,0,0,0,0,0,1,0,1,0.24166666666666667
时隙映射,0,0,0,0,0,1,0,1,0.24166666666666667
m序列,0,0,0,0,0,1,0,1,0.24166666666666667
同步序列,0,0,0,0,0,1,0,1,0.24166666666666667
系统性能曲线,0,0,0,0,0,1,0,1,0.24166666666666667
2odb,0,0,0,0,0,1,0,1,0.24166666666666667
实验室系统,0,0,0,0,0,1,0,1,0.24166666666666667
dq不平衡补偿算法,0,0,0,0,0,1,0,1,0.24166666666666667
硬件平台,1,0,0,0,0,1,0,2,1.2416666666666667
常规速率,0,0,0,0,0,1,0,1,0.24166666666666667
iq不平衡补偿技术,0,0,0,0,0,1,0,1,0.24166666666666667
远距离,0,0,0,0,0,1,2,3,0.725
发端系统,0,0,0,0,0,0,2,2,0.48333333333333334
并行处理,0,0,0,0,0,0,1,1,0.24166666666666667
流水化,0,0,0,0,0,0,1,1,0.24166666666666667
ffg1156芯片,0,0,0,0,0,0,1,1,0.24166666666666667
xc6vlx365t,0,0,0,0,0,0,1,1,0.24166666666666667
linx,0,0,0,0,0,0,1,1,0.24166666666666667
功放数字预失真技术,0,0,0,0,0,0,1,1,0.24166666666666667
高可靠通信,0,0,0,0,0,0,1,1,0.24166666666666667
空间分集增益,0,0,0,0,0,0,1,1,0.24166666666666667
编码增益,0,0,0,0,0,0,1,1,0.24166666666666667
数据帧结构,0,0,0,0,0,0,1,1,0.24166666666666667
发射架构,0,0,0,0,0,0,1,1,0.24166666666666667
发射机系统,0,0,0,0,0,0,1,1,0.24166666666666667
低信噪比无线信道,0,0,0,0,0,0,1,1,0.24166666666666667
i/q不平衡预补偿,1,0,0,0,0,0,1,2,1.2416666666666667
通行链路,0,0,0,0,0,0,1,1,0.24166666666666667
信号性能,0,0,0,0,0,0,1,1,0.24166666666666667
算法,0,0,0,0,0,0,1,1,0.24166666666666667
硬件条件,0,0,0,0,0,0,1,1,0.24166666666666667
线性技术,0,0,0,0,0,0,1,1,0.24166666666666667
校正技,0,0,0,0,0,0,1,1,0.24166666666666667
校正算法,0,0,0,0,0,0,1,1,0.24166666666666667
信号译码性能,0,0,0,0,0,0,1,1,0.24166666666666667
相位失真,0,0,0,0,0,0,1,1,0.24166666666666667
iq调制解调器,0,0,0,0,0,0,1,1,0.24166666666666667
估计,0,0,0,0,1,0,0,1,0.24166666666666667
数字信号处理器,0,0,0,0,1,0,0,1,0.24166666666666667
直接转换发射机,0,0,0,0,1,0,0,1,0.24166666666666667
补偿频率,0,0,0,0,1,0,0,1,0.24166666666666667
想特性,1,0,0,0,1,0,0,2,1.2416666666666667
低信噪比通信系统,0,0,0,1,0,0,0,1,0.125
累加码块,0,0,0,0,0,1,0,1,0.24166666666666667
超低信噪比,0,0,0,0,0,1,0,1,0.24166666666666667
理想特性,0,0,0,0,0,1,0,1,0.24166666666666667
MIMO SC-FDE系统,0,1,0,0,0,0,0,1,2.0
I/Q不平衡,0,1,0,0,0,0,0,1,2.0
c语言系统平台,1,0,0,0,0,0,0,1,1.0
c语言,1,0,0,0,0,0,0,1,1.0
建模,1,0,0,0,0,0,0,1,1.0
链路,1,0,0,0,0,0,0,1,1.0
信息交流,1,0,0,0,0,0,0,1,1.0
速度,1,0,0,0,0,0,0,1,1.0
