,摘要,关键词,第一章,第二章,第三章,第四章,第五章,总词频,加权得分
区域,0,0,0,20,0,1,0,21,2.7416666666666667
电子,0,0,1,31,3,0,0,35,4.725
能级,0,0,0,10,0,0,0,10,1.25
势垒,1,0,6,16,2,2,2,29,5.2
亚阈值斜率,4,0,23,10,8,11,6,62,14.166666666666668
波函数,0,0,0,8,0,0,0,8,1.0
隧穿概率,0,0,1,12,1,0,0,14,1.8666666666666667
能量,0,0,1,10,3,2,0,16,2.583333333333333
电流,0,0,14,14,3,2,0,33,4.708333333333333
tfets器件,3,0,13,13,16,12,1,58,13.258333333333333
隧穿电流,0,0,1,9,1,0,0,11,1.4916666666666667
tfets,2,0,29,14,6,2,4,57,10.275
能态,0,0,0,5,0,0,0,5,0.625
幅度,0,0,0,3,0,0,0,3,0.375
隧穿,0,0,2,9,0,2,0,13,1.8583333333333334
近似,0,0,0,3,0,0,0,3,0.375
阈值电压,0,0,0,3,4,0,0,7,1.3416666666666668
电子电流,0,0,0,2,0,1,0,3,0.4916666666666667
波矢量,0,0,0,2,0,0,0,2,0.25
概率密度,0,0,0,2,0,0,0,2,0.25
输入波,0,0,0,2,0,0,0,2,0.25
偏置,0,0,0,2,0,0,0,2,0.25
自旋,0,0,0,2,0,0,0,2,0.25
量子状态,0,0,0,2,0,0,0,2,0.25
费米能级,0,0,0,2,0,0,0,2,0.25
概率,0,0,1,2,3,0,0,6,1.1
相位,0,0,0,2,0,0,0,2,0.25
带带隧穿概率,0,0,1,5,21,4,0,31,6.791666666666667
栅极电压,0,0,13,5,6,6,0,30,5.15
ssavg,0,0,0,1,0,0,0,1,0.125
平均亚阈值斜率,0,0,3,2,2,2,0,9,1.5916666666666668
vcs,0,0,0,1,0,0,0,1,0.125
sspoint,0,0,0,1,0,0,0,1,0.125
斜率,0,0,1,1,0,0,0,2,0.25
点压阈值,0,0,0,1,0,0,0,1,0.125
平均,0,0,2,1,1,3,1,8,1.5833333333333333
mosfets器件,0,0,1,1,0,0,0,2,0.25
函数,0,0,0,1,0,0,0,1,0.125
横向电场,0,0,0,1,0,0,0,1,0.125
沟道,2,0,11,5,24,61,2,105,25.025
负指数函数,0,0,0,1,0,0,0,1,0.125
电场,1,0,0,6,8,15,1,31,7.55
kane模型,0,0,0,2,0,0,0,2,0.25
带带隧穿机制,0,0,1,1,0,0,0,2,0.25
亚阈值,0,0,0,1,0,0,0,1,0.125
漂移扩散,0,0,3,2,0,0,0,5,0.625
普通mosfets器件,0,0,0,1,0,0,0,1,0.125
dloguas,0,0,0,1,0,0,0,1,0.125
通mosfets,0,0,0,1,0,0,0,1,0.125
积分变量,0,0,0,1,0,0,0,1,0.125
波矢,0,0,0,1,0,0,0,1,0.125
相速度,0,0,0,1,0,0,0,1,0.125
热激发,0,0,0,1,0,0,0,1,0.125
变形,0,0,0,1,0,0,0,1,0.125
tgqvp,0,0,0,1,0,0,0,1,0.125
输入电流,0,0,0,1,0,0,0,1,0.125
双简,0,0,0,1,0,0,0,1,0.125
电子自旋,0,0,0,1,0,0,0,1,0.125
总隧穿电流,0,0,0,1,0,0,0,1,0.125
连续能态,0,0,0,1,0,0,0,1,0.125
维势井,0,0,0,1,0,0,0,1,0.125
e讹曲,0,0,0,1,0,0,0,1,0.125
双行波,0,0,0,1,0,0,0,1,0.125
维势,0,0,0,1,0,0,0,1,0.125
长度,0,0,2,1,2,4,0,9,1.825
-av,0,0,0,1,0,0,0,1,0.125
空能量状态,0,0,0,1,0,0,0,1,0.125
空能量,0,0,0,1,0,0,0,1,0.125
费米子,0,0,0,2,0,0,0,2,0.25
网状电流,0,0,0,1,0,0,0,1,0.125
有偏置电压,0,0,0,2,0,0,0,2,0.25
无偏置电压,0,0,0,2,0,0,0,2,0.25
能蒂,0,0,0,1,0,0,0,1,0.125
高能量状态,0,0,0,1,0,0,0,1,0.125
低能态,0,0,0,1,0,0,0,1,0.125
高能态,0,0,0,1,0,0,0,1,0.125
温度,0,0,0,1,0,0,0,1,0.125
玻尔兹曼常数,0,0,0,1,0,0,0,1,0.125
费米-狄拉克,0,0,0,1,0,0,0,1,0.125
连续能带,0,0,0,1,0,0,0,1,0.125
连续能级,0,0,0,1,0,0,0,1,0.125
块状晶体材料,0,0,0,1,0,0,0,1,0.125
电流模型,0,0,0,1,0,0,0,1,0.125
隧穿场效应晶体管器件,0,0,0,1,0,0,0,1,0.125
量子隧穿理论,0,0,0,1,0,0,0,1,0.125
能带结构,0,0,2,10,11,19,0,42,8.75
兰道尔公式,0,0,0,1,0,0,0,1,0.125
隧穿概率公式,0,0,0,2,0,0,0,2,0.25
边界条件,0,0,0,1,0,0,0,1,0.125
系数,0,0,0,1,0,0,0,1,0.125
指数,0,0,0,1,0,0,0,1,0.125
势垒区,0,0,0,1,0,0,0,1,0.125
传输波,0,0,0,1,0,0,0,1,0.125
反射波,0,0,0,1,0,0,0,1,0.125
传入波,0,0,0,1,0,0,0,1,0.125
薛定铐,0,0,0,1,0,0,0,1,0.125
线性叠加,0,0,0,1,0,0,0,1,0.125
正负指数,0,0,0,1,0,0,0,1,0.125
通解,0,0,0,1,0,0,0,1,0.125
相位函数,0,0,0,1,0,0,0,1,0.125
化解,0,0,0,1,0,0,0,1,0.125
数学,0,0,0,2,0,0,0,2,0.25
实数常量,0,0,0,1,0,0,0,1,0.125
复函数,0,0,0,1,0,0,0,1,0.125
wkb,0,0,0,1,0,0,0,1,0.125
离子能量,0,0,0,1,0,0,0,1,0.125
薛定铐等式,0,0,0,1,0,0,0,1,0.125
普通势垒,0,0,0,1,0,0,0,1,0.125
矩形势垒,0,0,0,1,0,0,0,1,0.125
be-ikx,0,0,0,1,0,0,0,1,0.125
wkb近似,0,0,0,2,0,0,0,2,0.25
kb,0,0,0,1,0,0,0,1,0.125
tfets重标,0,0,0,1,0,0,0,1,0.125
器件,4,0,29,12,27,61,5,138,31.6
刻蚀,0,0,0,0,5,5,0,10,2.4166666666666665
漏极,1,0,5,1,11,25,3,46,11.175
mosfets,1,0,20,1,4,0,4,30,5.558333333333334
化学气相沉淀,0,0,0,0,3,2,0,5,1.2083333333333333
源极,1,0,16,2,32,35,1,87,19.683333333333334
氧化层,0,0,0,1,3,0,0,4,0.85
栅极,0,0,6,0,4,6,1,17,3.408333333333333
掺杂杂质,0,0,0,0,3,1,0,4,0.9666666666666667
掺杂浓度,0,0,1,3,3,18,3,28,6.3
退火,0,0,0,0,3,1,0,4,0.9666666666666667
曝光,0,0,0,0,3,1,0,4,0.9666666666666667
加工,0,0,0,0,3,0,1,4,0.9666666666666667
p型掺杂区域,0,0,0,0,2,0,0,2,0.48333333333333334
掩膜,0,0,0,0,2,1,0,3,0.725
牺牲层,0,0,0,0,2,0,0,2,0.48333333333333334
隔离层,0,0,0,0,2,2,0,4,0.9666666666666667
栅极沉淀,0,0,0,0,2,0,0,2,0.48333333333333334
沉淀,0,0,0,0,2,1,0,3,0.725
源极硅层,0,0,0,0,7,5,0,12,2.9
半径,0,0,0,0,4,0,0,4,0.9666666666666667
离子注入,0,0,0,0,2,0,0,2,0.48333333333333334
gasgaatfet,13,0,8,0,114,78,12,225,63.3
加工流程,3,0,1,0,2,6,2,14,5.541666666666666
掺杂,0,0,1,0,4,1,0,6,1.3333333333333333
gasgaatfet器件,0,0,0,0,11,4,0,15,3.625
金属连接,0,0,0,0,1,0,0,1,0.24166666666666667
连接,0,0,0,0,1,2,0,3,0.725
离子注,0,0,0,0,1,1,0,2,0.48333333333333334
si层,0,0,0,0,1,1,0,2,0.48333333333333334
挖沟,0,0,0,0,1,1,0,2,0.48333333333333334
平整化,0,0,0,0,1,1,0,2,0.48333333333333334
teos,0,0,0,0,1,0,0,1,0.24166666666666667
正硅酸乙酯,0,0,0,0,1,1,0,2,0.48333333333333334
硅层,0,0,0,0,38,10,0,48,11.6
源极错层,0,0,0,0,5,4,0,9,2.175
ge层,0,0,0,0,1,0,0,1,0.24166666666666667
介质层,0,0,0,0,1,0,0,1,0.24166666666666667
化学机械平坦,0,0,0,0,1,0,0,1,0.24166666666666667
错层,0,0,0,0,36,8,0,44,10.633333333333333
沉淀氧化层,0,0,0,0,1,0,0,1,0.24166666666666667
栅极金属,0,0,0,0,1,0,0,1,0.24166666666666667
沉淀栅极金属,0,0,0,0,1,0,0,1,0.24166666666666667
外层,0,0,0,0,1,1,0,2,0.48333333333333334
gasgaatfet晶体管,0,0,0,0,1,1,0,2,0.48333333333333334
牺牲硅氧化层,0,0,0,0,1,1,0,2,0.48333333333333334
掩膜层,0,0,0,0,1,0,0,1,0.24166666666666667
横切面图,0,0,0,0,2,1,0,3,0.725
圆形硬掩膜层,0,0,0,0,1,1,0,2,0.48333333333333334
soi,0,0,0,0,1,1,0,2,0.48333333333333334
圆柱体外层,0,0,0,0,1,2,0,3,0.725
本征,0,0,0,0,1,0,0,1,0.24166666666666667
外延,0,0,0,0,1,0,0,1,0.24166666666666667
硅衬底,0,0,0,0,1,0,0,1,0.24166666666666667
绝缘氧化层衬底,0,0,0,0,1,0,0,1,0.24166666666666667
gasgaatfet加工工艺,0,0,1,0,1,1,0,3,0.6083333333333334
egme,0,0,0,0,1,0,0,1,0.24166666666666667
ved,0,0,0,0,1,0,0,1,0.24166666666666667
i4eformalkm,0,0,0,0,1,0,0,1,0.24166666666666667
ets,0,0,2,1,2,1,1,7,1.3416666666666668
环栅,0,0,0,0,2,0,0,2,0.48333333333333334
纳米管mosfets加工流程,0,0,0,0,1,0,0,1,0.24166666666666667
纳米管mosfets,0,0,0,0,1,0,0,1,0.24166666666666667
加工工艺流程,0,0,0,0,3,0,0,3,0.725
加工工艺,0,0,4,0,2,4,0,10,1.95
带带隧穿,2,1,8,3,35,36,2,87,23.016666666666666
双极性效应,3,0,10,2,15,4,4,38,10.058333333333334
开态电流,5,1,13,1,12,17,6,55,17.208333333333336
低功耗,0,0,1,0,1,0,0,2,0.3666666666666667
工艺,1,0,0,0,2,3,0,6,2.208333333333333
4gasgaatfet,0,0,0,0,1,0,0,1,0.24166666666666667
载流子,0,0,7,8,5,1,0,21,3.325
晶体管,3,0,29,1,21,1,1,56,12.308333333333334
沟道导带,1,0,5,5,8,9,1,29,6.6
源极价带,1,0,5,3,8,8,1,26,6.108333333333333
漏极导带,0,0,3,1,0,2,0,6,0.9833333333333334
沟道价带,0,0,3,1,2,2,0,8,1.4666666666666668
能带,0,0,3,7,4,5,1,20,3.6666666666666665
驱动能力,0,0,3,0,3,0,1,7,1.3416666666666668
高开态电流,1,0,2,0,1,2,0,6,1.975
tfets工艺,0,0,2,0,0,0,0,2,0.25
势垒能量,0,0,2,1,0,0,0,3,0.375
电压,0,0,2,0,2,0,0,4,0.7333333333333334
关态电流,4,0,4,1,14,28,8,59,16.708333333333336
性能,2,0,10,0,12,13,4,41,10.258333333333333
环栅隧穿场效应晶体管,0,0,1,0,1,0,0,2,0.3666666666666667
性能优化,0,0,2,0,0,0,0,2,0.25
p-gasgaatfet,5,0,3,0,0,58,8,74,21.325
0-gasgaatfet,0,0,1,0,0,2,0,3,0.6083333333333334
低关态电流,1,0,3,0,0,1,0,5,1.6166666666666667
内部机理,0,0,3,0,2,0,0,5,0.8583333333333334
tfet性能,0,0,1,0,0,0,0,1,0.125
错环绕源极结构,1,0,1,0,7,1,0,10,3.0583333333333336
tfet结构,0,0,3,0,1,0,0,4,0.6166666666666667
mosfets工艺,0,0,1,0,0,0,0,1,0.125
异质结,0,0,2,1,0,0,0,3,0.375
升源结构,0,0,1,0,0,0,0,1,0.125
隧穿几率,0,0,1,0,0,0,0,1,0.125
隧穿面积,0,0,2,0,0,0,0,2,0.25
尺寸,0,0,2,1,0,0,0,3,0.375
亚阈值特性,0,0,2,0,5,3,3,13,2.908333333333333
非对称掺杂,0,0,1,0,0,0,0,1,0.125
p-i-n,0,0,1,0,0,0,0,1,0.125
指数函数,0,0,1,0,0,0,0,1,0.125
变量,0,0,1,0,1,0,0,2,0.3666666666666667
距离,0,0,1,1,0,0,0,2,0.25
弯曲,0,0,1,1,0,3,0,5,0.975
特性转移曲线,0,0,1,0,0,0,0,1,0.125
反型层开口,0,0,1,0,0,0,0,1,0.125
点亚阈值,0,0,1,0,0,0,0,1,0.125
载流子扩散漂移,0,0,1,0,0,0,0,1,0.125
导带,0,0,1,11,2,4,0,18,2.95
价带,0,0,1,7,2,4,0,14,2.45
电子等载流子,0,0,1,0,0,0,0,1,0.125
带带隧穿原理,0,0,1,0,0,0,1,2,0.3666666666666667
量子力学,0,0,1,0,1,0,0,2,0.3666666666666667
电压差,0,0,1,0,0,0,0,1,0.125
源极漏极,0,0,1,0,0,0,0,1,0.125
通道,0,0,1,0,0,0,0,1,0.125
迁移,0,0,1,0,0,0,0,1,0.125
反型层,0,0,1,0,0,0,0,1,0.125
开态,0,0,1,3,4,3,0,11,2.1916666666666664
集成电路,3,0,7,0,0,0,2,12,4.358333333333333
低功耗器件,0,0,1,0,0,0,1,2,0.3666666666666667
玻尔兹曼,0,0,1,0,0,0,1,2,0.3666666666666667
常温,0,0,1,0,0,0,0,1,0.125
沟道接触面,0,0,0,1,0,11,1,13,3.025
漏极接触面,0,0,0,0,0,14,0,14,3.3833333333333333
overlap,1,0,2,0,0,13,1,17,4.633333333333333
o-gasgaatfet,5,0,2,0,0,43,6,56,17.09166666666667
带带隧穿面积,0,0,0,0,1,1,0,2,0.48333333333333334
带带隧穿电流,0,0,0,0,0,1,0,1,0.24166666666666667
overlap长度,0,0,0,0,0,27,0,27,6.525
overlap结构,2,0,2,0,0,6,0,10,3.7
电流密度,0,0,0,0,14,10,0,24,5.8
参数,0,0,0,11,6,10,0,27,5.241666666666667
sigaatfet,2,0,2,0,22,0,2,28,8.05
浓度,0,0,0,0,3,0,0,3,0.725
p型,0,0,0,0,3,6,0,9,2.175
硅层厚度,0,0,1,0,17,0,0,18,4.233333333333333
ge-sourcegaatfet,3,0,1,0,21,0,3,28,8.925
栅极氧化层,0,0,1,0,2,0,0,3,0.6083333333333334
可调,0,0,0,0,2,2,0,4,0.9666666666666667
错环绕硅,0,0,0,0,2,0,0,2,0.48333333333333334
源极区域,0,0,0,0,2,0,0,2,0.48333333333333334
普通环栅,0,0,0,0,2,0,0,2,0.48333333333333334
异质结结构,0,0,0,0,2,1,0,3,0.725
p型重掺杂,0,0,0,0,1,0,0,1,0.24166666666666667
p型轻掺杂,0,0,0,0,1,0,0,1,0.24166666666666667
n型掺杂,0,0,0,1,1,0,0,2,0.3666666666666667
二氧化氟,0,0,0,0,1,0,0,1,0.24166666666666667
ge-soucegaatfet,0,0,0,0,1,0,0,1,0.24166666666666667
漏极掺杂浓度,0,0,0,0,1,2,0,3,0.725
参杂浓度,0,0,0,0,1,1,0,2,0.48333333333333334
ns,0,0,0,0,1,1,0,2,0.48333333333333334
沟道摻杂浓度,0,0,0,0,1,0,0,1,0.24166666666666667
源极掺杂浓度,0,0,0,0,1,2,0,3,0.725
緒层厚度,0,0,0,0,1,1,0,2,0.48333333333333334
氧化层厚度,0,0,0,0,1,2,0,3,0.725
沟道长度,0,0,0,0,1,2,0,3,0.725
源极漏极长度,0,0,0,0,1,2,0,3,0.725
lsd,0,0,0,0,1,2,0,3,0.725
器件半径,0,0,0,0,1,2,0,3,0.725
1gasgaatfet,0,0,0,0,1,0,0,1,0.24166666666666667
内在机理,0,0,1,0,1,1,0,3,0.6083333333333334
源极结构,0,0,0,0,2,0,0,2,0.48333333333333334
铐层厚度,0,0,0,0,4,0,0,4,0.9666666666666667
厚度,0,0,0,0,3,4,0,7,1.6916666666666667
横切图,0,0,1,0,1,0,0,2,0.3666666666666667
异质,0,0,0,0,1,0,0,1,0.24166666666666667
带隙宽度,0,0,0,0,3,0,0,3,0.725
铐层,0,0,0,0,1,1,0,2,0.48333333333333334
硅材料,0,0,0,1,6,0,0,7,1.575
源极区,0,0,0,0,1,0,0,1,0.24166666666666667
普通环栅tfet,0,0,0,0,1,0,0,1,0.24166666666666667
材料结构,0,0,0,0,1,0,0,1,0.24166666666666667
tf,0,0,0,0,1,0,0,1,0.24166666666666667
普通,0,0,0,0,1,0,0,1,0.24166666666666667
栅极功函数,2,0,1,0,26,3,4,36,10.1
错层中心,0,0,0,0,6,0,0,6,1.45
曲线图,0,0,0,0,2,0,0,2,0.48333333333333334
带带隧穿概率峰值,0,0,0,0,4,2,0,6,1.45
关态,0,0,0,2,6,7,0,15,3.3916666666666666
硅层中心,0,0,0,0,4,0,0,4,0.9666666666666667
漏极电压,0,0,0,0,3,0,0,3,0.725
曲线,0,0,0,0,5,0,0,5,1.2083333333333333
量子隧穿效应,0,0,0,3,0,0,0,3,0.375
原子核,0,0,0,2,0,0,0,2,0.25
隧穿效应,0,0,0,2,0,0,0,2,0.25
隧穿二极管,0,0,0,1,0,0,0,1,0.125
扫描隧穿显微镜,0,0,0,1,0,0,0,1,0.125
a衰变,0,0,0,1,0,0,0,1,0.125
核聚变,0,0,0,1,0,0,0,1,0.125
原子核热动能,0,0,0,1,0,0,0,1,0.125
太阳核聚变,0,0,0,1,0,0,0,1,0.125
物理器件,0,0,0,1,0,0,0,1,0.125
小球,0,0,0,1,0,0,0,1,0.125
外力,0,0,0,1,0,0,0,1,0.125
经典力学,0,0,0,1,0,0,0,1,0.125
量子行为,0,0,0,1,0,0,0,1,0.125
总能量势垒,0,0,0,1,0,0,0,1,0.125
微观粒子,0,0,0,1,0,0,0,1,0.125
tfets理论,0,0,0,1,0,0,0,1,0.125
pn节,0,0,0,0,2,0,0,2,0.48333333333333334
线隧穿,0,0,1,0,2,0,0,3,0.6083333333333334
综合性能,0,0,0,0,1,0,1,2,0.48333333333333334
点亚阈值斜率,0,0,3,1,4,1,1,10,1.95
错环绕源极环栅结构,0,0,0,0,1,0,0,1,0.24166666666666667
gasgaatfet结构,0,0,0,0,1,1,0,2,0.48333333333333334
线隧,0,0,1,0,1,0,0,2,0.3666666666666667
源极错环绕硅层结构,0,0,0,0,1,0,0,1,0.24166666666666667
电子反型,0,0,0,0,1,0,0,1,0.24166666666666667
错环绕源极,0,0,0,0,3,1,1,5,1.2083333333333333
p型区域,0,0,0,0,1,0,0,1,0.24166666666666667
虚拟,0,0,0,0,1,0,0,1,0.24166666666666667
电子反转,0,0,0,0,1,0,0,1,0.24166666666666667
沟道区,0,0,0,0,1,0,0,1,0.24166666666666667
栅极电场,0,0,0,1,1,0,0,2,0.3666666666666667
窄带隙材料,0,0,1,0,2,0,0,3,0.6083333333333334
错材料,0,0,0,1,5,0,0,6,1.3333333333333333
栅源电压,0,0,0,0,1,0,0,1,0.24166666666666667
sourcegaatfet,0,0,0,0,1,0,0,1,0.24166666666666667
tfet,0,0,11,0,3,1,0,15,2.341666666666667
sourcegaa,0,0,0,0,1,0,0,1,0.24166666666666667
电子密度,0,0,0,0,1,0,0,1,0.24166666666666667
栅极金属功函数,0,0,0,0,4,0,0,4,0.9666666666666667
功函数,0,0,0,0,5,0,0,5,1.2083333333333333
源极电流密度,0,0,0,0,1,0,0,1,0.24166666666666667
漏极区,0,0,0,0,1,0,0,1,0.24166666666666667
空穴,0,0,0,0,1,0,0,1,0.24166666666666667
中间,0,0,0,0,1,0,0,1,0.24166666666666667
层中心,0,0,0,0,1,0,0,1,0.24166666666666667
p-gasgaatfet器件,0,0,0,0,0,5,0,5,1.2083333333333333
离子,0,0,0,0,0,3,0,3,0.725
碑离子,0,0,0,0,0,2,0,2,0.48333333333333334
pocket结构,1,0,0,0,0,27,0,28,7.525
pocket,0,0,1,0,0,17,4,22,5.2
n型,0,0,0,0,0,1,0,1,0.24166666666666667
p型掺杂,0,0,0,1,0,2,0,3,0.6083333333333334
电介质,0,0,0,0,0,1,0,1,0.24166666666666667
16,0,0,0,0,0,1,0,1,0.24166666666666667
pocket掺杂浓度,1,0,0,0,0,19,1,21,5.833333333333333
电场强度,0,0,0,0,3,16,0,19,4.591666666666667
粒子,0,0,0,1,0,6,0,7,1.575
空能态,0,0,0,0,0,3,0,3,0.725
窄带隙,0,0,0,0,2,2,0,4,0.9666666666666667
源极硅,0,0,0,0,0,2,0,2,0.48333333333333334
横切带带隧穿概率,0,0,0,0,0,2,0,2,0.48333333333333334
速度,0,0,0,0,0,2,0,2,0.48333333333333334
电场分布,0,0,0,0,0,3,0,3,0.725
中心,0,0,0,0,1,2,0,3,0.725
转移特性曲线,0,0,1,0,6,4,0,11,2.5416666666666665
cket,0,0,0,0,0,2,0,2,0.48333333333333334
对错层,0,0,0,0,1,1,0,2,0.48333333333333334
带带,0,0,0,0,0,1,0,1,0.24166666666666667
强度,0,0,0,0,0,1,0,1,0.24166666666666667
宽带隙,0,0,0,0,0,1,0,1,0.24166666666666667
能级结构,0,0,0,0,0,1,0,1,0.24166666666666667
带带隧穿区域,0,0,0,0,0,1,0,1,0.24166666666666667
开态条件,0,0,0,0,0,1,0,1,0.24166666666666667
带带隧穿图,0,0,0,0,0,1,0,1,0.24166666666666667
tfet器件,1,0,0,0,2,2,1,6,2.208333333333333
p-gasgaa,0,0,0,0,0,1,0,1,0.24166666666666667
度分布,0,0,0,0,0,1,0,1,0.24166666666666667
wkb概率,0,0,0,0,0,1,0,1,0.24166666666666667
中心处,0,0,0,0,0,1,0,1,0.24166666666666667
pcoket结构,0,0,0,0,0,1,0,1,0.24166666666666667
log曲线,0,0,0,0,0,1,0,1,0.24166666666666667
线型曲线,0,0,0,0,0,1,0,1,0.24166666666666667
特性,0,0,0,1,1,1,0,3,0.6083333333333334
电子束光刻刻蚀,0,0,0,0,0,2,0,2,0.48333333333333334
过程,0,0,0,0,0,1,0,1,0.24166666666666667
overlap工程,0,0,0,0,0,4,0,4,0.9666666666666667
o-gasgaatfet刻蚀,0,0,0,0,0,1,0,1,0.24166666666666667
圆柱型硅柱,0,0,0,0,0,1,0,1,0.24166666666666667
电子束光刻技术,0,0,0,0,0,1,0,1,0.24166666666666667
o-gasgaatfet器件,0,0,0,0,0,4,0,4,0.9666666666666667
实验仿真,0,0,0,1,0,0,0,1,0.125
tefts器件,0,0,0,1,1,0,0,2,0.3666666666666667
错层厚度,0,0,1,0,58,2,1,62,14.866666666666667
转移特性,0,1,0,0,11,3,0,15,5.383333333333333
器件加工流程,0,0,0,0,1,0,0,1,0.24166666666666667
纳米mosfets,0,0,0,0,1,0,0,1,0.24166666666666667
物理特性,0,0,0,6,4,3,0,13,2.4416666666666664
电学特性,0,0,1,2,4,4,0,11,2.3083333333333336
电子浓度,0,0,0,0,1,0,0,1,0.24166666666666667
gasgaa,0,0,0,0,1,1,0,2,0.48333333333333334
仿真参数,0,0,2,0,1,0,0,3,0.4916666666666667
通sigaatfet,0,0,0,0,1,0,0,1,0.24166666666666667
器件结构,0,0,1,8,0,1,2,12,1.85
电路设计,0,0,1,0,0,0,0,1,0.125
二维tfet,0,0,1,0,0,0,0,1,0.125
带隧穿,0,0,0,0,1,0,0,1,0.24166666666666667
猪层厚度,0,0,0,0,1,0,0,1,0.24166666666666667
关闭状态,0,0,0,0,1,0,0,1,0.24166666666666667
3gasgaatfet,0,0,0,0,1,0,0,1,0.24166666666666667
低电场,0,0,0,0,0,3,0,3,0.725
overlap长,0,0,0,0,0,2,1,3,0.725
漏极接触,1,0,0,0,0,1,0,2,1.2416666666666667
空穴电流密度,0,0,0,0,0,1,0,1,0.24166666666666667
空穴电流,0,0,0,0,0,1,0,1,0.24166666666666667
et,2,0,3,0,0,1,1,7,2.8583333333333334
o-gasgaa,0,0,0,0,0,1,0,1,0.24166666666666667
接触面,0,0,0,0,2,2,0,4,0.9666666666666667
vds,0,0,0,0,0,1,0,1,0.24166666666666667
最低,0,0,0,0,0,1,0,1,0.24166666666666667
ds,0,0,0,0,0,1,0,1,0.24166666666666667
阈值电流,0,0,0,0,2,0,0,2,0.48333333333333334
漏极电流,0,0,3,1,2,0,0,6,0.9833333333333334
开启电压,0,0,0,0,2,0,0,2,0.48333333333333334
方差,0,0,0,0,1,0,0,1,0.24166666666666667
gasgaatfet曲线,0,0,0,0,1,0,0,1,0.24166666666666667
稳定性,0,0,0,0,1,0,0,1,0.24166666666666667
亚阈值斜率曲线,0,0,0,0,1,0,0,1,0.24166666666666667
gaatfet,0,0,0,0,1,0,0,1,0.24166666666666667
综合转移特性,0,0,0,0,1,0,0,1,0.24166666666666667
ionse,0,0,0,0,1,0,0,1,0.24166666666666667
转移特性曲线图,0,0,0,0,1,0,0,1,0.24166666666666667
vonset,0,0,0,0,1,0,0,1,0.24166666666666667
亚阈值斜率图,0,0,0,0,1,0,0,1,0.24166666666666667
硅层半径,0,0,0,0,3,0,0,3,0.725
横切线,0,0,0,0,3,0,0,3,0.725
切线,0,0,0,0,3,0,0,3,0.725
接触,0,0,0,0,2,0,0,2,0.48333333333333334
面积,0,0,2,0,2,0,0,4,0.7333333333333334
错硅层,0,0,0,0,2,0,0,2,0.48333333333333334
源极电场分布,0,0,0,0,2,0,0,2,0.48333333333333334
源极导带,0,0,0,0,2,0,0,2,0.48333333333333334
切线处,0,0,0,0,2,0,0,2,0.48333333333333334
源极竖切线,0,0,0,0,2,0,0,2,0.48333333333333334
gasgaatfeto,0,0,1,0,2,0,0,3,0.6083333333333334
强电场面积,0,0,0,0,1,0,0,1,0.24166666666666667
硅层接触面,0,0,0,0,1,0,0,1,0.24166666666666667
电场面积,0,0,0,0,1,0,0,1,0.24166666666666667
错硅,0,0,0,0,1,0,0,1,0.24166666666666667
强电场强,0,0,0,0,1,0,0,1,0.24166666666666667
电场分布图,0,0,0,0,1,0,0,1,0.24166666666666667
九加时,0,0,0,0,1,0,0,1,0.24166666666666667
强电场分布,0,0,0,0,1,0,0,1,0.24166666666666667
源极沟道,0,0,0,0,1,0,0,1,0.24166666666666667
交界面,0,0,0,0,1,0,0,1,0.24166666666666667
总量,0,0,0,0,1,0,0,1,0.24166666666666667
环栅tfets,0,0,0,0,1,0,0,1,0.24166666666666667
环绕源极结构,0,0,0,0,1,0,0,1,0.24166666666666667
8mn晶体管,0,0,0,0,1,0,0,1,0.24166666666666667
错层中间位置,0,0,0,0,1,0,0,1,0.24166666666666667
硅层中间位,0,0,0,0,1,0,0,1,0.24166666666666667
带隙宽,0,0,0,0,1,0,0,1,0.24166666666666667
带隙,0,0,0,1,1,0,0,2,0.3666666666666667
源极竖切面,0,0,0,0,1,0,0,1,0.24166666666666667
源极错中心,0,0,0,0,1,0,0,1,0.24166666666666667
源极硅中心,0,0,0,0,1,0,0,1,0.24166666666666667
能带图,0,0,0,0,1,0,0,1,0.24166666666666667
触面,0,0,0,0,1,0,0,1,0.24166666666666667
沟道接触,0,0,0,0,1,0,0,1,0.24166666666666667
源极曙层,0,0,0,0,1,0,0,1,0.24166666666666667
10nm器件,0,0,0,0,1,0,0,1,0.24166666666666667
8nm,0,0,0,0,1,0,0,1,0.24166666666666667
错层半径,0,0,0,0,1,0,0,1,0.24166666666666667
漏电流,0,0,1,0,1,0,0,2,0.3666666666666667
饱和,0,0,0,0,1,0,0,1,0.24166666666666667
漏极源极电压,0,0,0,0,1,0,0,1,0.24166666666666667
b-b'切线,0,0,0,0,1,0,0,1,0.24166666666666667
切线a-,0,0,0,0,1,0,0,1,0.24166666666666667
电场分布强度,0,0,0,0,1,0,0,1,0.24166666666666667
-c,0,0,0,0,1,0,0,1,0.24166666666666667
横切,0,0,0,0,1,0,0,1,0.24166666666666667
内在物理特性,0,0,0,0,1,0,0,1,0.24166666666666667
结构模型,0,0,1,0,0,0,0,1,0.125
实验仿真基,0,0,1,0,0,0,0,1,0.125
经典分析模型,0,0,1,0,0,0,0,1,0.125
tfets性能指标,0,0,1,0,0,0,0,1,0.125
tfets基础理论,0,0,1,0,0,0,0,1,0.125
瓶颈,0,0,1,0,0,0,0,1,0.125
半导体器件,0,0,2,3,0,0,0,5,0.625
反向开态,0,0,0,3,0,0,0,3,0.375
源极沟道漏极,0,0,0,1,0,0,0,1,0.125
抑制,0,0,0,1,0,0,0,1,0.125
双极性,0,0,0,1,0,0,0,1,0.125
漏极价带,0,0,0,1,0,0,0,1,0.125
漏极价带距离,0,0,0,1,0,0,0,1,0.125
反向开态现象,0,0,0,1,0,0,0,1,0.125
对称掺杂,0,0,0,1,0,0,0,1,0.125
n-p,0,0,0,1,0,0,0,1,0.125
p-n,0,0,0,1,0,0,0,1,0.125
p-i-n型,0,0,0,1,0,0,0,1,0.125
反向,0,0,0,1,0,0,0,1,0.125
关态时器件,0,0,0,1,0,0,0,1,0.125
平面tfet结构,0,0,0,1,0,0,0,1,0.125
导带能量,0,0,0,1,0,0,0,1,0.125
源极价带能量,0,0,0,1,0,0,0,1,0.125
能带隙,0,0,0,1,0,0,0,1,0.125
有效质量,0,0,0,1,0,0,0,1,0.125
屏蔽隧穿长度,0,0,0,1,0,0,0,1,0.125
3qfi,0,0,0,1,0,0,0,1,0.125
ion,0,0,1,1,0,0,0,2,0.25
wkb近似表达式,0,0,0,1,0,0,0,1,0.125
栅极电压控制器件,0,0,0,1,0,0,0,1,0.125
本征掺杂,0,0,0,1,0,0,0,1,0.125
平面tfet,0,0,0,1,0,0,0,1,0.125
关闭,0,0,0,0,0,1,0,1,0.24166666666666667
n型掺杂结构,0,0,0,0,0,1,0,1,0.24166666666666667
口袋,0,0,0,0,0,1,0,1,0.24166666666666667
覆盖,0,0,0,0,0,1,0,1,0.24166666666666667
sentaurusdevice,0,0,0,7,0,0,0,7,0.875
仿真,0,0,2,6,0,1,1,10,1.4833333333333334
sentaurustcad,1,0,0,6,0,0,1,8,1.9916666666666667
声子辅助隧穿,0,0,0,4,0,0,0,4,0.5
动态非局部隧穿模型,0,0,0,4,0,0,0,4,0.5
直接隧穿,0,0,0,3,0,0,0,3,0.375
动态非局域模型,0,0,0,3,0,0,0,3,0.375
器件仿真,0,0,0,4,0,0,0,4,0.5
小尺寸器件,0,0,0,3,0,0,0,3,0.375
费米-狄拉克统计分布模型,0,0,0,2,0,0,0,2,0.25
运动,0,0,0,2,0,0,0,2,0.25
半导体,0,0,0,7,0,0,0,7,0.875
漂移扩散模型,0,0,0,2,0,0,0,2,0.25
动态非局域隧穿模型,0,0,0,2,0,0,0,2,0.25
隧穿路径,0,0,0,2,0,0,0,2,0.25
简易模型,0,0,0,2,0,0,0,2,0.25
载流子密度,0,0,0,2,0,0,0,2,0.25
泊松方程,0,0,0,3,0,0,0,3,0.375
求解器,0,0,0,2,0,0,0,2,0.25
网格加密,0,0,0,2,0,0,0,2,0.25
数值,0,0,0,3,0,0,0,3,0.375
网格,0,0,0,2,0,0,0,2,0.25
物理模型,0,0,0,2,0,0,0,2,0.25
二级效应,1,0,1,2,0,0,1,5,1.6166666666666667
原子半径,0,0,0,2,0,0,0,2,0.25
原子,0,0,0,3,0,0,0,3,0.375
玻尔兹曼统计模型,0,0,0,1,0,0,0,1,0.125
量子统计,0,0,0,1,0,0,0,1,0.125
费米分布,0,0,0,1,0,0,0,1,0.125
费米子系统,0,0,0,1,0,0,0,1,0.125
费米-狄拉克分布,0,0,0,1,0,0,0,1,0.125
tfets器件仿真,0,0,0,1,0,0,0,1,0.125
漏区,0,0,0,1,0,0,0,1,0.125
源区,0,0,0,1,0,0,0,1,0.125
半经典性模型,0,0,0,1,0,0,0,1,0.125
载流子浓度分布,0,0,0,1,0,0,0,1,0.125
电势分布,0,0,0,1,0,0,0,1,0.125
漂移扩散方程,0,0,0,1,0,0,0,1,0.125
漂移电流,0,0,0,1,0,0,0,1,0.125
扩散电流,0,0,0,1,0,0,0,1,0.125
扩散方程,0,0,0,1,0,0,0,1,0.125
漂移,0,0,0,1,0,0,0,1,0.125
difiiisionmodel,0,0,0,1,0,0,0,1,0.125
parameter,0,0,0,1,0,0,0,1,0.125
parametersetname,0,0,0,1,0,0,0,1,0.125
localpath,0,0,0,1,0,0,0,1,0.125
non,0,0,0,1,0,0,0,1,0.125
band2band,0,0,0,1,0,0,0,1,0.125
physics,0,0,0,1,0,0,0,1,0.125
commands,0,0,0,1,0,0,0,1,0.125
动态非局部带带隧穿模型,0,0,0,2,0,0,0,2,0.25
错硅异质结结构,0,0,0,1,0,0,0,1,0.125
rpath,0,0,0,1,0,0,0,1,0.125
dpath,0,0,0,1,0,0,0,1,0.125
vcrrt,0,0,0,1,0,0,0,1,0.125
bpath,0,0,0,1,0,0,0,1,0.125
默认值,0,0,0,1,0,0,0,1,0.125
pathindex,0,0,0,1,0,0,0,1,0.125
非局部带带隧穿模型,0,0,0,1,0,0,0,1,0.125
认值,0,0,0,1,0,0,0,1,0.125
动态非局域带带隧穿模型,0,0,0,1,0,0,0,1,0.125
光学声子数,0,0,0,1,0,0,0,1,0.125
电势,0,0,0,3,0,0,0,3,0.375
n°p,0,0,0,1,0,0,0,1,0.125
导带偏移量,0,0,0,1,0,0,0,1,0.125
简并因子,0,0,0,1,0,0,0,1,0.125
尬许坊,0,0,0,1,0,0,0,1,0.125
mc,0,0,0,1,0,0,0,1,0.125
声子辅助隧穿过程,0,0,0,1,0,0,0,1,0.125
直接隧穿过程,0,0,0,1,0,0,0,1,0.125
禁带变窄效应,0,0,0,1,0,0,0,1,0.125
声子辅助隧穿过,0,0,0,1,0,0,0,1,0.125
直接隧穿过,0,0,0,1,0,0,0,1,0.125
恒定电场,0,0,0,1,0,0,0,1,0.125
接隧穿,0,0,0,1,0,0,0,1,0.125
间接带隙半导体,0,0,0,1,0,0,0,1,0.125
直接带隙半导体,0,0,0,2,0,0,0,2,0.25
gaas,0,0,0,1,0,0,0,1,0.125
载流子隧穿,0,0,0,1,0,0,0,1,0.125
非局域,0,0,0,1,0,0,0,1,0.125
能带形,0,0,0,1,0,0,0,1,0.125
非局域网格,0,0,0,1,0,0,0,1,0.125
hurkx,0,0,0,1,0,0,0,1,0.125
schenk,0,0,0,1,0,0,0,1,0.125
带带隧穿模型,0,0,0,1,0,0,0,1,0.125
hurkx模型,0,0,0,2,0,0,0,2,0.25
schenk模型,0,0,0,1,0,0,0,1,0.125
dynamicnonlocalbtbtmodel,0,0,0,1,0,0,0,1,0.125
tfets仿真,0,0,0,1,0,0,0,1,0.125
仿真模型结构,0,0,0,1,0,0,0,1,0.125
模型参数,0,0,0,1,0,0,0,1,0.125
仿真模型,0,0,0,1,0,0,0,1,0.125
空穴迁移率,0,0,0,1,0,0,0,1,0.125
空穴连续性方程,0,0,0,1,0,0,0,1,0.125
迭代线性求解器,0,0,0,1,0,0,0,1,0.125
3d仿真,0,0,0,1,0,0,0,1,0.125
直接线性求解器,0,0,0,1,0,0,0,1,0.125
2d仿真,0,0,0,1,0,0,0,1,0.125
仿真器件,0,0,0,1,0,0,0,1,0.125
srh复合模型,0,0,0,1,0,0,0,1,0.125
enonnal,0,0,0,1,0,0,0,1,0.125
界面散射,0,0,0,1,0,0,0,1,0.125
highfieldsaturation,0,0,0,1,0,0,0,1,0.125
速度饱和模型,0,0,0,1,0,0,0,1,0.125
pendence,0,0,0,1,0,0,0,1,0.125
ping,0,0,0,1,0,0,0,1,0.125
迁移率模型,0,0,0,1,0,0,0,1,0.125
模型,0,0,0,1,0,0,0,1,0.125
物理仿真模型,0,0,0,1,0,0,0,1,0.125
电极定义,0,0,0,1,0,0,0,1,0.125
file命令,0,0,0,1,0,0,0,1,0.125
器件信息,0,0,0,1,0,0,0,1,0.125
密疏调整,0,0,0,1,0,0,0,1,0.125
器件网格,0,0,0,1,0,0,0,1,0.125
栅极接触面,0,0,0,1,0,0,0,1,0.125
aurustcad,0,0,0,1,0,0,0,1,0.125
sentaurusvisual,0,0,0,1,0,0,0,1,0.125
sentaurusmesh,0,0,0,1,0,0,0,1,0.125
editor,0,0,0,1,0,0,0,1,0.125
sentaurusstructure,0,0,0,1,0,0,0,1,0.125
sentaurusstructureeditor,0,0,0,1,0,0,0,1,0.125
模拟工艺,0,0,0,1,0,0,0,1,0.125
sentaurusprocess,0,0,0,1,0,0,0,1,0.125
仿真工具,0,0,0,2,0,0,0,2,0.25
仿真实验,0,0,1,1,0,0,0,2,0.25
虚拟分,0,0,0,1,0,0,0,1,0.125
模集成电路,0,0,0,1,0,0,0,1,0.125
纳米级工艺,0,0,0,1,0,0,0,1,0.125
器件仿真软件,0,0,0,1,0,0,0,1,0.125
synopsys,0,0,0,1,0,0,0,1,0.125
仿真技术,0,0,0,1,0,0,0,1,0.125
分析工具,0,0,0,1,0,0,0,1,0.125
模拟,0,0,0,1,0,0,0,1,0.125
等量子力学,0,0,0,1,0,0,0,1,0.125
分析模型,0,0,0,2,0,0,0,2,0.25
相干距离,0,0,0,1,0,0,0,1,0.125
特征尺寸,0,0,0,1,0,0,1,2,0.3666666666666667
器件特征,0,0,0,1,0,0,0,1,0.125
集成电路工艺,0,0,0,1,0,0,0,1,0.125
gaa,0,0,0,1,0,0,0,1,0.125
环绕式栅极,0,0,0,1,0,0,0,1,0.125
3nm工艺,0,0,0,1,0,0,0,1,0.125
台积电,0,0,0,1,0,0,0,1,0.125
制程,0,0,0,1,0,0,0,1,0.125
芯片,0,0,3,1,0,0,1,5,0.7416666666666667
工艺制程,0,0,0,1,0,0,0,1,0.125
5nm,0,0,0,1,0,0,0,1,0.125
7nm,0,0,0,1,0,0,0,1,0.125
原子核间距,0,0,0,1,0,0,0,1,0.125
基本粒子,0,0,0,1,0,0,0,1,0.125
tfets实验基,0,0,0,1,0,0,0,1,0.125
mgnt-tfet,0,0,5,0,0,0,0,5,0.625
hm-hltfet,0,0,3,0,0,0,0,3,0.375
ttfet,0,0,3,0,0,0,0,3,0.375
纳米tfet,0,0,2,0,0,0,0,2,0.25
双源极,0,0,2,0,0,0,0,2,0.25
ltfet,0,0,2,0,0,0,0,2,0.25
开关速度,0,0,2,0,0,0,0,2,0.25
驱动,0,0,1,0,0,0,0,1,0.125
低栅极电压,0,0,1,0,0,0,0,1,0.125
功耗,1,0,7,0,0,0,1,9,2.1166666666666667
抑制漏电流,0,0,1,0,0,0,0,1,0.125
电流开关,0,0,3,0,0,0,0,3,0.375
传输特性,0,0,1,0,0,0,0,1,0.125
辅助栅结构,0,0,1,0,0,0,0,1,0.125
gaas材料,0,0,1,0,0,0,0,1,0.125
高功函数,0,0,1,0,0,0,0,1,0.125
inas材料,0,0,1,0,0,0,0,1,0.125
低功函数,0,0,1,0,0,0,0,1,0.125
异质无结tfets,0,0,1,0,0,0,0,1,0.125
动态性能,0,0,1,0,0,0,0,1,0.125
静态性能,0,0,1,0,0,0,0,1,0.125
带带隧穿几率,0,0,3,0,0,0,0,3,0.375
线性隧穿区域,0,0,1,0,0,0,0,1,0.125
外栅,0,0,1,0,0,0,0,1,0.125
内栅,0,0,1,0,0,0,0,1,0.125
外部栅极,0,0,1,0,0,0,0,1,0.125
shellgatearchitecture,0,0,1,0,0,0,1,2,0.3666666666666667
donmisalignedcore,0,0,1,0,0,0,0,1,0.125
tfetbase,0,0,1,0,0,0,0,1,0.125
不对准线性纳米tfet,0,0,1,0,0,0,0,1,0.125
内栅外栅,0,0,1,0,0,0,0,1,0.125
双源极隧穿场效应晶体管,0,0,1,0,0,0,0,1,0.125
开关电流比,1,0,2,0,0,0,0,3,1.25
氧化隔离层,0,0,1,0,0,0,0,1,0.125
有效隧穿区域,0,0,1,0,0,0,0,1,0.125
ttfet结构,0,0,1,0,0,0,0,1,0.125
截止频率,0,0,1,0,0,0,0,1,0.125
跨导,0,0,1,0,0,0,0,1,0.125
t型结构,0,0,1,0,0,0,0,1,0.125
l形结构,0,0,1,0,0,0,0,1,0.125
t形结构,0,0,1,0,0,0,0,1,0.125
lttfet,0,0,1,0,0,0,0,1,0.125
ast形隧穿场效应晶体管,0,0,1,0,0,0,0,1,0.125
异质ttfet,0,0,1,0,0,0,0,1,0.125
非局部隧穿模型,0,0,0,8,0,0,0,8,1.0
计算机,0,0,4,1,0,0,0,5,0.625
局部隧穿模型,0,0,0,7,0,0,0,7,0.875
tfets性能,0,0,0,0,1,0,0,1,0.24166666666666667
错层硅层厚度,0,0,0,0,1,0,0,1,0.24166666666666667
2gasgaatfet,0,0,0,0,1,0,0,1,0.24166666666666667
electrondevice,0,0,0,0,0,0,10,10,2.4166666666666665
eetransaction,0,0,0,0,0,0,3,3,0.725
in,0,0,0,0,0,0,2,2,0.48333333333333334
effecttransistor,0,0,0,0,0,0,2,2,0.48333333333333334
electrondevices,0,0,0,0,0,0,2,2,0.48333333333333334
effecttransis,0,0,0,0,0,0,2,2,0.48333333333333334
sa,0,0,0,0,0,0,2,2,0.48333333333333334
voltage,0,0,0,0,0,0,2,2,0.48333333333333334
impactionization,0,0,0,0,0,0,2,2,0.48333333333333334
fig,0,0,0,0,0,0,2,2,0.48333333333333334
cylindricalgaa,0,0,0,0,0,0,2,2,0.48333333333333334
es,0,0,0,0,0,0,2,2,0.48333333333333334
semiconductors,0,0,0,0,0,0,2,2,0.48333333333333334
dimensionalintegration,0,0,0,0,0,0,2,2,0.48333333333333334
tion,0,0,0,0,0,0,2,2,0.48333333333333334
stamp,0,0,0,0,0,0,2,2,0.48333333333333334
otechnology,0,0,0,0,0,0,1,1,0.24166666666666667
son,0,0,0,0,0,0,1,1,0.24166666666666667
lypesicylindrical,0,0,0,0,0,0,1,1,0.24166666666666667
nt,0,0,0,0,0,0,1,1,0.24166666666666667
underlapands,0,0,0,0,0,0,1,1,0.24166666666666667
cts,0,0,0,0,0,0,1,1,0.24166666666666667
tigationontheef,0,0,0,0,0,0,1,1,0.24166666666666667
shapedgate,0,0,0,0,0,0,1,1,0.24166666666666667
symmetricu,0,0,0,0,0,0,1,1,0.24166666666666667
vlsidcs,0,0,0,0,0,0,1,1,0.24166666666666667
circuitandsystem,0,0,0,0,0,0,1,1,0.24166666666666667
vlsidevice,0,0,0,0,0,0,1,1,0.24166666666666667
gaasjunction,0,0,0,0,0,0,1,1,0.24166666666666667
materialina,0,0,0,0,0,0,1,1,0.24166666666666667
anovelheter,0,0,0,0,0,0,1,1,0.24166666666666667
ormance,0,0,0,0,0,0,1,1,0.24166666666666667
eetransactionson,0,0,0,0,0,0,1,1,0.24166666666666667
ie,0,0,0,0,0,0,1,1,0.24166666666666667
inemergingnanotubefets,0,0,0,0,0,0,1,1,0.24166666666666667
gnedcore,0,0,0,0,0,0,1,1,0.24166666666666667
halinetunnelingfield,0,0,0,0,0,0,1,1,0.24166666666666667
minieeetransaction,0,0,0,0,0,0,1,1,0.24166666666666667
tw,0,0,0,0,0,0,1,1,0.24166666666666667
tration,0,0,0,0,0,0,1,1,0.24166666666666667
onelectrondevice,0,0,0,0,0,0,1,1,0.24166666666666667
transactions,0,0,0,0,0,0,1,1,0.24166666666666667
effect,0,0,0,0,0,0,1,1,0.24166666666666667
nneling,0,0,0,0,0,0,1,1,0.24166666666666667
vheterojunction,0,0,0,0,0,0,1,1,0.24166666666666667
shapedi,0,0,0,0,0,0,1,1,0.24166666666666667
dubeypk,0,0,0,0,0,0,1,1,0.24166666666666667
bility,0,0,0,0,0,0,1,1,0.24166666666666667
ring,0,0,0,0,0,0,1,1,0.24166666666666667
spacerengin,0,0,0,0,0,0,1,1,0.24166666666666667
hetero,0,0,0,0,0,0,1,1,0.24166666666666667
base,0,0,0,0,0,0,1,1,0.24166666666666667
underlap,0,0,1,0,0,0,1,2,0.3666666666666667
etric,0,0,0,0,0,0,1,1,0.24166666666666667
sy,0,0,0,0,0,0,1,1,0.24166666666666667
ka,0,0,0,0,0,0,1,1,0.24166666666666667
vi,0,0,0,0,0,0,1,1,0.24166666666666667
yadav,0,0,0,0,0,0,1,1,0.24166666666666667
electrondevicelet,0,0,0,0,0,0,1,1,0.24166666666666667
ep,0,0,0,0,0,0,1,1,0.24166666666666667
ioffratioa,0,0,0,0,0,0,1,1,0.24166666666666667
gh,0,0,0,0,0,0,1,1,0.24166666666666667
channelhetero,0,0,0,0,0,0,1,1,0.24166666666666667
simulation,0,0,0,0,0,0,1,1,0.24166666666666667
performance,0,0,0,0,0,0,1,1,0.24166666666666667
elhigh,0,0,0,0,0,0,1,1,0.24166666666666667
n-mosfet,0,0,0,0,0,0,1,1,0.24166666666666667
pnpn,0,0,0,0,0,0,1,1,0.24166666666666667
tunnels,0,0,0,0,0,0,1,1,0.24166666666666667
va,0,0,0,0,0,0,1,1,0.24166666666666667
na,0,0,0,0,0,0,1,1,0.24166666666666667
ieeetrans,0,0,0,0,0,0,1,1,0.24166666666666667
withline,0,0,0,0,0,0,1,1,0.24166666666666667
gatetfets,0,0,0,0,0,0,1,1,0.24166666666666667
acteristics,0,0,0,0,0,0,1,1,0.24166666666666667
ieee,0,0,0,0,0,0,1,1,0.24166666666666667
efifecttra,0,0,0,0,0,0,1,1,0.24166666666666667
ntunnelfield,0,0,0,0,0,0,1,1,0.24166666666666667
pocketp,0,0,0,0,0,0,1,1,0.24166666666666667
at,0,0,0,0,0,0,1,1,0.24166666666666667
polar,0,0,0,0,0,0,1,1,0.24166666666666667
doperating,0,0,0,0,0,0,1,1,0.24166666666666667
uce,0,0,0,0,0,0,1,1,0.24166666666666667
reliability,0,0,0,0,0,0,1,1,0.24166666666666667
devicewithimproved,0,0,0,0,0,0,1,1,0.24166666666666667
dimos,0,0,0,0,0,0,1,1,0.24166666666666667
imos,0,0,0,0,0,0,1,1,0.24166666666666667
ovelde,0,0,0,0,0,0,1,1,0.24166666666666667
ment,0,0,0,0,0,0,1,1,0.24166666666666667
ek,0,0,0,0,0,0,1,1,0.24166666666666667
downvoltage,0,0,0,0,0,0,1,1,0.24166666666666667
rea,0,0,0,0,0,0,1,1,0.24166666666666667
withreduce,0,0,0,0,0,0,1,1,0.24166666666666667
mosfet,0,0,2,0,0,0,1,3,0.4916666666666667
animpactionization,0,0,0,0,0,0,1,1,0.24166666666666667
rcuitsimula,0,0,0,0,0,0,1,1,0.24166666666666667
device,0,0,0,0,0,0,1,1,0.24166666666666667
i-mos,0,0,2,0,0,0,1,3,0.4916666666666667
ff,0,0,0,0,0,0,1,1,0.24166666666666667
hn,0,0,0,0,0,0,1,1,0.24166666666666667
la,0,0,0,0,0,0,1,1,0.24166666666666667
sse,0,0,0,0,0,0,1,1,0.24166666666666667
effecttra,0,0,0,0,0,0,1,1,0.24166666666666667
unnelfield,0,0,0,0,0,0,1,1,0.24166666666666667
pande,0,0,0,0,0,0,1,1,0.24166666666666667
lu,0,0,0,0,0,0,1,1,0.24166666666666667
ho,0,0,0,0,0,0,1,1,0.24166666666666667
iceic,0,0,0,0,0,0,1,1,0.24166666666666667
andcommunication,0,0,0,0,0,0,1,1,0.24166666666666667
onelectronics,0,0,0,0,0,0,1,1,0.24166666666666667
ference,0,0,0,0,0,0,1,1,0.24166666666666667
efifecttransistor,0,0,0,0,0,0,1,1,0.24166666666666667
unnellingfield,0,0,0,0,0,0,1,1,0.24166666666666667
heterojunctiongate,0,0,0,0,0,0,1,1,0.24166666666666667
based,0,0,0,0,0,0,1,1,0.24166666666666667
assb,0,0,0,0,0,0,1,1,0.24166666666666667
za,0,0,0,0,0,0,1,1,0.24166666666666667
ti,0,0,0,0,0,0,1,1,0.24166666666666667
electronics,0,0,0,0,0,0,1,1,0.24166666666666667
nextgeneration,0,0,0,0,0,0,1,1,0.24166666666666667
ymposium,0,0,0,0,0,0,1,1,0.24166666666666667
internationals,0,0,0,0,0,0,1,1,0.24166666666666667
forperformance,0,0,0,0,0,0,1,1,0.24166666666666667
terojunction,0,0,0,0,0,0,1,1,0.24166666666666667
ow,0,0,0,0,0,0,1,1,0.24166666666666667
tical,0,0,0,0,0,0,1,1,0.24166666666666667
devicedesign,0,0,0,0,0,0,1,1,0.24166666666666667
uction,0,0,0,0,0,0,1,1,0.24166666666666667
ld,0,0,0,0,0,0,1,1,0.24166666666666667
age,0,0,0,0,0,0,1,1,0.24166666666666667
source,0,0,0,0,0,0,1,1,0.24166666666666667
ign,0,0,0,0,0,0,1,1,0.24166666666666667
nne,0,0,0,0,0,0,1,1,0.24166666666666667
el,0,0,0,0,0,0,1,1,0.24166666666666667
ett,0,0,0,0,0,0,1,1,0.24166666666666667
wi,0,0,0,0,0,0,1,1,0.24166666666666667
space,0,0,0,0,0,0,1,1,0.24166666666666667
tfetwith,0,0,0,0,0,0,1,1,0.24166666666666667
underlap3d,0,0,0,0,0,0,1,1,0.24166666666666667
asymmetrical,0,0,0,0,0,0,1,1,0.24166666666666667
asimulations,0,0,0,0,0,0,1,1,0.24166666666666667
bt,0,0,0,0,0,0,1,1,0.24166666666666667
rultra,0,0,0,0,0,0,1,1,0.24166666666666667
ce,0,0,0,0,0,0,1,1,0.24166666666666667
withacore,0,0,0,0,0,0,1,1,0.24166666666666667
nanotubetunnelling,0,0,0,0,0,0,1,1,0.24166666666666667
internation,0,0,0,0,0,0,1,1,0.24166666666666667
applications,0,0,0,0,0,0,1,1,0.24166666666666667
and,0,0,0,0,0,0,1,1,0.24166666666666667
material,0,0,0,0,0,0,1,1,0.24166666666666667
processing,0,0,0,0,0,0,1,1,0.24166666666666667
informationscience,0,0,0,0,0,0,1,1,0.24166666666666667
formance,0,0,0,0,0,0,1,1,0.24166666666666667
io,0,0,0,0,0,0,1,1,0.24166666666666667
su,0,0,0,0,0,0,1,1,0.24166666666666667
wer,0,0,0,0,0,0,1,1,0.24166666666666667
steminfuture,0,0,0,0,0,0,1,1,0.24166666666666667
evelopment,0,0,0,0,0,0,1,1,0.24166666666666667
微纳电子技术,0,0,0,0,0,0,1,1,0.24166666666666667
隧穿场效应晶体管,1,1,2,0,0,0,1,5,3.4916666666666667
许高博,0,0,0,0,0,0,1,1,0.24166666666666667
lawatfift,0,0,0,0,0,0,1,1,0.24166666666666667
xplor,0,0,0,0,0,0,1,1,0.24166666666666667
数字科技,0,0,0,0,0,0,1,1,0.24166666666666667
amuseum,0,0,0,0,0,0,1,1,0.24166666666666667
cdstm,0,0,0,0,0,0,1,1,0.24166666666666667
amuseiim,0,0,0,0,0,0,1,1,0.24166666666666667
射频性能,0,0,0,0,0,0,1,1,0.24166666666666667
电路模型,0,0,0,0,0,0,1,1,0.24166666666666667
器件加工工艺,0,0,0,0,0,0,1,1,0.24166666666666667
加工验证,0,0,0,0,0,0,1,1,0.24166666666666667
sentaurustcad仿真模拟,0,0,0,0,0,0,1,1,0.24166666666666667
宽度,0,0,0,0,0,0,1,1,0.24166666666666667
overlap增长,0,0,0,0,0,0,1,1,0.24166666666666667
lap,0,0,0,0,0,0,1,1,0.24166666666666667
仿真软件,0,0,0,0,0,0,1,1,0.24166666666666667
错环绕源极环栅隧穿场效应晶体管,1,1,0,0,0,0,1,3,3.2416666666666667
电路,0,0,1,0,0,0,1,2,0.3666666666666667
硅基,0,0,0,0,0,0,1,1,0.24166666666666667
免疫能力,0,0,0,0,0,0,1,1,0.24166666666666667
窄沟道效应,1,0,0,0,0,0,1,2,1.2416666666666667
短沟道效应,1,0,1,0,0,0,1,3,1.3666666666666667
漏端,0,0,1,0,0,0,1,2,0.3666666666666667
集成度,1,0,1,0,0,0,1,3,1.3666666666666667
withpocket,0,0,0,0,0,1,0,1,0.24166666666666667
withoverlap,0,0,0,0,0,1,0,1,0.24166666666666667
价能带间载流子,0,0,0,0,0,1,0,1,0.24166666666666667
负栅极电压,0,0,0,0,0,1,0,1,0.24166666666666667
双极性电流,0,0,0,0,0,1,0,1,0.24166666666666667
单片芯片,0,0,3,0,0,0,0,3,0.375
元器件,0,0,3,0,0,0,0,3,0.375
体积,0,0,3,0,0,0,0,3,0.375
电容,0,0,2,0,0,0,0,2,0.25
栅长,0,0,2,0,0,0,0,2,0.25
错晶体管,0,0,2,0,0,0,0,2,0.25
tfets制造工艺,0,0,1,0,0,0,0,1,0.125
mosfets制造工艺,0,0,1,0,0,0,0,1,0.125
免疫力,0,0,1,0,0,0,0,1,0.125
效应,2,0,1,0,0,0,0,3,2.125
体效应,0,0,1,0,0,0,0,1,0.125
纳米级,0,0,1,0,0,0,0,1,0.125
关断电流,0,0,1,0,0,0,0,1,0.125
关断,0,0,1,0,0,0,0,1,0.125
自由载流子,0,0,1,0,0,0,0,1,0.125
电流控制机制,0,0,1,0,0,0,0,1,0.125
超陡峭亚阈值斜率,0,0,1,0,0,0,0,1,0.125
击穿电压,0,0,1,0,0,0,0,1,0.125
tunnellingfieldeffecttransis,0,0,1,0,0,0,0,1,0.125
btbt,0,0,1,0,0,0,0,1,0.125
bandtobandtunne,0,0,1,0,0,0,0,1,0.125
miconductor,0,0,1,0,0,0,0,1,0.125
ionization-metaloxide,0,0,1,0,0,0,0,1,0.125
电离金属氧化物半导体,0,0,1,0,0,0,0,1,0.125
碰撞电离,0,0,1,0,0,0,0,1,0.125
高关态电流,0,0,1,0,0,0,0,1,0.125
电源电压,0,0,1,0,0,0,0,1,0.125
供电电压,0,0,1,0,0,0,0,1,0.125
耗尽区,0,0,1,0,0,0,0,1,0.125
功耗问,0,0,1,0,0,0,0,1,0.125
单块集成电路,0,0,1,0,0,0,0,1,0.125
栅极电容,0,0,1,0,0,0,0,1,0.125
栅极长度,0,0,1,0,0,0,0,1,0.125
集成电路芯片,0,0,1,0,0,0,0,1,0.125
摩尔定律,1,0,1,0,0,0,0,2,1.125
仙童半导体公司,0,0,1,0,0,0,0,1,0.125
巨型真空管,0,0,1,0,0,0,0,1,0.125
微型化,0,0,1,0,0,0,0,1,0.125
电子器件,0,0,1,0,0,0,0,1,0.125
焊接点,0,0,1,0,0,0,0,1,0.125
重量,0,0,1,0,0,0,0,1,0.125
分立元器件电路,0,0,1,0,0,0,0,1,0.125
错集成电路,0,0,1,0,0,0,0,1,0.125
简易电路,0,0,1,0,0,0,0,1,0.125
相移振荡器,0,0,1,0,0,0,0,1,0.125
德州仪器,0,0,1,0,0,0,0,1,0.125
小型化,0,0,1,0,0,0,0,1,0.125
商用计算机,0,0,1,0,0,0,0,1,0.125
点接触型晶体管,0,0,1,0,0,0,0,1,0.125
贝尔实验室,0,0,1,0,0,0,0,1,0.125
源极掺杂浓度变化率,0,0,3,0,0,0,0,3,0.375
器件性能,0,0,2,0,0,0,0,2,0.25
接触面积,0,0,2,0,0,0,0,2,0.25
u形栅,0,0,2,0,0,0,0,2,0.25
异质对称,0,0,2,0,0,0,0,2,0.25
电子科技,0,0,2,0,0,0,0,2,0.25
hs-tfet,0,0,2,0,0,0,0,2,0.25
hs-tfet结构,0,0,2,0,0,0,0,2,0.25
underlap结构,0,0,1,0,0,0,0,1,0.125
sourcedopinggradient,0,0,1,0,0,0,0,1,0.125
栅极覆盖源极,0,0,1,0,0,0,0,1,0.125
栅极远离源极,0,0,1,0,0,0,0,1,0.125
n型sigaatfet,0,0,1,0,0,0,0,1,0.125
tcad,0,0,1,0,0,0,0,1,0.125
栅极内凹tfet,0,0,1,0,0,0,0,1,0.125
电流开关比,0,0,1,0,0,0,0,1,0.125
栅极内凹,0,0,1,0,0,0,0,1,0.125
shapedgatetfet,0,0,1,0,0,0,0,1,0.125
backgate,0,0,1,0,0,0,0,1,0.125
开关特性,0,0,1,0,0,0,0,1,0.125
u形栅结构,0,0,1,0,0,0,0,1,0.125
u-shapedgatetfet,0,0,1,0,0,0,0,1,0.125
隧穿场效应晶体管结构,0,0,1,0,0,0,0,1,0.125
漏电流增量,0,0,1,0,0,0,0,1,0.125
stackedsource,0,0,1,0,0,0,0,1,0.125
源极叠层,0,0,1,0,0,0,0,1,0.125
亚阈值性能,0,0,0,0,1,0,0,1,0.24166666666666667
gasgastfet,0,0,0,0,1,0,0,1,0.24166666666666667
半导体材料,0,0,0,3,0,0,0,3,0.375
e-k,0,0,0,2,0,0,0,2,0.25
空间,0,0,0,2,0,0,0,2,0.25
局部模型,0,0,0,1,0,0,0,1,0.125
tfet分析模型,0,0,0,1,0,0,0,1,0.125
隧穿点,0,0,0,1,0,0,0,1,0.125
器件电流,0,0,0,1,0,0,0,1,0.125
总电流,0,0,0,1,0,0,0,1,0.125
复合电流,0,0,0,1,0,0,0,1,0.125
电子总数,0,0,0,1,0,0,0,1,0.125
价带隧穿,0,0,0,1,0,0,0,1,0.125
积分,0,0,0,1,0,0,0,1,0.125
偏置电场,0,0,0,1,0,0,0,1,0.125
e-k图,0,0,0,1,0,0,0,1,0.125
晶格,0,0,0,1,0,0,0,1,0.125
输运方程,0,0,0,1,0,0,0,1,0.125
非局部模型,0,0,0,1,0,0,0,1,0.125
电流计算模型,0,0,0,1,0,0,0,1,0.125
依赖,0,0,0,1,0,0,0,1,0.125
薛定涔方程,0,0,0,1,0,0,0,1,0.125
薛定铐方程,0,0,0,1,0,0,0,1,0.125
外部偏置,0,0,0,1,0,0,0,1,0.125
空间位置,0,0,0,1,0,0,0,1,0.125
薛定筒方程,0,0,0,1,0,0,0,1,0.125
路径,0,0,0,1,0,0,0,1,0.125
郎道尔公式,0,0,0,1,0,0,0,1,0.125
fefs分析模型,0,0,0,1,0,0,0,1,0.125
源极硅层掺杂浓度,0,0,0,0,0,2,0,2,0.48333333333333334
延长长度,0,0,0,0,0,1,0,1,0.24166666666666667
gasgaateft,0,0,0,0,0,1,0,1,0.24166666666666667
工艺流程,0,0,0,0,0,3,0,3,0.725
器件沟道,0,0,0,0,0,1,0,1,0.24166666666666667
overlapi程,0,0,0,0,0,1,0,1,0.24166666666666667
o-gasgaatfet结构,0,0,0,0,0,1,0,1,0.24166666666666667
oo-gasgaatfet,0,0,0,0,0,1,0,1,0.24166666666666667
电学性能,0,0,0,0,1,0,0,1,0.24166666666666667
错硅异质结,0,0,0,0,1,0,0,1,0.24166666666666667
ogasgaatfet,0,0,0,0,1,0,0,1,0.24166666666666667
10gasgaatfet,0,0,0,0,0,1,0,1,0.24166666666666667
npocket,0,0,0,0,0,1,0,1,0.24166666666666667
沟道掺杂浓度,0,0,0,0,0,1,0,1,0.24166666666666667
pocket长度,0,0,0,0,0,1,0,1,0.24166666666666667
pocket半径,0,0,0,0,0,1,0,1,0.24166666666666667
工艺尺寸,2,0,0,0,0,0,0,2,2.0
n型pocket,1,0,0,0,0,0,0,1,1.0
硅源极环栅,1,0,0,0,0,0,0,1,1.0
错源极环栅,1,0,0,0,0,0,0,1,1.0
纳米管mosfets加工工艺,1,0,0,0,0,0,0,1,1.0
微米,1,0,0,0,0,0,0,1,1.0
纳米,1,0,0,0,0,0,0,1,1.0
金属氧化物半导体,1,0,0,0,0,0,0,1,1.0
场效应晶体管,1,0,0,0,0,0,0,1,1.0
玻尔兹曼限制,1,0,0,0,0,0,0,1,1.0
