,摘要,关键词,第一章,第二章,第三章,第四章,第五章,总词频,加权得分
wi-fi信号,0,0,20,15,7,6,4,52,8.483333333333334
分辨率,0,0,11,2,19,0,6,38,7.666666666666667
wi-fi,2,0,33,12,19,40,13,119,25.025
带宽,3,0,8,10,14,0,5,40,9.841666666666667
wi-fi信道,6,0,4,2,10,0,4,26,10.133333333333333
行为感知技术,1,0,10,1,2,3,2,19,4.066666666666666
链路,4,0,18,1,0,52,8,83,20.875
csi,3,0,10,20,13,7,5,58,12.791666666666668
信号,0,0,6,4,7,1,4,22,4.15
多径分辨率,0,0,6,0,2,0,2,10,1.7166666666666668
神经网络,0,0,6,3,2,7,4,22,4.266666666666667
聚合信道,1,0,2,0,9,0,2,14,3.908333333333333
聚合机制,1,0,2,0,1,0,2,6,1.975
快速切换,0,0,2,0,1,0,2,5,0.975
多信道,0,0,2,1,2,0,2,7,1.3416666666666668
信号带宽,0,0,3,0,2,0,2,7,1.3416666666666668
感知链路,1,0,7,2,0,18,2,30,6.958333333333333
目标行,0,0,3,0,1,1,1,6,1.1
感知效果,0,0,4,0,0,0,0,4,0.5
子载波,0,0,6,11,2,2,2,23,3.575
行为感知精度,0,0,2,0,0,0,1,3,0.4916666666666667
目标,1,0,8,1,4,0,3,17,3.8166666666666664
wi-fi设备,1,0,20,2,0,12,3,38,7.375
感知,0,0,7,0,2,3,1,13,2.325
高时间分辨率信号,0,0,1,0,1,0,1,3,0.6083333333333334
神经网络模块,0,0,2,0,1,0,2,5,0.975
特征图像,0,0,2,4,2,1,2,11,1.9583333333333333
空间域特征,0,0,2,0,1,1,2,6,1.2166666666666668
频域特征,0,0,2,0,1,1,2,6,1.2166666666666668
时域特征,0,0,2,0,1,1,2,6,1.2166666666666668
特征,0,0,2,0,9,0,1,12,2.6666666666666665
相位,0,0,2,8,3,1,2,16,2.7
csi幅度,0,0,2,6,4,3,2,17,3.175
特征提取模块,1,0,2,0,6,1,2,12,3.425
空间域,1,0,2,0,1,1,2,7,2.216666666666667
频域,1,0,2,3,1,1,2,10,2.591666666666667
时域,1,0,2,2,1,2,2,10,2.708333333333333
可切换信道,1,0,2,1,2,0,1,7,2.1
丢包,0,0,1,0,3,0,1,5,1.0916666666666668
信道切换,0,0,2,1,12,0,1,16,3.5166666666666666
重传机制,0,0,1,0,1,0,1,3,0.6083333333333334
确认,0,0,1,0,2,0,1,4,0.85
csi数据,0,0,2,1,2,2,1,8,1.5833333333333333
时间,0,0,1,1,5,1,1,9,1.9416666666666667
切换,0,0,1,0,0,0,1,2,0.3666666666666667
聚合算法,0,0,2,1,9,0,1,13,2.7916666666666665
感知分辨率提升机,0,0,1,1,1,0,0,3,0.4916666666666667
目标状态,1,0,2,0,0,0,1,4,1.4916666666666667
信道带宽,1,0,2,0,2,0,1,6,1.975
wi-fi网卡,0,0,2,2,2,0,1,7,1.225
状态,0,0,5,8,2,5,2,22,3.8
活动目标,0,0,1,0,1,0,1,3,0.6083333333333334
多径长度,0,0,1,0,1,0,1,3,0.6083333333333334
时间分辨率,0,0,1,5,1,0,1,8,1.2333333333333334
多径到达时间,0,0,2,0,0,0,1,3,0.4916666666666667
目标行为感知,0,0,5,0,1,3,0,9,1.5916666666666668
多径信号,0,0,1,0,1,0,0,2,0.3666666666666667
择机制,0,0,2,0,0,4,0,6,1.2166666666666668
最佳感知链路,0,0,1,0,0,0,0,1,0.125
行为感知分辨率提升机制,0,0,2,0,5,0,1,8,1.7
行为感知模型,0,0,1,0,0,0,0,1,0.125
最佳,0,0,1,0,0,0,0,1,0.125
物理空间,0,0,2,0,0,0,0,2,0.25
收发设备,0,0,1,0,0,0,0,1,0.125
感知环境,0,0,2,0,0,1,0,3,0.4916666666666667
通信链路,0,0,2,0,0,1,1,4,0.7333333333333334
接收设备,0,0,2,0,0,0,1,3,0.4916666666666667
发送设备,0,0,2,0,0,0,1,3,0.4916666666666667
wi-fi感知技术,0,0,3,0,0,1,2,6,1.1
多径传播,0,0,2,0,0,0,0,2,0.25
wi-fi收发链路,0,0,1,0,0,0,0,1,0.125
目标行为,0,0,4,6,6,5,0,21,3.908333333333333
区分度,0,0,1,0,0,0,0,1,0.125
wi-fi多径信号,0,0,1,0,1,0,0,2,0.3666666666666667
精度提升,0,1,2,1,0,0,1,5,2.6166666666666667
行为感知系统,1,0,9,2,0,0,1,13,2.6166666666666667
行为感知,2,1,12,5,1,8,1,30,8.541666666666666
lstm,0,0,0,5,9,6,0,20,4.25
特征谱图,0,0,0,0,4,0,0,4,0.9666666666666667
训练时间,0,0,0,0,3,0,0,3,0.725
分辨率提升机制,1,0,0,0,19,0,1,21,5.833333333333333
图像,0,0,0,5,4,0,0,9,1.5916666666666668
时变信号,0,0,0,0,1,0,0,1,0.24166666666666667
时间状态信息,0,0,0,0,1,0,0,1,0.24166666666666667
编码,0,0,0,0,1,0,0,1,0.24166666666666667
cnno,0,0,0,0,1,0,0,1,0.24166666666666667
深度学习方法,0,0,0,0,1,0,0,1,0.24166666666666667
行为,0,0,0,1,1,3,0,5,1.0916666666666668
性能,0,0,0,3,6,8,1,18,4.0
特征信息,0,0,0,0,1,0,0,1,0.24166666666666667
谱图,0,0,0,0,2,0,0,2,0.48333333333333334
幅度,0,0,1,4,2,1,0,8,1.35
深度特征,0,0,0,0,1,0,0,1,0.24166666666666667
系统性能,0,0,0,0,2,0,0,2,0.48333333333333334
深度学习,0,0,0,0,2,1,0,3,0.725
准确率,0,0,0,0,6,2,0,8,1.9333333333333333
池化层,0,0,0,1,7,4,0,12,2.783333333333333
卷积层,0,0,0,1,12,14,0,27,6.408333333333333
指数衰减率,0,0,0,0,4,2,0,6,1.45
全连接层,0,0,0,1,11,9,0,21,4.958333333333333
ablstm,0,0,0,0,5,0,0,5,1.2083333333333333
活动感知,0,0,0,0,2,0,0,2,0.48333333333333334
lstm参数,0,0,0,0,2,0,0,2,0.48333333333333334
无穷小参数,0,0,0,0,2,1,0,3,0.725
epoch,0,0,0,0,2,0,0,2,0.48333333333333334
batch,0,0,0,0,2,0,0,2,0.48333333333333334
学习率,0,0,0,0,2,1,0,3,0.725
数值,0,0,0,0,2,1,0,3,0.725
参数,0,0,0,1,2,15,0,18,4.233333333333333
cnn参数,0,0,0,0,2,0,0,2,0.48333333333333334
深度学习模块,0,0,0,0,8,0,0,8,1.9333333333333333
人类活动识别,0,0,0,0,4,0,0,4,0.9666666666666667
人体活动识别技术,0,0,0,0,1,0,0,1,0.24166666666666667
活动识别,0,0,2,3,1,2,0,8,1.35
距离,0,0,1,2,4,0,0,7,1.3416666666666668
clhar,0,0,0,0,2,0,0,2,0.48333333333333334
人类,0,0,0,0,5,0,0,5,1.2083333333333333
行为感知机制,0,0,0,0,1,0,0,1,0.24166666666666667
隐藏层单元个数,0,0,0,0,1,0,0,1,0.24166666666666667
活动,1,0,1,1,6,3,0,12,3.425
dropout率,0,0,0,0,1,1,0,2,0.48333333333333334
softmax,0,0,0,0,1,3,0,4,0.9666666666666667
激活函数,0,0,0,4,1,3,0,8,1.4666666666666668
层数,0,0,0,0,2,3,0,5,1.2083333333333333
cnn结构,0,0,0,0,1,0,0,1,0.24166666666666667
标签,0,0,0,0,3,1,0,4,0.9666666666666667
卷积滤波器,0,0,0,0,2,0,0,2,0.48333333333333334
输入数据,0,0,0,1,1,3,0,5,1.0916666666666668
内存,0,0,0,0,2,0,0,2,0.48333333333333334
x1080,0,0,0,0,1,0,0,1,0.24166666666666667
force,0,0,0,0,1,0,0,1,0.24166666666666667
48核cpu处理器,0,0,0,0,1,0,0,1,0.24166666666666667
xeon,0,0,0,0,1,0,0,1,0.24166666666666667
服务器,0,0,0,0,1,0,0,1,0.24166666666666667
tensorflow,0,0,0,0,1,0,0,1,0.24166666666666667
协同感知,0,0,1,0,0,0,0,1,0.125
多设备,1,0,1,0,0,0,0,2,1.125
聚合额外带宽,0,0,1,0,0,0,0,1,0.125
精度,1,0,2,0,5,3,0,11,3.1833333333333336
网络模型,0,0,1,0,0,0,0,1,0.125
精确度,0,0,1,0,0,0,0,1,0.125
机器学习模型,0,0,1,0,0,0,0,1,0.125
非监督学习,0,0,1,0,0,0,0,1,0.125
监督学习,0,0,1,0,0,0,0,1,0.125
行为特征,1,0,1,0,1,0,0,3,1.3666666666666667
特征提取技,0,0,1,0,0,0,0,1,0.125
无线信号,1,0,5,8,0,0,1,15,2.8666666666666667
映射关系模型,0,0,1,0,0,0,0,1,0.125
冗余信息,0,0,1,0,0,3,0,4,0.85
有用信息,0,0,1,0,0,0,0,1,0.125
wi-fi链路,2,0,2,1,0,28,1,34,9.383333333333333
wi-fi行为感知场,0,0,1,0,0,0,0,1,0.125
环境目标,0,0,1,0,0,0,0,1,0.125
csi序列,0,0,1,3,0,0,0,4,0.5
反射路径长度,0,0,1,0,1,0,0,2,0.3666666666666667
学习,0,0,1,0,0,1,0,2,0.3666666666666667
wi.fi设备,0,0,1,0,0,0,0,1,0.125
分类网络,0,0,0,0,0,10,0,10,2.4166666666666665
cnn,0,0,0,0,0,5,0,5,1.2083333333333333
强化学习智能体,0,0,0,0,0,2,0,2,0.48333333333333334
数据处理模块,0,0,0,0,0,4,0,4,0.9666666666666667
机制,0,0,0,1,1,7,1,10,2.3
智能体,1,0,4,19,0,30,3,57,11.85
情景信息,1,0,2,0,0,5,2,10,2.9416666666666664
位置,1,0,2,0,4,2,2,11,3.1833333333333336
姿态,1,0,4,0,0,0,2,7,1.9833333333333334
标状态,0,0,1,0,0,0,1,2,0.3666666666666667
特征提取,1,0,1,2,0,2,1,7,2.1
排序,0,0,1,0,0,0,1,2,0.3666666666666667
权重,1,0,1,3,5,4,1,15,3.9166666666666665
真实标签,0,0,1,0,0,0,0,1,0.125
深度强化学习智能体,0,0,1,0,0,0,1,2,0.3666666666666667
感知精度,2,0,3,1,0,6,1,13,4.191666666666666
活动目标状态,0,0,1,0,0,0,1,2,0.3666666666666667
场景收发设备,0,0,1,0,0,0,0,1,0.125
目标行为感知技术,0,0,2,1,0,0,1,4,0.6166666666666667
收发链路,0,0,2,0,0,0,1,3,0.4916666666666667
选择机制,0,0,1,0,0,0,0,1,0.125
wi.fi,0,0,1,0,0,0,0,1,0.125
信道,0,0,3,5,39,0,1,48,10.666666666666666
混淆矩阵,0,0,0,0,3,0,0,3,0.725
定位误差,0,0,0,0,1,0,0,1,0.24166666666666667
平均,0,0,0,0,1,0,0,1,0.24166666666666667
单信道系统,0,0,0,0,1,0,0,1,0.24166666666666667
单信道,0,0,0,0,3,0,0,3,0.725
位置信息,0,0,0,0,2,0,0,2,0.48333333333333334
性能波动,0,0,0,0,1,0,0,1,0.24166666666666667
分类性能,0,0,0,0,1,1,0,2,0.48333333333333334
fpro,0,0,0,0,1,0,0,1,0.24166666666666667
fl,0,0,0,0,1,0,0,1,0.24166666666666667
行为感知分辨率,0,0,0,0,1,0,0,1,0.24166666666666667
pdp,0,0,1,10,1,0,0,12,1.6166666666666667
连续活动,0,0,0,0,1,0,0,1,0.24166666666666667
频率,0,0,1,0,3,1,0,5,1.0916666666666668
跑步,0,0,0,0,2,1,0,3,0.725
行走,0,0,0,0,2,1,0,3,0.725
活动频率,0,0,0,0,1,0,0,1,0.24166666666666667
稳定性,0,0,0,0,1,0,0,1,0.24166666666666667
聚合csi,1,0,0,0,5,0,0,6,2.208333333333333
聚合csio,0,0,0,0,1,0,0,1,0.24166666666666667
wi-fi行为感知,0,0,0,0,1,1,0,2,0.48333333333333334
单一信道,0,0,0,0,1,0,0,1,0.24166666666666667
aoa谱图,0,0,0,0,8,0,0,8,1.9333333333333333
aoa值,0,0,0,2,4,0,0,6,1.2166666666666668
stft谱图,0,0,0,0,8,0,0,8,1.9333333333333333
频率特征,0,0,0,0,2,0,0,2,0.48333333333333334
aoa,0,0,0,1,2,0,0,3,0.6083333333333334
相位差,0,0,1,11,3,4,0,19,3.1916666666666664
空间,0,0,2,0,1,0,0,3,0.4916666666666667
时频特征,0,0,0,0,2,0,0,2,0.48333333333333334
stft,0,0,0,0,2,0,0,2,0.48333333333333334
short-timefouriertransform,0,0,0,0,1,0,0,1,0.24166666666666667
短时傅里叶变换,0,0,0,0,1,0,0,1,0.24166666666666667
变化,0,0,0,0,1,0,0,1,0.24166666666666667
路径长度,0,0,0,0,1,0,0,1,0.24166666666666667
数据维度,0,0,0,0,1,2,0,3,0.725
principalcomponent,0,0,0,0,1,0,0,1,0.24166666666666667
主成分分析法,0,0,0,0,1,0,0,1,0.24166666666666667
csi数据流,0,0,0,0,2,2,0,4,0.9666666666666667
csi相位差,0,0,0,0,1,0,0,1,0.24166666666666667
天线,0,0,1,7,7,1,0,16,2.9333333333333336
鲁棒性,0,0,0,0,1,0,0,1,0.24166666666666667
室内,0,0,0,0,1,0,0,1,0.24166666666666667
多信道切换,0,0,0,0,2,0,0,2,0.48333333333333334
数据,0,0,0,3,1,2,0,6,1.1
用wi-fi设备,0,0,1,0,1,0,0,2,0.3666666666666667
相邻信道,0,0,0,0,1,0,0,1,0.24166666666666667
包处理,0,0,0,0,1,0,0,1,0.24166666666666667
毫秒粒度,0,0,0,0,1,0,0,1,0.24166666666666667
lossofradioconnectivity,0,0,0,0,1,0,0,1,0.24166666666666667
on,0,0,0,0,1,0,0,1,0.24166666666666667
lo,0,0,0,0,1,0,0,1,0.24166666666666667
ieee802.il包,0,0,0,0,1,0,0,1,0.24166666666666667
iwlwifi驱动程序,0,0,0,0,1,0,0,1,0.24166666666666667
csio,0,0,0,0,1,0,0,1,0.24166666666666667
wi-fi数据包,0,0,0,0,1,0,0,1,0.24166666666666667
接收端,0,0,2,8,7,2,0,19,3.425
固件,0,0,0,0,1,0,0,1,0.24166666666666667
驱动程序,0,0,0,0,1,0,0,1,0.24166666666666667
intel5300网卡,0,0,0,0,1,1,0,2,0.48333333333333334
时间间隔,0,0,0,1,1,0,0,2,0.3666666666666667
总带宽,0,0,0,1,2,0,0,3,0.6083333333333334
wi-fi通信信号,0,0,0,0,1,0,0,1,0.24166666666666667
wifi信道,0,0,0,0,1,0,0,1,0.24166666666666667
环境,1,0,1,7,0,0,0,9,2.0
强化学习,1,0,2,6,0,1,0,10,2.2416666666666667
动作空间,0,0,0,2,0,4,0,6,1.2166666666666668
状态空间,0,0,0,2,0,0,0,2,0.25
强化学习模型,0,0,0,2,0,0,0,2,0.25
概率,0,0,0,4,3,4,0,11,2.1916666666666664
奖励,0,0,0,3,0,0,0,3,0.375
学习智能体,0,0,0,2,0,5,0,7,1.4583333333333333
wi-fi感知系统,0,0,0,1,0,0,0,1,0.125
持续性,0,0,0,1,0,0,0,1,0.125
wi-fi环境,1,0,0,4,1,9,0,15,3.9166666666666665
顺序,0,0,0,1,0,0,0,1,0.125
映射,0,0,0,2,0,0,0,2,0.25
系统,0,0,0,1,0,1,0,2,0.3666666666666667
感知智能体,0,0,0,1,0,0,0,1,0.125
激励,0,0,0,1,0,0,0,1,0.125
奖励函数,0,0,0,1,0,1,0,2,0.3666666666666667
智能体能,0,0,0,1,0,0,0,1,0.125
markovdecision,0,0,0,1,0,0,0,1,0.125
马尔可夫决策过程,0,0,0,1,0,0,0,1,0.125
策略,0,0,0,1,0,0,0,1,0.125
转移概率,0,0,0,1,0,0,0,1,0.125
动作,0,0,0,5,0,4,0,9,1.5916666666666668
statereward,0,0,0,1,0,0,0,1,0.125
agent,0,0,0,1,0,0,0,1,0.125
环境信息,0,0,0,1,0,3,0,4,0.85
强化学习任务,0,0,0,1,0,0,0,1,0.125
机器学习,0,0,0,1,0,1,0,2,0.3666666666666667
人类活动,0,0,0,0,4,0,0,4,0.9666666666666667
csi数据集,0,0,0,0,1,0,0,1,0.24166666666666667
信号特征,0,0,0,0,1,0,0,1,0.24166666666666667
分类器,0,0,0,0,2,2,0,4,0.9666666666666667
ena,0,0,0,0,1,0,0,1,0.24166666666666667
recognition,0,0,0,0,1,0,0,1,0.24166666666666667
humanactivity,0,0,0,0,1,0,0,1,0.24166666666666667
crosslocation,0,0,0,0,1,0,0,1,0.24166666666666667
人类活动识别场景,0,0,0,0,2,0,0,2,0.48333333333333334
场景,0,0,2,0,1,0,0,3,0.4916666666666667
智能链路,0,0,1,0,0,2,1,4,0.85
wi-fi发射端,0,0,0,0,0,0,1,1,0.24166666666666667
目标状态标签,0,0,0,0,0,0,1,1,0.24166666666666667
链路覆,0,0,0,0,0,0,1,1,0.24166666666666667
多径传播效果,0,0,0,0,0,0,1,1,0.24166666666666667
识别性能,0,0,0,0,1,0,1,2,0.48333333333333334
clhar场景,0,0,0,0,0,0,1,1,0.24166666666666667
密集wi-fi,0,0,1,0,0,0,1,2,0.3666666666666667
子载波数量,0,0,0,0,0,0,1,1,0.24166666666666667
多径效应,0,0,3,3,0,0,1,7,0.9916666666666667
映射关系,0,0,1,0,0,0,1,2,0.3666666666666667
多径叠加信号,0,0,1,0,0,0,1,2,0.3666666666666667
无线智能终端,0,0,1,0,0,0,1,2,0.3666666666666667
跨位置,0,0,0,0,1,0,0,1,0.24166666666666667
ablstmo,0,0,0,0,1,0,0,1,0.24166666666666667
人体活动识别,0,0,0,0,1,0,0,1,0.24166666666666667
dwt谱图,0,0,0,0,0,5,0,5,1.2083333333333333
tdtptc,0,0,0,0,0,2,0,2,0.48333333333333334
dropout,0,0,0,0,1,2,0,3,0.725
概率分布,0,0,0,0,0,1,0,1,0.24166666666666667
用户行为样本,0,0,0,0,0,1,0,1,0.24166666666666667
预测分布,0,0,0,0,0,1,0,1,0.24166666666666667
概率值,0,0,0,0,0,2,0,2,0.48333333333333334
分类标签,0,0,0,0,1,1,0,2,0.48333333333333334
softmax函数,0,0,0,0,0,1,0,1,0.24166666666666667
特征图,0,0,0,0,5,1,0,6,1.45
relu函数,0,0,0,0,0,1,0,1,0.24166666666666667
sq,0,0,0,0,0,1,0,1,0.24166666666666667
tdtp,0,0,0,0,0,1,0,1,0.24166666666666667
特征映射,0,0,0,0,1,1,0,2,0.48333333333333334
sj,0,0,0,0,0,1,0,1,0.24166666666666667
cnn分类网络,0,0,0,0,0,7,0,7,1.6916666666666667
时频图,0,0,0,0,0,1,0,1,0.24166666666666667
图片信息,0,0,0,0,0,1,0,1,0.24166666666666667
时频,0,0,0,0,0,1,0,1,0.24166666666666667
时序数据,0,0,0,0,0,1,0,1,0.24166666666666667
时频信息,0,0,0,1,0,1,0,2,0.3666666666666667
时间频率特征,0,0,0,0,0,1,0,1,0.24166666666666667
discretewavelettransform,0,0,0,0,0,1,0,1,0.24166666666666667
离散小波变换,0,0,0,0,0,1,0,1,0.24166666666666667
csi流,0,0,0,0,0,3,0,3,0.725
wi-fi链路数量,0,0,0,0,0,2,0,2,0.48333333333333334
计算复杂度,0,0,0,0,0,1,0,1,0.24166666666666667
最优链路,0,0,0,0,0,1,0,1,0.24166666666666667
wifi设备,0,0,0,0,0,1,0,1,0.24166666666666667
环境噪音,0,0,0,0,0,2,0,2,0.48333333333333334
目标行为信息,0,0,0,0,0,3,0,3,0.725
wi-fi感知,0,0,1,0,0,1,0,2,0.3666666666666667
标行为,0,0,0,0,0,1,0,1,0.24166666666666667
无用链路,0,0,0,0,0,1,0,1,0.24166666666666667
去噪方,0,0,0,0,0,1,0,1,0.24166666666666667
特征提取方,0,0,0,0,0,1,0,1,0.24166666666666667
去噪环节,0,0,0,0,0,1,0,1,0.24166666666666667
分类器性能,0,0,0,0,0,1,0,1,0.24166666666666667
链路信息,0,0,0,0,0,1,0,1,0.24166666666666667
环境噪声,0,0,0,0,0,2,0,2,0.48333333333333334
两收设备,0,0,0,0,0,1,0,1,0.24166666666666667
正交链路,0,0,0,0,0,4,0,4,0.9666666666666667
wi-fi感知应用,0,0,0,0,0,2,0,2,0.48333333333333334
标注时间,0,0,0,0,0,1,0,1,0.24166666666666667
人工链路,0,0,0,0,0,1,0,1,0.24166666666666667
链路管理,0,0,0,0,0,1,0,1,0.24166666666666667
无效信息,0,0,0,0,0,1,0,1,0.24166666666666667
有效信息,0,0,0,0,0,1,0,1,0.24166666666666667
自适应,0,0,0,0,0,1,0,1,0.24166666666666667
wi-fi状态,0,0,0,0,0,1,0,1,0.24166666666666667
长期收益,0,0,0,0,0,1,0,1,0.24166666666666667
wifi信号,0,0,0,0,1,1,0,2,0.48333333333333334
正交wi-fi链路,0,0,0,0,0,1,0,1,0.24166666666666667
人工选择链路,0,0,0,0,0,1,0,1,0.24166666666666667
智能选择链路,0,0,0,0,0,1,0,1,0.24166666666666667
性能分,0,0,0,0,0,1,0,1,0.24166666666666667
目标行为感知应用,0,0,0,0,0,1,0,1,0.24166666666666667
行为识别,1,0,0,0,0,1,0,2,1.2416666666666667
识别过程,0,0,0,0,0,1,0,1,0.24166666666666667
维度,0,0,0,0,0,1,0,1,0.24166666666666667
数据集,0,0,0,0,0,4,0,4,0.9666666666666667
监督数据,0,0,0,0,0,1,0,1,0.24166666666666667
训练,0,0,0,0,1,1,0,2,0.48333333333333334
长期回报,0,0,0,0,0,1,0,1,0.24166666666666667
即时奖励,0,0,0,0,0,1,0,1,0.24166666666666667
位置标号,0,0,0,0,2,0,0,2,0.48333333333333334
位置标签,0,0,0,0,2,0,0,2,0.48333333333333334
负样本,0,0,0,0,2,0,0,2,0.48333333333333334
假阳率,0,0,0,0,2,0,0,2,0.48333333333333334
正样本,0,0,0,0,2,0,0,2,0.48333333333333334
频带,0,0,0,0,2,0,0,2,0.48333333333333334
空间坐标轴,0,0,0,0,1,0,0,1,0.24166666666666667
个数,0,0,0,0,2,0,0,2,0.48333333333333334
测试集,0,0,0,0,2,2,0,4,0.9666666666666667
averagelocalization,0,0,0,0,1,0,0,1,0.24166666666666667
平均定位误差,0,0,0,0,1,0,0,1,0.24166666666666667
fpr,0,0,0,0,1,0,0,1,0.24166666666666667
位置识别性能,0,0,0,0,1,0,0,1,0.24166666666666667
truenegative,0,0,0,0,1,0,0,1,0.24166666666666667
真阴率,0,0,0,0,1,0,0,1,0.24166666666666667
falsepositivera,0,0,0,0,1,0,0,1,0.24166666666666667
假反例率,0,0,0,0,1,0,0,1,0.24166666666666667
度量,0,0,0,0,1,0,0,1,0.24166666666666667
felsepositive,0,0,0,0,1,0,0,1,0.24166666666666667
recall,0,0,0,0,1,0,0,1,0.24166666666666667
召回率,0,0,0,0,1,0,0,1,0.24166666666666667
falseposit,0,0,0,0,1,0,0,1,0.24166666666666667
truepositive,0,0,0,0,1,0,0,1,0.24166666666666667
真阳率,0,0,0,0,1,0,0,1,0.24166666666666667
precision,0,0,0,0,1,0,0,1,0.24166666666666667
精确率,0,0,0,0,1,0,0,1,0.24166666666666667
准确率混淆矩阵,0,0,0,0,1,0,0,1,0.24166666666666667
细粒度性能,0,0,0,0,1,0,0,1,0.24166666666666667
fi信号,0,0,0,0,1,0,0,1,0.24166666666666667
wi-,0,0,0,0,1,0,0,1,0.24166666666666667
暖色调,0,0,0,0,1,0,0,1,0.24166666666666667
高能量,0,0,0,0,1,0,0,1,0.24166666666666667
指纹信息,0,0,0,0,1,0,0,1,0.24166666666666667
aoa谱图分布,0,0,0,0,1,0,0,1,0.24166666666666667
csi相位,0,0,0,2,1,0,0,3,0.4916666666666667
分辨,0,0,0,0,1,0,0,1,0.24166666666666667
numberofpackets,0,0,0,0,1,0,0,1,0.24166666666666667
活动识别准确率,0,0,0,0,1,0,0,1,0.24166666666666667
人类活动识别实验,0,0,0,0,1,0,0,1,0.24166666666666667
性能增益,0,0,0,0,1,0,0,1,0.24166666666666667
聚合模块,0,0,0,0,1,0,0,1,0.24166666666666667
人体活动识别系统,0,0,0,0,1,0,0,1,0.24166666666666667
接收信号,0,0,0,0,1,0,0,1,0.24166666666666667
分辨率提升机,0,0,0,0,1,0,0,1,0.24166666666666667
为感知,0,0,0,1,3,0,0,4,0.85
ifft,0,0,0,3,0,0,0,3,0.375
信息,0,0,2,6,0,4,0,12,1.9666666666666668
极坐标,0,0,0,2,0,0,0,2,0.25
时间偏移,0,0,0,2,0,0,0,2,0.25
误差源,0,0,0,2,0,0,0,2,0.25
相位分布,0,0,0,2,0,0,0,2,0.25
静态,0,0,0,2,0,0,0,2,0.25
方差,0,0,0,2,0,1,0,3,0.4916666666666667
相位信息,0,0,0,2,0,0,0,2,0.25
多径信道,0,0,0,2,0,0,0,2,0.25
色散,0,0,0,2,0,0,0,2,0.25
时间域,0,0,0,2,0,0,0,2,0.25
静态路径,0,0,0,1,0,0,0,1,0.125
距离差,0,0,0,1,0,0,0,1,0.125
子载波信号,0,0,0,1,0,0,0,1,0.125
波长,0,0,0,1,0,0,0,1,0.125
额外距离,0,0,0,1,0,0,0,1,0.125
相位差分布,0,0,0,1,0,0,0,1,0.125
始相位,0,0,0,1,0,0,0,1,0.125
相位差信息,0,0,0,1,0,0,0,1,0.125
phasedihitetic,0,0,0,1,0,0,0,1,0.125
rawphases,0,0,0,1,0,0,0,1,0.125
波动,0,0,0,1,0,0,0,1,0.125
空间环境,0,0,1,1,0,0,0,2,0.25
sfo,0,0,0,1,0,0,0,1,0.125
cfo,0,0,0,1,0,0,0,1,0.125
csi相位信息,0,0,0,1,0,0,0,1,0.125
时间常量,0,0,0,1,0,0,0,1,0.125
网卡,0,0,0,1,0,0,0,1,0.125
高斯噪声,0,0,0,1,0,0,0,1,0.125
常数,0,0,0,1,0,2,0,3,0.6083333333333334
lzcsi,0,0,0,1,0,0,0,1,0.125
采样时钟时间偏移,0,0,0,1,0,0,0,1,0.125
采样时钟频率偏移,0,0,0,1,0,0,0,1,0.125
载波,0,0,0,1,0,0,0,1,0.125
additivewhitegaus,0,0,0,1,0,0,0,1,0.125
加性高斯白噪声,0,0,0,1,0,0,0,1,0.125
相位偏移,0,0,0,1,0,0,0,1,0.125
振荡器,0,0,0,1,0,0,0,1,0.125
phaselockedloop,0,0,0,1,0,0,0,1,0.125
锁相环,0,0,0,1,0,0,0,1,0.125
数据点,0,0,0,1,0,0,0,1,0.125
时域样本,0,0,0,1,0,0,0,1,0.125
采样时间,0,0,0,1,1,0,0,2,0.3666666666666667
发射端,0,0,2,4,4,2,0,12,2.2
samplingfrequency,0,0,0,1,0,0,0,1,0.125
采样频率偏移,0,0,0,1,0,0,0,1,0.125
carrierfrequency,0,0,0,1,0,0,0,1,0.125
载波频率偏移,0,0,0,1,0,0,0,1,0.125
长度,0,0,0,1,0,0,0,1,0.125
数据符号,0,0,0,1,0,0,0,1,0.125
总长度,0,0,0,1,0,0,0,1,0.125
ofdm符号,0,0,0,1,0,0,0,1,0.125
csk,0,0,0,1,0,0,0,1,0.125
zcsit,0,0,0,1,0,0,0,1,0.125
噪音,0,0,0,1,0,1,0,2,0.3666666666666667
软件,0,0,0,1,0,0,0,1,0.125
硬件,0,0,1,1,0,0,0,2,0.25
wi-fi系统,0,0,0,1,0,0,0,1,0.125
原始幅度数据,0,0,0,1,0,0,0,1,0.125
阈值,0,0,0,1,0,0,0,1,0.125
有限差分,0,0,0,1,0,0,0,1,0.125
meanabsolutedeviation,0,0,0,1,0,0,0,1,0.125
平均绝对偏差,0,0,0,1,0,0,0,1,0.125
csi幅度曲线,0,0,0,1,0,0,0,1,0.125
波动过程,0,0,0,1,0,0,0,1,0.125
曲线,0,0,0,1,0,0,0,1,0.125
震荡曲线,0,0,0,1,0,0,0,1,0.125
直线,0,0,0,1,0,0,0,1,0.125
静态环境,0,0,0,1,0,0,0,1,0.125
4csi幅度,0,0,0,1,0,0,0,1,0.125
多径特性,0,0,0,1,0,0,0,1,0.125
无线信道,0,0,2,2,0,0,0,4,0.5
幅度信息,0,0,0,1,0,0,0,1,0.125
有效带宽,0,0,1,1,0,0,0,2,0.25
信道聚合,0,0,0,1,0,0,0,1,0.125
感知性能,0,0,0,1,0,1,0,2,0.3666666666666667
传输系统,0,0,0,1,0,0,0,1,0.125
wi-fi网络,0,0,0,1,0,0,0,1,0.125
细粒度wi-fi,0,0,0,1,0,0,0,1,0.125
大信道带宽,0,0,0,1,0,0,0,1,0.125
pdp分辨率,0,0,0,1,0,0,0,1,0.125
样本频率,0,0,0,1,0,0,0,1,0.125
at,0,0,0,1,0,0,0,1,0.125
数据点数,0,0,0,1,0,0,0,1,0.125
窗口长度,0,0,0,1,0,0,0,1,0.125
时间序列,0,0,0,3,0,0,0,3,0.375
多路径,0,0,0,1,0,0,0,1,0.125
多径信道特征,0,0,0,1,0,0,0,1,0.125
到达信号,0,0,0,1,0,0,0,1,0.125
路径,0,0,1,2,0,0,0,3,0.375
发送端,0,0,0,1,2,0,0,3,0.6083333333333334
狄克拉脉冲函数,0,0,0,1,0,0,0,1,0.125
iertransform,0,0,0,1,0,0,0,1,0.125
inversefa,0,0,0,1,0,0,0,1,0.125
逆傅里叶变换,0,0,0,1,0,0,0,1,0.125
powerdelayprofile,0,0,1,1,0,0,0,2,0.25
channelstateinformation,1,0,1,1,0,0,0,3,1.25
功率时延分布,0,0,1,2,0,0,0,3,0.375
情景感知网络,0,0,0,0,0,8,0,8,1.9333333333333333
偏置,0,0,0,1,3,3,0,7,1.575
观测网络,0,0,0,0,0,3,0,3,0.725
策略网络,0,0,0,0,0,3,0,3,0.725
特征向量,0,0,0,0,0,3,0,3,0.725
pca,0,0,0,0,0,3,0,3,0.725
隐藏状态,0,0,0,0,0,2,0,2,0.48333333333333334
wi-fi环,0,0,0,0,0,2,0,2,0.48333333333333334
零均值,0,0,0,0,0,2,0,2,0.48333333333333334
gma,0,0,0,0,0,1,0,1,0.24166666666666667
动作概率分布,0,0,0,0,0,1,0,1,0.24166666666666667
max,0,0,0,0,0,1,0,1,0.24166666666666667
动作兔,0,0,0,0,0,1,0,1,0.24166666666666667
softmax激活函数,0,0,0,0,1,1,0,2,0.48333333333333334
参数血,0,0,0,0,0,1,0,1,0.24166666666666667
序列信息,0,0,0,0,0,1,0,1,0.24166666666666667
lstm层,0,0,0,0,0,1,0,1,0.24166666666666667
隐藏信息,0,0,0,0,0,1,0,1,0.24166666666666667
lstm模型,0,0,0,3,0,1,0,4,0.6166666666666667
多层,0,0,0,0,0,1,0,1,0.24166666666666667
函数,0,0,0,0,1,1,0,2,0.48333333333333334
线性加权,0,0,0,0,0,1,0,1,0.24166666666666667
t时刻,0,0,0,0,0,1,0,1,0.24166666666666667
目标行为特征,0,0,0,0,0,1,0,1,0.24166666666666667
wi-fi环境信息,0,0,0,0,0,1,0,1,0.24166666666666667
历史状态,0,0,0,0,0,1,0,1,0.24166666666666667
观察网络,0,0,0,0,0,1,0,1,0.24166666666666667
网络,0,0,0,1,0,4,0,5,1.0916666666666668
微小位移,0,0,0,0,0,1,0,1,0.24166666666666667
标准差,0,0,0,0,0,1,0,1,0.24166666666666667
均值,0,0,0,0,0,1,0,1,0.24166666666666667
csi流込,0,0,0,0,0,1,0,1,0.24166666666666667
去噪csi数据流,0,0,0,0,0,1,0,1,0.24166666666666667
azhj,0,0,0,0,0,1,0,1,0.24166666666666667
冗余噪声,0,0,0,0,0,1,0,1,0.24166666666666667
去噪,0,0,0,0,0,1,0,1,0.24166666666666667
azhz,0,0,0,0,0,1,0,1,0.24166666666666667
az,0,0,0,0,0,1,0,1,0.24166666666666667
csi相位数据,0,0,0,0,0,1,0,1,0.24166666666666667
相位数据,0,0,0,0,0,1,0,1,0.24166666666666667
幅度数据,0,0,0,0,0,1,0,1,0.24166666666666667
节点,0,0,0,3,2,0,0,5,0.8583333333333334
加权,0,0,0,0,2,1,0,3,0.725
感知机,0,0,0,0,2,0,0,2,0.48333333333333334
协同适应,0,0,0,0,1,0,0,1,0.24166666666666667
dropout机制,0,0,0,0,1,0,0,1,0.24166666666666667
adaptivemomentestimation,0,0,0,0,1,0,0,1,0.24166666666666667
最小化损失函数,0,0,0,0,1,0,0,1,0.24166666666666667
errorbackpropagation,0,0,0,0,1,0,0,1,0.24166666666666667
误差反向传播算法,0,0,0,0,1,1,0,2,0.48333333333333334
损失函数,0,0,0,0,1,3,0,4,0.9666666666666667
模型,0,0,0,1,2,0,0,3,0.6083333333333334
真值,0,0,0,0,1,0,0,1,0.24166666666666667
交叉癇损失函数,0,0,0,0,1,0,0,1,0.24166666666666667
输出层,0,0,0,3,1,0,0,4,0.6166666666666667
zk,0,0,0,0,1,0,0,1,0.24166666666666667
分类,0,0,0,0,1,0,0,1,0.24166666666666667
感知器,0,0,0,0,1,0,0,1,0.24166666666666667
非线性关,0,0,0,0,1,0,0,1,0.24166666666666667
全连通层,0,0,0,0,1,0,0,1,0.24166666666666667
分类任,0,0,0,0,1,0,0,1,0.24166666666666667
数据降维,0,0,0,0,1,0,0,1,0.24166666666666667
池化函数,0,0,0,0,1,0,0,1,0.24166666666666667
空间不变性,0,0,0,0,1,0,0,1,0.24166666666666667
池化窗口,0,0,0,0,1,0,0,1,0.24166666666666667
窗函数,0,0,0,0,1,0,0,1,0.24166666666666667
池化层函数,0,0,0,0,1,0,0,1,0.24166666666666667
局部特征,0,0,0,0,1,0,0,1,0.24166666666666667
离散卷积运算,0,0,0,0,1,0,0,1,0.24166666666666667
运算,0,0,0,0,1,0,0,1,0.24166666666666667
rectifiedlinear,0,0,0,0,1,0,0,1,0.24166666666666667
线性整流函数,0,0,0,0,1,0,0,1,0.24166666666666667
滤波器,0,0,0,0,1,0,0,1,0.24166666666666667
卷积层函数,0,0,0,0,1,0,0,1,0.24166666666666667
滤波权重,0,0,0,0,1,0,0,1,0.24166666666666667
时空特征,0,0,0,0,1,0,0,1,0.24166666666666667
化层,0,0,0,0,1,0,0,1,0.24166666666666667
最大,0,0,0,0,1,0,0,1,0.24166666666666667
深度学习模型,0,0,0,0,1,0,0,1,0.24166666666666667
数据包,0,0,0,0,6,1,0,7,1.6916666666666667
tx,0,0,0,0,5,0,0,5,1.2083333333333333
聚合,0,0,0,0,4,0,0,4,0.9666666666666667
超时时间,0,0,0,0,2,0,0,2,0.48333333333333334
快速信道,0,0,0,0,2,0,0,2,0.48333333333333334
csicj,0,0,0,0,1,0,0,1,0.24166666666666667
聚合csici,0,0,0,0,1,0,0,1,0.24166666666666667
csic,0,0,0,0,1,0,0,1,0.24166666666666667
ackthen,0,0,0,0,1,0,0,1,0.24166666666666667
iftx,0,0,0,0,1,0,0,1,0.24166666666666667
ack,0,0,0,0,1,0,0,1,0.24166666666666667
ifrx,0,0,0,0,1,0,0,1,0.24166666666666667
套接字,0,0,0,0,1,0,0,1,0.24166666666666667
whiletx,0,0,0,0,1,0,0,1,0.24166666666666667
待选信道,0,0,0,0,1,0,0,1,0.24166666666666667
扩展信,0,0,0,0,1,0,0,1,0.24166666666666667
数据传输,0,0,0,0,1,0,0,1,0.24166666666666667
重传机,0,0,0,0,1,0,0,1,0.24166666666666667
同步传输,0,0,0,0,1,0,0,1,0.24166666666666667
csi聚合,0,0,0,0,1,0,0,1,0.24166666666666667
报文,0,0,0,0,1,0,0,1,0.24166666666666667
无线环,0,0,0,0,1,0,0,1,0.24166666666666667
同步,0,0,0,0,1,0,0,1,0.24166666666666667
切换信道,0,0,0,0,1,0,0,1,0.24166666666666667
wifi链路,0,0,0,0,0,1,0,1,0.24166666666666667
强化学习技术,0,0,1,1,0,0,0,2,0.25
信道状态信息,0,0,2,2,0,0,0,4,0.5
状态信息,1,0,2,1,0,0,0,4,1.375
reinforce算法,0,0,0,5,0,2,0,7,1.1083333333333334
目标函数,0,0,0,3,0,1,0,4,0.6166666666666667
梯度,0,0,0,3,0,3,0,6,1.1
累积奖励,0,0,0,3,0,0,0,3,0.375
ndo,0,0,0,2,0,0,0,2,0.25
m条序列,0,0,0,2,0,0,0,2,0.25
策略梯度,0,0,0,2,0,1,0,3,0.4916666666666667
q函数,0,0,0,2,0,0,0,2,0.25
sna1,0,0,0,1,0,0,0,1,0.125
状态si,0,0,0,1,0,0,0,1,0.125
初始化状态,0,0,0,1,0,0,0,1,0.125
forepisode,0,0,0,1,0,0,0,1,0.125
迭代次数,0,0,0,1,0,0,0,1,0.125
无偏估计,0,0,0,1,0,0,0,1,0.125
价值函数,0,0,0,1,0,0,0,1,0.125
=号器,0,0,0,1,0,0,0,1,0.125
velogp,0,0,0,1,0,0,0,1,0.125
xtp,0,0,0,1,0,0,0,1,0.125
导数,0,0,0,1,0,0,0,1,0.125
梯度上升,0,0,0,1,0,0,0,1,0.125
etp,0,0,0,1,0,0,0,1,0.125
累积回报,0,0,0,1,0,0,0,1,0.125
序列,0,0,0,4,1,0,0,5,0.7416666666666667
贝尔曼方程,0,0,0,1,0,0,0,1,0.125
折扣因子,0,0,0,1,0,1,0,2,0.3666666666666667
q-valuefunction,0,0,0,1,0,0,0,1,0.125
动作价值函数,0,0,0,1,0,0,0,1,0.125
状态s,0,0,0,1,0,0,0,1,0.125
强化学习环境,0,0,0,1,0,0,0,1,0.125
频率粒度,0,0,0,0,2,0,0,2,0.48333333333333334
活动样本,0,0,0,0,2,0,0,2,0.48333333333333334
采样率,0,0,0,0,2,0,0,2,0.48333333333333334
频率范围,0,0,0,0,1,0,0,1,0.24166666666666667
频率分量,0,0,0,0,1,0,0,1,0.24166666666666667
样本数据,0,0,0,0,1,0,0,1,0.24166666666666667
样本数量,0,0,0,0,1,0,0,1,0.24166666666666667
数据处理,0,0,0,0,1,0,0,1,0.24166666666666667
实验环境,0,0,0,0,1,0,0,1,0.24166666666666667
训练集,0,0,0,0,1,1,0,2,0.48333333333333334
样本,0,0,0,0,1,2,0,3,0.725
时间序列数据包,0,0,0,0,1,0,0,1,0.24166666666666667
星形,0,0,0,0,1,0,0,1,0.24166666666666667
txtransmitter,0,0,0,0,1,0,0,1,0.24166666666666667
切换时间,0,0,0,0,1,0,0,1,0.24166666666666667
聚合csl,0,0,0,0,1,0,0,1,0.24166666666666667
5ghzwi-fi信道,0,0,0,0,1,0,0,1,0.24166666666666667
lorcon,0,0,0,0,1,0,0,1,0.24166666666666667
子载波数,0,0,1,0,1,0,0,2,0.3666666666666667
5300网卡,0,0,0,0,1,0,0,1,0.24166666666666667
intel5300无线网卡,0,0,0,0,1,0,0,1,0.24166666666666667
小主机,0,0,0,0,1,3,0,4,0.9666666666666667
rnn,0,0,0,8,0,0,0,8,1.0
存储单元,0,0,0,3,0,0,0,3,0.375
门控,0,0,0,2,0,0,0,2,0.25
sigmoid,0,0,0,2,0,0,0,2,0.25
隐藏层结构,0,0,0,3,0,0,0,3,0.375
帧信息,0,0,0,2,0,0,0,2,0.25
神经元,0,0,0,2,0,0,0,2,0.25
隐藏层,0,0,0,3,0,0,0,3,0.375
时间特征,0,0,0,1,0,0,0,1,0.125
目标状态信息,0,0,0,1,0,0,0,1,0.125
上下文信息,0,0,0,1,0,0,0,1,0.125
放缩,0,0,0,1,0,0,0,1,0.125
tcm/i,0,0,0,1,0,0,0,1,0.125
控制,0,0,0,1,0,0,0,1,0.125
门控5,0,0,0,1,0,0,0,1,0.125
选择性遗忘,0,0,0,1,0,0,0,1,0.125
遗忘阶段,0,0,0,1,0,0,0,1,0.125
记忆阶,0,0,0,1,0,0,0,1,0.125
门控状态,0,0,0,1,0,0,0,1,0.125
拼接向量,0,0,0,1,0,0,0,1,0.125
血加,0,0,0,1,0,0,0,1,0.125
ftosi,0,0,0,1,0,0,0,1,0.125
lstm单元,0,0,0,1,0,0,0,1,0.125
门结构,0,0,0,1,0,0,0,1,0.125
输出门,0,0,0,1,0,0,0,1,0.125
存储单元耳,0,0,0,1,0,0,0,1,0.125
遗忘门,0,0,0,1,0,0,0,1,0.125
输入门,0,0,0,1,0,0,0,1,0.125
输入层,0,0,0,3,0,0,0,3,0.375
记忆能力,0,0,0,1,0,0,0,1,0.125
longshort-termmemory,0,0,0,1,0,0,0,1,0.125
长短期记忆网络,0,0,0,1,0,0,0,1,0.125
学习能力,0,0,0,1,0,1,0,2,0.3666666666666667
隐藏层神经元,0,0,0,1,0,0,0,1,0.125
图像序列,0,0,0,1,0,0,0,1,0.125
递归神经网络,0,0,0,1,0,0,0,1,0.125
recurrentneuralnet,0,0,0,1,0,0,0,1,0.125
循环神经网络,0,0,0,1,0,0,0,1,0.125
长短期记忆网络模型,0,0,0,1,0,0,0,1,0.125
智能,0,0,1,0,0,1,0,2,0.3666666666666667
动目标状态,0,0,0,0,0,1,0,1,0.24166666666666667
决策算法,0,0,0,0,0,1,0,1,0.24166666666666667
干扰,0,0,0,0,0,1,0,1,0.24166666666666667
质量,0,0,0,0,0,1,0,1,0.24166666666666667
无线链路,0,0,0,0,0,1,0,1,0.24166666666666667
信息量,0,0,0,0,0,2,0,2,0.48333333333333334
通信质量,0,0,0,0,0,1,0,1,0.24166666666666667
购物,0,0,0,0,0,1,0,1,0.24166666666666667
密集wi.fi场,0,0,0,0,0,1,0,1,0.24166666666666667
池化,0,0,0,2,0,0,0,2,0.25
局部感知,0,0,0,2,0,0,0,2,0.25
图像数据,0,0,0,2,0,0,0,2,0.25
建模过程,0,0,0,1,0,0,0,1,0.125
目标行为模型,0,0,0,1,0,0,0,1,0.125
图像处理,0,0,0,1,0,0,0,1,0.125
时频变换,0,0,0,1,0,0,0,1,0.125
变形,0,0,0,1,0,0,0,1,0.125
平移,0,0,0,1,0,0,0,1,0.125
缩放,0,0,0,1,0,0,0,1,0.125
计算量,0,0,0,1,0,0,0,1,0.125
图像规模,0,0,0,1,0,0,0,1,0.125
数量级,0,0,0,1,0,0,0,1,0.125
局部连接,0,0,0,1,0,0,0,1,0.125
全连接,0,0,0,1,0,0,0,1,0.125
计算速度,0,0,0,1,0,0,0,1,0.125
卷积核数,0,0,0,1,0,0,0,1,0.125
卷积核,0,0,0,1,0,0,0,1,0.125
权重共享,0,0,0,1,0,0,0,1,0.125
权值共享,0,0,0,1,0,0,0,1,0.125
识别结果,0,0,0,1,0,0,0,1,0.125
多维数据,0,0,0,1,0,0,0,1,0.125
多层感知机,0,0,0,1,0,0,0,1,0.125
活动类别,0,0,0,1,0,0,0,1,0.125
网络结构,0,0,0,1,0,0,0,1,0.125
特征提取过程,0,0,0,1,0,0,0,1,0.125
多维图像,0,0,0,1,0,0,0,1,0.125
映射模型,0,0,0,1,0,0,0,1,0.125
图像像素,0,0,0,1,0,0,0,1,0.125
活动特征,0,0,0,1,0,1,0,2,0.3666666666666667
cnn模型,0,0,0,1,0,0,0,1,0.125
语音信号处理,0,0,0,1,0,0,0,1,0.125
自然语言处理,0,0,0,1,0,0,0,1,0.125
计算机视觉,0,0,1,1,0,0,0,2,0.25
内在特征,0,0,0,1,0,0,0,1,0.125
分类任务,0,0,0,1,0,0,0,1,0.125
预测任务,0,0,0,1,0,0,0,1,0.125
深层信息,0,0,0,1,0,0,0,1,0.125
信息特征,0,0,0,1,0,0,0,1,0.125
自主学习图像,0,0,0,1,0,0,0,1,0.125
卷积运算,0,0,0,1,0,0,0,1,0.125
隐含层网络,0,0,0,1,0,0,0,1,0.125
分析,0,0,0,1,0,0,0,1,0.125
图片处理,0,0,0,1,0,0,0,1,0.125
图像识别,0,0,0,1,0,0,0,1,0.125
convolutionneuralnet,0,0,0,1,0,0,0,1,0.125
卷积神经网络,0,0,0,1,0,0,0,1,0.125
算法,0,0,0,1,0,0,0,1,0.125
深度学习技术,0,0,0,1,0,0,0,1,0.125
卷积神经网络模型,0,0,0,1,0,0,0,1,0.125
网络参数,0,0,0,0,0,2,0,2,0.48333333333333334
性能倒退,0,0,0,0,0,1,0,1,0.24166666666666667
反向传播梯度,0,0,0,0,0,1,0,1,0.24166666666666667
模型训,0,0,0,0,0,1,0,1,0.24166666666666667
手动标注链路,0,0,0,0,0,1,0,1,0.24166666666666667
用户行为特征,0,0,0,0,0,2,0,2,0.48333333333333334
噪声干扰,0,0,0,0,0,1,0,1,0.24166666666666667
用户行为信息,0,0,0,0,0,1,0,1,0.24166666666666667
动态智能选择机制,1,0,0,0,0,1,0,2,1.2416666666666667
链路数,0,0,0,0,0,1,0,1,0.24166666666666667
感知应用,0,0,0,1,0,0,0,1,0.125
天线数,0,0,0,1,0,0,0,1,0.125
mrx,0,0,0,1,0,0,0,1,0.125
n磁,0,0,0,1,0,0,0,1,0.125
csito,0,0,0,1,0,0,0,1,0.125
动目标,0,0,0,1,0,0,0,1,0.125
机器学习算法,0,0,0,1,0,0,0,1,0.125
数学建模,0,0,0,1,0,0,0,1,0.125
传播信息,0,0,0,1,0,0,0,1,0.125
频率响应,0,0,0,1,0,0,0,1,0.125
运动,0,0,1,1,0,0,0,2,0.25
wifi环境,0,0,0,1,0,0,0,1,0.125
cfr样本,0,0,0,1,0,0,0,1,0.125
采样分辨率,0,0,0,1,0,0,0,1,0.125
传播时延,0,0,0,1,0,0,0,1,0.125
幅度衰减,0,0,0,1,0,0,0,1,0.125
路径总数,0,0,0,1,0,0,0,1,0.125
离散样本集,0,0,0,1,0,0,0,1,0.125
cfr,0,0,0,1,0,0,0,1,0.125
频域角度,0,0,0,1,0,0,0,1,0.125
po,0,0,0,1,0,0,0,1,0.125
channelfrequency,0,0,0,1,0,0,0,1,0.125
信道频率响应,0,0,0,1,0,0,0,1,0.125
叠加信号,0,0,0,1,0,0,0,1,0.125
散射,0,0,0,1,0,0,0,1,0.125
反射,0,0,0,1,0,0,0,1,0.125
直射,0,0,0,1,0,0,0,1,0.125
步长,0,0,0,0,0,7,0,7,1.6916666666666667
dropout层,0,0,0,0,0,3,0,3,0.725
情境感知网络,0,0,0,0,0,2,0,2,0.48333333333333334
勺分类网络,0,0,0,0,0,1,0,1,0.24166666666666667
dwt图像,0,0,0,0,0,1,0,1,0.24166666666666667
真实样本,0,0,0,0,0,1,0,1,0.24166666666666667
多设备协作,0,0,0,0,0,1,0,1,0.24166666666666667
csitool,0,0,0,0,0,1,0,1,0.24166666666666667
wi・fi发射端,0,0,0,0,0,1,0,1,0.24166666666666667
t-sne嵌入,0,0,0,0,0,4,0,4,0.9666666666666667
output,0,0,0,0,0,3,0,3,0.725
t-sneembedd,0,0,0,0,0,3,0,3,0.725
可视化,0,0,0,0,0,2,0,2,0.48333333333333334
t-sne算法,0,0,0,0,0,2,0,2,0.48333333333333334
时间复杂度,0,0,0,0,0,1,0,1,0.24166666666666667
算复杂度,0,0,0,0,0,1,0,1,0.24166666666666667
设备,0,0,1,0,0,1,0,2,0.3666666666666667
人体感知技术,0,0,0,0,0,1,0,1,0.24166666666666667
用户,0,0,0,0,0,1,0,1,0.24166666666666667
智能决策,0,0,0,0,0,1,0,1,0.24166666666666667
期望回报,0,0,0,0,0,1,0,1,0.24166666666666667
用户行为,0,0,0,0,0,1,0,1,0.24166666666666667
walk,0,0,0,0,0,1,0,1,0.24166666666666667
图形,0,0,0,0,0,1,0,1,0.24166666666666667
高维数据,0,0,0,0,0,1,0,1,0.24166666666666667
人类活动关联特性,0,0,0,0,0,1,0,1,0.24166666666666667
有效链路,0,0,0,0,0,1,0,1,0.24166666666666667
数据可视化,0,0,0,0,0,1,0,1,0.24166666666666667
wi-fi网卡驱动,0,0,0,0,1,0,0,1,0.24166666666666667
wi-fi信道带宽,0,0,0,0,1,0,0,1,0.24166666666666667
w-fi,0,0,0,0,1,0,0,1,0.24166666666666667
多径长度分辨率,0,0,0,0,1,0,0,1,0.24166666666666667
分米级,0,0,0,0,1,0,0,1,0.24166666666666667
细粒度,0,0,2,0,1,0,0,3,0.4916666666666667
传输信号,0,0,0,0,1,0,0,1,0.24166666666666667
到达时间,0,0,0,0,1,0,0,1,0.24166666666666667
映射关,0,0,1,0,0,0,0,1,0.125
特征提,0,0,1,0,0,0,0,1,0.125
跨位置活动,0,0,1,0,0,0,0,1,0.125
系统模型,0,0,1,0,0,0,0,1,0.125
行为感知分辨率提升机,1,0,1,0,0,0,0,2,1.125
reinforcementlear,0,0,1,0,0,0,0,1,0.125
wifi,0,0,1,0,0,0,0,1,0.125
wlan,0,0,4,0,0,0,0,4,0.5
机器,1,0,4,0,0,0,0,5,1.5
无线网络,0,0,3,0,0,0,0,3,0.375
非视距感知,0,0,3,0,0,0,0,3,0.375
障碍物,0,0,3,0,0,0,0,3,0.375
智能家居,0,0,3,0,0,0,0,3,0.375
定位精度,0,0,2,0,0,0,0,2,0.25
通信,0,0,2,0,0,0,0,2,0.25
智能手机,0,0,2,0,0,0,0,2,0.25
平板电脑,0,0,2,0,0,0,0,2,0.25
笔记本电脑,0,0,2,0,0,0,0,2,0.25
附加设备,0,0,2,0,0,0,0,2,0.25
红外线,0,0,2,0,0,0,0,2,0.25
红外线技,0,0,2,0,0,0,0,2,0.25
计算机视觉技术,0,0,2,0,0,0,0,2,0.25
人机交互,0,0,2,0,0,0,0,2,0.25
多信道扩展技术,0,0,1,0,0,0,0,1,0.125
wi-fi多信道,0,0,1,0,0,0,0,1,0.125
亚米精度,0,0,1,0,0,0,0,1,0.125
室内定位系统,0,0,1,0,0,0,0,1,0.125
tonetrack,0,0,1,0,0,0,0,1,0.125
cir估计,0,0,1,0,0,0,0,1,0.125
信道稀疏性,0,0,1,0,0,0,0,1,0.125
多信道cfr,0,0,1,0,0,0,0,1,0.125
附加系统,0,0,1,0,0,0,0,1,0.125
mimo平滑技术,0,0,1,0,0,0,0,1,0.125
mimo平滑新,0,0,1,0,0,0,0,1,0.125
频率分集,0,0,1,0,0,0,0,1,0.125
空间分集,0,0,1,0,0,0,0,1,0.125
接收机,0,0,1,0,0,0,0,1,0.125
mimo发射机,0,0,1,0,0,0,0,1,0.125
非线性回归传播模型,0,0,1,0,0,0,0,1,0.125
非视距识别,0,0,1,0,0,0,0,1,0.125
识别精度,0,0,1,0,0,0,0,1,0.125
数据吞吐量,0,0,1,0,0,0,0,1,0.125
wi-fiap,0,0,1,0,0,0,0,1,0.125
固定天线,0,0,1,0,0,0,0,1,0.125
接口,0,0,1,0,0,0,0,1,0.125
linux内核,0,0,1,0,0,0,0,1,0.125
缝合天线,0,0,1,0,0,0,0,1,0.125
呼吸速率,0,0,1,0,0,0,0,1,0.125
相位差数据,0,0,1,0,0,0,0,1,0.125
rf,0,0,1,0,0,0,0,1,0.125
轨迹,0,0,1,0,0,0,0,1,0.125
目标速度,0,0,1,0,0,0,0,1,0.125
angle,0,0,1,0,0,0,0,1,0.125
到达角,0,0,1,0,0,0,0,1,0.125
时空多普勒,0,0,1,0,0,0,0,1,0.125
indotrack,0,0,1,0,0,0,0,1,0.125
速度,0,0,1,0,0,0,0,1,0.125
移动速度,0,0,1,0,0,0,0,1,0.125
分米,0,0,1,0,0,0,0,1,0.125
多普勒频移,0,0,1,0,0,0,0,1,0.125
手指手势,0,0,1,0,0,0,0,1,0.125
wifinger,0,0,1,0,0,0,0,1,0.125
跌倒检测,0,0,1,0,0,0,0,1,0.125
wifall,0,0,1,0,0,0,0,1,0.125
按键识别系统,0,0,1,0,0,0,0,1,0.125
wikey,0,0,1,0,0,0,0,1,0.125
多径传播能力,0,0,1,0,0,0,0,1,0.125
商用设备,0,0,1,0,0,0,0,1,0.125
无线通信,0,0,1,0,0,0,0,1,0.125
wi-fi协议,0,0,1,0,0,0,0,1,0.125
穿透效果,0,0,1,0,0,0,0,1,0.125
墙体,0,0,1,0,0,0,0,1,0.125
wi-fi频段,0,0,1,0,0,0,0,1,0.125
无线网卡,0,0,1,0,0,0,0,1,0.125
行为分析,0,0,1,0,0,0,0,1,0.125
属性,0,0,1,0,0,0,0,1,0.125
行为感知应用,0,0,1,0,0,0,0,1,0.125
人体检测,0,0,1,0,0,0,0,1,0.125
生理指标检测,0,0,1,0,0,0,0,1,0.125
目标追踪,0,0,1,0,0,0,0,1,0.125
rig,0,0,1,0,0,0,0,1,0.125
无线局域网,0,0,1,0,0,0,0,1,0.125
无线通信技术,0,0,1,0,0,0,0,1,0.125
网络技术,0,0,1,0,0,0,0,1,0.125
专用传感器设备,0,0,1,0,0,0,0,1,0.125
动作信息,0,0,1,0,0,0,0,1,0.125
加速器,0,0,1,0,0,0,0,1,0.125
陀螺仪,0,0,1,0,0,0,0,1,0.125
传感器设备,0,0,1,0,0,0,0,1,0.125
专用传感器技,0,0,1,0,0,0,0,1,0.125
工作环境,0,0,1,0,0,0,0,1,0.125
家庭环境,0,0,1,0,0,0,0,1,0.125
专用设备,0,0,1,0,0,0,0,1,0.125
穿墙,0,0,1,0,0,0,0,1,0.125
雷达,0,0,1,0,0,0,0,1,0.125
微波雷达,0,0,1,0,0,0,0,1,0.125
毫米波,0,0,1,0,0,0,0,1,0.125
毫米波技,0,0,1,0,0,0,0,1,0.125
距离因素,0,0,1,0,0,0,0,1,0.125
目标信息,0,0,1,0,0,0,0,1,0.125
光线,0,0,1,0,0,0,0,1,0.125
手势,0,0,1,0,0,0,0,1,0.125
人体,0,0,1,0,0,0,0,1,0.125
动态变化特征,0,0,1,0,0,0,0,1,0.125
活动序列,0,0,1,0,0,0,0,1,0.125
视频信息,0,0,1,0,0,0,0,1,0.125
图像信息,0,0,1,0,0,0,0,1,0.125
摄像头,0,0,1,0,0,0,0,1,0.125
人工,0,0,1,0,0,0,0,1,0.125
智能化,0,0,1,0,0,0,0,1,0.125
群体感知,0,0,1,0,0,0,0,1,0.125
身份认证,0,0,1,0,0,0,0,1,0.125
运动分析,0,0,1,0,0,0,0,1,0.125
宠物行为监测,0,0,1,0,0,0,0,1,0.125
健康监控,0,0,1,0,0,0,0,1,0.125
老年人,0,0,1,0,0,0,0,1,0.125
体感游戏,0,0,1,0,0,0,0,1,0.125
国防安全,0,0,1,0,0,0,0,1,0.125
目标行为感知系统,0,0,1,0,0,0,0,1,0.125
损失,0,0,0,0,0,5,0,5,1.2083333333333333
类别,0,0,0,0,0,1,0,1,0.24166666666666667
二进制交叉矯损失,0,0,0,0,0,1,0,1,0.24166666666666667
行为标签,0,0,0,0,0,1,0,1,0.24166666666666667
条链路,0,0,0,0,0,1,0,1,0.24166666666666667
二元交叉爛,0,0,0,0,0,1,0,1,0.24166666666666667
蒙特卡罗,0,0,0,0,0,1,0,1,0.24166666666666667
样本数,0,0,0,0,0,1,0,1,0.24166666666666667
ologn,0,0,0,0,0,1,0,1,0.24166666666666667
蒙特卡罗采样法,0,0,0,0,0,1,0,1,0.24166666666666667
位移,0,0,0,0,0,1,0,1,0.24166666666666667
长期折扣回报,0,0,0,0,0,1,0,1,0.24166666666666667
第t时刻,0,0,0,0,0,1,0,1,0.24166666666666667
折扣回报,0,0,0,0,0,1,0,1,0.24166666666666667
分布,0,0,0,0,0,1,0,1,0.24166666666666667
置信度,0,0,0,0,0,1,0,1,0.24166666666666667
Wi-Fi信道状态信息,0,1,0,0,0,0,0,1,2.0
信道切换和聚合,0,1,0,0,0,0,0,1,2.0
最优链路选择,0,1,0,0,0,0,0,1,2.0
感知分辨率,2,0,0,0,0,0,0,2,2.0
环境条件,1,0,0,0,0,0,0,1,1.0
多wi-fi设备,1,0,0,0,0,0,0,1,1.0
学习智能,1,0,0,0,0,0,0,1,1.0
多wifi设备,1,0,0,0,0,0,0,1,1.0
近似性能,1,0,0,0,0,0,0,1,1.0
聚合带宽,1,0,0,0,0,0,0,1,1.0
动物,1,0,0,0,0,0,0,1,1.0
