,摘要,关键词,第一章,第二章,第三章,第四章,第五章,总词频,加权得分
北斗地面站,0,0,6,2,26,15,2,51,11.391666666666667
距离隔离,0,0,6,0,28,2,3,39,8.725
imt基站,0,0,5,1,35,14,1,56,12.833333333333334
aclr,0,0,3,2,35,0,0,40,9.083333333333334
频率隔离,0,0,6,0,36,5,3,50,11.383333333333333
干扰,1,0,11,15,33,28,3,91,19.71666666666667
干扰概率,0,0,0,1,17,17,0,35,8.341666666666667
频率隔离度,0,0,6,0,11,5,0,22,4.616666666666667
被仿真系统,0,0,0,5,8,0,0,13,2.5583333333333336
快照,0,0,0,6,8,0,0,14,2.6833333333333336
距离隔离度,0,0,1,0,5,0,0,6,1.3333333333333333
基站,0,0,1,0,19,40,1,61,14.625
快照仿真,0,0,0,6,6,0,0,12,2.2
初始化,0,0,0,2,6,0,0,8,1.7
imt系统,0,0,10,3,28,2,4,47,9.841666666666667
性能,0,0,1,8,4,1,0,14,2.333333333333333
收发天线模型,0,0,0,0,3,0,0,3,0.725
共存,0,0,4,1,12,0,3,20,4.25
aclr指标,0,0,0,0,2,0,0,2,0.48333333333333334
地面站,0,0,5,2,7,7,1,22,4.5
北斗卫星导航系统,3,0,28,10,10,2,6,59,12.1
滤波器特性,0,0,2,0,6,1,0,9,1.9416666666666667
共存准则,0,0,0,0,1,0,0,1,0.24166666666666667
干扰概率曲线,0,0,0,0,5,2,0,7,1.6916666666666667
aclr值,0,0,0,0,7,0,0,7,1.6916666666666667
timt,0,0,0,0,1,0,0,1,0.24166666666666667
aclrtimt基站,0,0,0,0,1,0,0,1,0.24166666666666667
频-r隔离,0,0,0,0,1,0,0,1,0.24166666666666667
频净隔离,0,0,0,0,1,0,0,1,0.24166666666666667
扰橄率曲线,0,0,0,0,1,0,0,1,0.24166666666666667
北斗系统,0,0,2,1,8,0,1,12,2.55
北斗地血站,0,0,0,0,1,0,0,1,0.24166666666666667
仿真快照,0,0,0,0,3,1,0,4,0.9666666666666667
仿ft场景,0,0,0,0,1,0,0,1,0.24166666666666667
北斗地向州系统,0,0,0,0,1,0,0,1,0.24166666666666667
imt基泌,0,0,0,0,1,0,0,1,0.24166666666666667
环境,0,0,0,0,1,0,0,1,0.24166666666666667
宏肉城区,0,0,0,0,1,0,0,1,0.24166666666666667
容量,0,0,0,1,2,0,0,3,0.6083333333333334
用频系统,0,0,0,1,2,0,0,3,0.6083333333333334
配置,0,0,0,1,2,0,0,3,0.6083333333333334
系统保护准则,0,0,0,2,2,0,0,4,0.7333333333333334
干扰概率指标,0,0,0,0,2,0,0,2,0.48333333333333334
快照仿真统,0,0,0,0,2,0,0,2,0.48333333333333334
性能统计,0,0,0,1,2,0,0,3,0.6083333333333334
基站链路,0,0,0,0,1,0,0,1,0.24166666666666667
路径损耗模型,0,0,0,1,2,1,0,4,0.85
天线,0,0,2,0,11,0,0,13,2.908333333333333
共存仿真,0,0,0,1,2,0,0,3,0.6083333333333334
配置模型,0,0,0,0,2,0,0,2,0.48333333333333334
仿真过程,0,0,0,1,2,0,0,3,0.6083333333333334
仿真参数,0,0,0,2,2,0,0,4,0.7333333333333334
衰落,0,0,0,1,2,2,0,5,1.0916666666666668
路径损耗,0,0,4,1,5,4,1,15,3.0416666666666665
网络拓扑,0,0,0,1,5,1,0,7,1.575
地理位置,0,0,0,1,2,0,0,3,0.6083333333333334
确定性分析接口,0,0,0,0,2,0,0,2,0.48333333333333334
北斗系统参数,0,0,0,0,2,0,0,2,0.48333333333333334
发射参数,0,0,0,0,2,0,0,2,0.48333333333333334
系统,2,0,3,8,7,2,3,25,6.275
级仿真分析,0,0,0,0,1,0,0,1,0.24166666666666667
宏蜂窝城区,0,0,0,0,4,0,0,4,0.9666666666666667
隔离,0,0,0,0,1,1,0,2,0.48333333333333334
频率,0,0,1,5,6,1,0,13,2.4416666666666664
距离,0,0,3,0,5,3,0,11,2.3083333333333336
北斗地面站系统,0,0,0,0,1,0,0,1,0.24166666666666667
imt演进系统,1,0,1,0,2,0,0,4,1.6083333333333334
北斗终端,0,0,1,1,31,32,3,68,16.2
路损指数,0,0,0,0,0,8,0,8,1.9333333333333333
发射功率,0,0,0,8,11,8,0,27,5.591666666666667
蒙特卡罗系统级仿真,0,0,0,0,1,5,1,7,1.6916666666666667
lte用户,0,0,0,0,0,10,0,10,2.4166666666666665
lte用户终端,0,0,0,0,0,5,0,5,1.2083333333333333
十扰,0,0,0,0,0,2,0,2,0.48333333333333334
ppp分布,0,0,0,0,0,2,0,2,0.48333333333333334
正六边形,0,0,0,0,0,3,0,3,0.725
ppp理论,0,0,0,0,0,2,1,3,0.725
随机调度算法,0,0,0,0,0,7,0,7,1.6916666666666667
路径指数,0,0,0,0,0,2,0,2,0.48333333333333334
用户终端,0,0,0,0,1,3,1,5,1.2083333333333333
td-lte终端,0,0,0,0,0,2,0,2,0.48333333333333334
干扰北斗终端,0,0,1,0,5,3,0,9,2.0583333333333336
lte基站,0,0,0,0,3,11,0,14,3.3833333333333333
仿真,0,0,0,5,5,5,0,15,3.0416666666666665
干扰分析,0,0,0,1,0,2,0,3,0.6083333333333334
b3链路,0,0,0,0,0,1,0,1,0.24166666666666667
-f扰,0,0,0,0,0,1,0,1,0.24166666666666667
b1链路,0,0,0,0,0,1,0,1,0.24166666666666667
ppp理,0,0,0,0,0,1,0,1,0.24166666666666667
上行终端,0,0,0,0,0,1,0,1,0.24166666666666667
下行基站,0,0,0,0,0,1,0,1,0.24166666666666667
上下行,0,0,0,0,0,1,0,1,0.24166666666666667
正六边形分布,0,0,0,0,0,1,0,1,0.24166666666666667
基站ppp分布,0,0,0,0,0,1,0,1,0.24166666666666667
理论模型,0,0,0,0,0,1,0,1,0.24166666666666667
max-acir调度算法,0,0,0,0,0,4,0,4,0.9666666666666667
参数,0,0,0,3,12,3,1,19,4.241666666666667
曲线,0,0,0,0,0,3,0,3,0.725
max-acir算法,0,0,0,0,0,5,0,5,1.2083333333333333
上行调度算法,0,0,0,0,0,1,0,1,0.24166666666666667
调度算法,0,0,0,0,0,1,0,1,0.24166666666666667
max-acir,0,0,0,0,0,2,1,3,0.725
td-lte,0,0,0,0,4,3,0,7,1.6916666666666667
基姑,0,0,0,0,0,1,0,1,0.24166666666666667
增加幅度,0,0,0,0,0,1,0,1,0.24166666666666667
干扰概率值,0,0,0,0,0,1,0,1,0.24166666666666667
lte干扰终端,0,0,0,0,0,1,0,1,0.24166666666666667
干扰功率,0,0,2,4,3,1,0,10,1.7166666666666668
路径损耗指数,0,0,0,0,0,3,0,3,0.725
干扰变,0,0,0,0,0,1,0,1,0.24166666666666667
随机调度算,0,0,0,0,0,1,0,1,0.24166666666666667
上行功率控制曲线,0,0,0,0,0,1,0,1,0.24166666666666667
lte,0,0,1,0,0,2,0,3,0.6083333333333334
十扰北斗终端,0,0,0,0,1,1,0,2,0.48333333333333334
增幅,0,0,0,0,0,1,0,1,0.24166666666666667
干扰基站,0,0,0,0,0,3,0,3,0.725
干扰场景,0,0,0,1,0,1,0,2,0.3666666666666667
乡村,0,0,0,0,1,1,0,2,0.48333333333333334
城市,0,0,0,0,0,1,0,1,0.24166666666666667
干扰地,0,0,0,0,0,1,0,1,0.24166666666666667
隔离频率,0,0,0,0,4,2,0,6,1.45
td-lte基站,0,0,0,0,0,1,0,1,0.24166666666666667
d-lte基站,0,0,0,0,0,1,0,1,0.24166666666666667
模型,0,0,0,1,0,3,0,4,0.85
仿真流程,0,0,0,1,0,1,1,3,0.6083333333333334
ppp模型,0,0,1,0,0,10,2,13,3.025
干扰分析仿真,0,0,0,0,0,1,0,1,0.24166666666666667
台站,0,0,0,3,0,0,0,3,0.375
最小保护带宽,0,0,0,1,0,0,0,1,0.125
空间隔离距离,0,0,0,2,0,0,0,2,0.25
小空间隔离距离,0,0,0,1,0,0,0,1,0.125
保护带宽,0,0,0,2,0,0,0,2,0.25
邻频系统,2,0,4,1,0,0,2,9,3.1083333333333334
干扰保护准则,0,0,0,6,0,0,1,7,0.9916666666666667
蒙特卡罗仿真,1,0,1,1,0,1,2,6,1.975
保护准则,0,0,2,2,2,1,0,7,1.225
集总干扰,1,0,0,1,1,12,1,16,4.508333333333333
干扰链路,0,0,0,1,0,1,0,2,0.3666666666666667
信道衰落,0,0,0,1,0,0,0,1,0.125
方向,0,0,0,1,0,0,0,1,0.125
收发天线,0,0,0,2,1,1,0,4,0.7333333333333334
系统网络拓扑,0,0,0,1,0,0,0,1,0.125
网络性能,0,0,0,1,0,0,0,1,0.125
系统网络,0,0,0,1,0,0,0,1,0.125
系统级仿真,1,0,1,3,9,0,0,14,3.675
蒙特卡罗,0,0,0,2,0,1,0,3,0.4916666666666667
间隔离度指标,0,0,0,1,0,0,0,1,0.125
兼容,0,0,0,2,0,0,0,2,0.25
强度,0,0,0,1,0,0,0,1,0.125
干扰信号,0,0,0,3,0,0,0,3,0.375
链路模型,0,0,0,1,0,0,0,1,0.125
评估门限,0,0,0,1,0,0,0,1,0.125
灵敏度损失,0,0,0,5,0,0,0,5,0.625
链路预算,0,0,0,2,1,0,0,3,0.4916666666666667
的系统级仿,0,0,0,1,0,0,0,1,0.125
蒙特卡,0,0,0,1,0,0,0,1,0.125
lo,0,0,0,1,0,0,0,1,0.125
monte,0,0,0,1,0,0,0,1,0.125
确定性分析,0,0,0,1,0,0,0,1,0.125
干扰研究,0,0,0,1,0,0,0,1,0.125
干扰共存分析,0,0,1,2,0,2,1,6,1.1
终端,0,0,1,5,13,7,0,26,5.583333333333333
功控模型,0,0,0,0,1,1,0,2,0.48333333333333334
功率控制,0,0,1,1,5,3,1,11,2.425
imt,1,0,13,1,4,1,2,22,4.441666666666666
acs,0,0,0,5,1,1,0,7,1.1083333333333334
邻信道,0,0,0,5,2,1,0,8,1.35
接收机,0,0,1,15,4,1,0,21,3.208333333333333
lr,0,0,0,0,1,1,0,2,0.48333333333333334
邻信道泄露比,0,0,0,0,1,1,0,2,0.48333333333333334
发射机,0,0,0,4,2,1,0,7,1.225
邻信道干扰比,0,0,0,0,0,1,0,1,0.24166666666666667
增益,0,0,3,3,5,1,0,12,2.2
加性高斯白噪声,0,0,0,0,0,1,0,1,0.24166666666666667
有用信号,0,0,0,7,0,1,0,8,1.1166666666666667
门限,0,0,0,0,0,1,0,1,0.24166666666666667
信噪比,0,0,0,0,0,1,0,1,0.24166666666666667
容忍干扰门限,0,0,0,1,1,1,0,3,0.6083333333333334
二维均匀分布,0,0,0,0,0,2,0,2,0.48333333333333334
imt终端,0,0,0,0,26,1,0,27,6.525
二维ppp分布,0,0,0,0,0,1,0,1,0.24166666666666667
干扰共存系统模型,0,0,0,0,0,1,0,1,0.24166666666666667
间邻频干扰,0,0,0,5,0,0,1,6,0.8666666666666667
衰减,0,0,0,2,1,0,0,3,0.4916666666666667
功率,0,0,0,3,2,0,0,5,0.8583333333333334
有用信道,0,0,0,2,0,0,0,2,0.25
信道带宽,0,0,0,2,1,0,0,3,0.4916666666666667
非邻频阻塞干扰,0,0,0,1,0,0,0,1,0.125
选择性干扰,0,0,0,1,0,0,0,1,0.125
邻信道泄露干扰,0,0,0,1,0,0,0,1,0.125
频偏,0,0,0,1,0,0,0,1,0.125
非邻信道,0,0,0,1,0,0,0,1,0.125
阻塞干扰,0,0,0,2,0,0,0,2,0.25
无用信号,0,0,0,2,0,0,0,2,0.25
频道,0,0,0,2,0,0,0,2,0.25
抗邻道干扰能力,0,0,0,2,0,0,0,2,0.25
抑制能力,0,0,0,2,0,0,0,2,0.25
频道信号,0,0,0,1,0,0,0,1,0.125
收信机,0,0,0,1,0,0,0,1,0.125
接收机滤波器,0,0,0,3,0,0,0,3,0.375
选择性,0,0,0,2,0,0,0,2,0.25
载噪比,0,0,0,1,0,0,0,1,0.125
载波干扰比,0,0,0,1,0,0,0,1,0.125
阻塞干扰门限,0,0,0,1,0,0,0,1,0.125
邻道选择性抑制比,0,0,0,1,0,0,0,1,0.125
灵敏度,0,0,0,2,0,0,0,2,0.25
受扰接收机信道,0,0,0,1,0,0,0,1,0.125
干扰源,0,0,0,2,0,0,0,2,0.25
邻道泄漏功率,0,0,0,1,0,0,0,1,0.125
信道,0,0,0,1,0,0,0,1,0.125
邻道泄漏功率比,0,0,0,2,0,0,0,2,0.25
无用发射,0,0,0,1,0,0,0,1,0.125
有用发射,0,0,0,1,0,0,0,1,0.125
带内,0,0,0,2,0,0,0,2,0.25
发射,0,0,0,1,1,0,0,2,0.3666666666666667
杂散发射,0,0,0,1,0,0,0,1,0.125
邻道泄漏抑制比,0,0,0,1,0,0,0,1,0.125
发射互调特性,0,0,0,1,0,0,0,1,0.125
发射频率,0,0,0,2,0,0,0,2,0.25
收发信机滤波器,0,0,0,2,0,0,0,2,0.25
干扰共存,1,0,4,2,2,1,2,12,2.958333333333333
忍干扰门限,0,0,0,0,1,0,0,1,0.24166666666666667
地球站,0,0,0,5,2,1,0,8,1.35
干扰保护门限,0,0,0,0,1,0,0,1,0.24166666666666667
imt系统基站,0,0,0,0,2,0,0,2,0.48333333333333334
滤波器,0,0,0,2,7,0,0,9,1.9416666666666667
天线增益,0,0,3,0,6,0,0,9,1.825
系统间保护,0,0,0,0,1,1,0,2,0.48333333333333334
rdss,1,0,8,0,1,0,0,10,2.2416666666666667
卫星星座,0,0,5,0,0,0,0,5,0.625
mss,0,0,3,0,0,0,0,3,0.375
rnss,0,0,3,1,0,0,0,4,0.5
位置,0,0,2,0,0,0,0,2,0.25
卫星,0,0,8,1,1,0,0,10,1.3666666666666667
s波段,0,0,6,0,2,1,2,11,1.9583333333333333
rdss系统,1,0,4,1,0,0,0,6,1.625
卫星定位工程,0,0,2,0,0,0,0,2,0.25
卫星导航工程,0,0,2,0,0,0,0,2,0.25
武器制导,0,0,1,0,0,0,0,1,0.125
救援导航,0,0,1,0,0,0,0,1,0.125
通信,0,0,3,0,0,0,0,3,0.375
测速,0,0,3,0,0,0,0,3,0.375
通信定位,0,0,1,0,0,0,0,1,0.125
服务业务,0,0,1,0,0,0,0,1,0.125
全球一体化设,0,0,1,0,0,0,0,1,0.125
覆盖特性区域,0,0,1,0,0,0,0,1,0.125
多普勒测量值,0,0,1,0,0,0,0,1,0.125
星地伪距,0,0,1,0,0,0,0,1,0.125
中心控制系统,0,0,1,0,0,0,0,1,0.125
观测量,0,0,1,0,0,0,0,1,0.125
信号,0,0,3,3,0,1,0,7,0.9916666666666667
igso,0,0,1,0,0,0,0,1,0.125
步轨道,0,0,1,0,0,0,0,1,0.125
地球倾斜,0,0,1,0,0,0,0,1,0.125
meo,0,0,1,0,0,0,0,1,0.125
中圆轨道,0,0,1,0,0,0,0,1,0.125
地球静止轨道,0,0,1,0,0,0,0,1,0.125
速度,0,0,1,0,0,4,0,5,1.0916666666666668
性能卫星定位工程,0,0,1,0,0,0,0,1,0.125
ss,0,0,1,0,0,0,0,1,0.125
卫星网络业务,0,0,1,0,0,0,0,1,0.125
mss业务,0,0,1,0,0,0,0,1,0.125
rdss业务,0,0,1,0,0,0,0,1,0.125
业务,0,0,1,1,0,0,0,2,0.25
次要业务电台,0,0,1,0,0,0,0,1,0.125
射电天文,0,0,1,0,0,0,0,1,0.125
航空无线电导航,0,0,1,0,0,0,0,1,0.125
地对空业务,0,0,1,0,0,0,0,1,0.125
地对空l波段,0,0,1,0,0,0,0,1,0.125
ku频段,0,0,1,0,0,0,0,1,0.125
c波段,1,0,8,0,5,1,3,18,4.175
固定卫星,0,0,1,2,0,0,0,3,0.375
下行链路,0,0,1,0,0,0,0,1,0.125
mcc,0,0,1,0,0,0,0,1,0.125
工作频率,0,0,1,0,0,0,0,1,0.125
空对地下行,0,0,1,0,0,0,0,1,0.125
地对空上行工作频率,0,0,1,0,0,0,0,1,0.125
频段,0,0,23,8,2,0,0,33,4.358333333333333
mss频段,0,0,1,0,0,0,0,1,0.125
航空移动业务,0,0,1,0,0,0,0,1,0.125
administrativeradio,0,0,1,0,0,0,0,1,0.125
行政无线电,0,0,1,0,0,0,0,1,0.125
无线电频谱,0,0,1,0,0,0,0,1,0.125
mss频谱,0,0,1,0,0,0,0,1,0.125
rdss频谱,0,0,1,0,0,0,0,1,0.125
mobilesatelliteservices,0,0,1,0,0,0,0,1,0.125
卫星移动业务,0,0,1,0,0,0,0,1,0.125
卫星无线电,0,0,1,0,0,0,0,1,0.125
电信联,0,0,2,0,0,0,0,2,0.25
rnss系统,0,0,2,0,0,0,0,2,0.25
北斗二代卫星导航系统,0,0,5,0,0,0,0,5,0.625
卫星导航系统,0,0,9,0,0,0,0,9,1.125
北斗一代,0,0,3,0,0,0,0,3,0.375
设备制造工程,0,0,1,0,0,0,0,1,0.125
rdss卫星定位服务,0,0,1,0,0,0,0,1,0.125
有源定位,0,0,2,0,0,0,0,2,0.25
位置测定,0,0,1,0,0,0,0,1,0.125
距离测量,0,0,1,0,0,0,0,1,0.125
外部系统,0,0,1,0,0,0,0,1,0.125
卫星无线电测定业务,0,0,1,0,0,0,0,1,0.125
无源定位,0,0,1,0,0,0,0,1,0.125
航行参数,0,0,1,0,0,0,0,1,0.125
航速,0,0,1,0,0,0,0,1,0.125
定位,0,0,6,0,0,0,0,6,0.75
卫星无线电导航信号,0,0,1,0,0,0,0,1,0.125
rnsso,0,0,1,0,0,0,0,1,0.125
卫星无线电导航业务,0,0,2,0,0,0,0,2,0.25
卫星无线电业务,0,0,1,0,0,0,0,1,0.125
频率分配,0,0,1,0,0,0,0,1,0.125
卫星定位,0,0,1,0,0,0,0,1,0.125
imt-advanced,0,0,8,0,1,1,0,10,1.4833333333333334
itu-r,0,0,5,0,0,0,0,5,0.625
标准化,0,0,3,0,0,0,0,3,0.375
tdd,0,0,2,0,0,0,0,2,0.25
fdd,0,0,2,0,0,0,0,2,0.25
3gpp2,0,0,2,0,0,0,0,2,0.25
3gpp,0,0,2,1,3,0,0,6,1.1
cdma技术,0,0,2,0,0,0,0,2,0.25
移动通信系统,0,0,4,0,0,0,0,4,0.5
无线电,0,0,2,0,0,0,0,2,0.25
4g,0,0,2,0,0,0,0,2,0.25
imt-2000,0,0,2,0,0,0,0,2,0.25
演进系统,0,0,13,1,1,1,1,17,2.475
共存条,0,0,1,0,0,0,0,1,0.125
后续演进系统,0,0,1,0,0,0,0,1,0.125
扩展频段,0,0,1,0,0,0,0,1,0.125
mhz,0,0,1,0,7,2,0,10,2.3
4g频段,0,0,1,0,0,0,0,1,0.125
3g频段,0,0,1,0,0,0,0,1,0.125
40mhz,0,0,1,0,0,0,0,1,0.125
60mhz,0,0,1,0,0,0,0,1,0.125
30mhz,0,0,1,0,0,0,0,1,0.125
双工模式,0,0,1,0,0,0,0,1,0.125
频段带宽,0,0,1,0,0,0,0,1,0.125
制式,0,0,1,0,0,0,0,1,0.125
频诺资源,0,0,1,0,0,0,0,1,0.125
无线移动通信,0,0,1,0,0,0,0,1,0.125
移动通信频谱,0,0,1,0,0,0,0,1,0.125
无线电频率,0,0,1,0,0,0,0,1,0.125
无线通信系统,0,0,2,1,0,0,0,3,0.375
频谱,0,0,1,0,0,0,0,1,0.125
频谱工,0,0,1,0,0,0,0,1,0.125
可用频谱,0,0,1,0,0,0,0,1,0.125
全球,0,0,2,0,0,0,0,2,0.25
通信技术,0,0,1,0,0,0,0,1,0.125
5g,0,0,4,0,0,0,0,4,0.5
imt-2020,0,0,3,0,0,0,0,3,0.375
jtu-r,0,0,1,0,0,0,0,1,0.125
pe,0,0,1,0,0,0,0,1,0.125
无线接口规范,0,0,1,0,0,0,0,1,0.125
wman-advanced,0,0,1,0,0,0,0,1,0.125
802.16,0,0,1,0,0,0,0,1,0.125
lte-advanced,0,0,1,0,0,0,0,1,0.125
候选技,0,0,1,0,0,0,0,1,0.125
itu-rwp5d,0,0,1,0,0,0,0,1,0.125
systembeyondimt-2000,0,0,1,0,0,0,0,1,0.125
itu-rwp8,0,0,1,0,0,0,0,1,0.125
wp8,0,0,1,0,0,0,0,1,0.125
cdma2000,0,0,2,0,0,0,0,2,0.25
mc-cdma,0,0,1,0,0,0,0,1,0.125
td-scdma,0,0,2,0,0,0,0,2,0.25
wcdma,0,0,2,0,0,0,0,2,0.25
cdmatdd,0,0,1,0,0,0,0,1,0.125
ds-cdma,0,0,1,0,0,0,0,1,0.125
eration,0,0,1,0,0,0,0,1,0.125
imt-rscp,0,0,1,0,0,0,0,1,0.125
无线接口技术,0,0,1,0,0,0,0,1,0.125
wp5,0,0,1,0,0,0,0,1,0.125
(imt-,0,0,1,0,0,0,0,1,0.125
国际移动通信,1,0,1,0,0,0,0,2,1.125
无线通信,0,0,1,1,0,0,0,2,0.25
移动终端,1,0,0,1,5,0,0,7,2.333333333333333
北斗导航系统,0,0,1,0,5,0,1,7,1.575
带外指标,0,0,0,0,4,0,0,4,0.9666666666666667
dbm,0,0,4,2,5,0,0,11,1.9583333333333333
最大干扰功率谱密度,0,0,0,1,3,0,0,4,0.85
北斗用户终端,0,0,1,0,2,0,0,3,0.6083333333333334
隔离距离,0,0,2,0,2,4,0,8,1.7
北斗终端特性,0,0,0,0,2,0,0,2,0.48333333333333334
acir值,0,0,0,0,3,2,0,5,1.2083333333333333
接收滤波器,0,0,0,0,2,0,0,2,0.48333333333333334
发射滤波器,0,0,0,0,2,0,0,2,0.48333333333333334
dbw,0,0,0,0,3,0,0,3,0.725
eirp,0,0,1,1,2,0,0,4,0.7333333333333334
解调,0,0,0,3,2,0,0,5,0.8583333333333334
干扰值,0,0,2,0,1,0,0,3,0.4916666666666667
dbi,0,0,1,0,3,0,0,4,0.85
北斗用户终端天线,0,0,0,0,1,0,0,1,0.24166666666666667
imt终端干扰,0,0,0,0,1,0,0,1,0.24166666666666667
发射机滤波器,0,0,0,1,1,0,0,2,0.3666666666666667
直线距离,0,0,0,0,1,0,0,1,0.24166666666666667
imt基站天线,0,0,0,0,1,0,0,1,0.24166666666666667
确定性,0,0,0,0,1,0,0,1,0.24166666666666667
imt基站干扰,0,0,1,0,1,0,0,2,0.3666666666666667
最大干扰功率,0,0,0,0,1,0,0,1,0.24166666666666667
最大干扰,0,0,0,0,1,0,0,1,0.24166666666666667
等效干扰功率谱密,0,0,0,0,1,0,0,1,0.24166666666666667
接收信号,0,0,0,1,1,0,0,2,0.3666666666666667
最小损耗,0,0,0,0,1,0,0,1,0.24166666666666667
最小隔离距离,0,0,0,0,1,0,0,1,0.24166666666666667
北斗,0,0,8,0,9,1,0,18,3.4166666666666665
北斗终端接收机,0,0,0,0,3,0,0,3,0.725
热噪声功率,0,0,0,3,1,0,0,4,0.6166666666666667
余量,0,0,0,0,1,0,0,1,0.24166666666666667
eb/n0,0,0,0,0,1,0,0,1,0.24166666666666667
eh/na,0,0,0,0,1,0,0,1,0.24166666666666667
容许干扰,0,0,0,0,1,0,0,1,0.24166666666666667
有效带宽,0,0,0,0,1,0,0,1,0.24166666666666667
北斗信号,0,0,0,0,1,0,0,1,0.24166666666666667
地面,0,0,1,0,1,0,0,2,0.3666666666666667
地面端,0,0,0,0,1,0,0,1,0.24166666666666667
静止轨道卫星,0,0,1,0,1,0,0,2,0.3666666666666667
播模型,0,0,0,0,1,0,0,1,0.24166666666666667
空对地,0,0,0,0,1,0,0,1,0.24166666666666667
解调门限,0,0,0,1,1,0,0,2,0.3666666666666667
lte滤波器特性,0,0,0,0,3,0,0,3,0.725
lte滤波器,0,0,0,0,3,0,0,3,0.725
宏蜂窝乡村,0,0,0,0,2,0,0,2,0.48333333333333334
lte终端,0,0,0,0,5,6,0,11,2.658333333333333
频谱模板,0,0,0,1,4,0,0,5,1.0916666666666668
宏蜂窝,0,0,0,0,4,0,0,4,0.9666666666666667
干扰北斗终端系统,0,0,0,0,2,0,0,2,0.48333333333333334
「扰概率曲线,0,0,0,0,1,0,0,1,0.24166666666666667
宏蜂窝乡村环境,0,0,0,0,3,0,0,3,0.725
特性,0,0,0,0,1,1,0,2,0.48333333333333334
级仿真场,0,0,0,0,1,0,0,1,0.24166666666666667
acir,0,0,0,2,4,3,0,9,1.9416666666666667
终端链路,0,0,0,0,1,0,0,1,0.24166666666666667
天线模型,0,0,0,1,3,0,1,5,1.0916666666666668
用户,0,0,3,1,1,0,0,5,0.7416666666666667
功率控制模型,0,0,0,0,2,0,0,2,0.48333333333333334
系统级仿真分析,0,0,0,0,1,0,0,1,0.24166666666666667
终端干扰,0,0,0,0,1,0,0,1,0.24166666666666667
宏观特性,0,0,0,0,1,0,0,1,0.24166666666666667
方向角,0,0,1,0,3,0,0,4,0.85
阴影衰落,0,0,0,1,1,0,0,2,0.3666666666666667
接口,0,0,0,0,1,0,0,1,0.24166666666666667
网络拓扑结构,0,0,0,0,1,0,0,1,0.24166666666666667
fss卫星系统,0,0,0,0,1,0,0,1,0.24166666666666667
噪声温度,0,0,0,1,1,0,0,2,0.3666666666666667
天线直径,0,0,0,0,2,0,0,2,0.48333333333333334
天线高度,0,0,0,0,2,0,0,2,0.48333333333333334
bpsk,0,0,0,1,1,0,0,2,0.3666666666666667
oqpsk,0,0,0,1,1,0,0,2,0.3666666666666667
调制,0,0,0,0,1,0,0,1,0.24166666666666667
工作频段,0,0,0,0,2,0,0,2,0.48333333333333334
kbps,0,0,0,0,1,0,0,1,0.24166666666666667
数据速率,0,0,0,1,1,0,0,2,0.3666666666666667
带宽,0,0,0,2,10,0,0,12,2.6666666666666665
e1rp,0,0,0,0,1,0,0,1,0.24166666666666667
终端卫星,0,0,0,0,1,0,0,1,0.24166666666666667
参数卫星,0,0,0,0,1,0,0,1,0.24166666666666667
北斗参数,0,0,0,0,1,0,0,1,0.24166666666666667
卫星导航定位工程,0,0,0,0,1,0,0,1,0.24166666666666667
共存分析,0,0,2,0,2,0,0,4,0.7333333333333334
传统系统级,0,0,1,0,0,0,1,2,0.3666666666666667
干扰模型,0,0,1,0,0,0,1,2,0.3666666666666667
随机几何,0,0,1,0,0,1,1,3,0.6083333333333334
干扰共存分析模型,0,0,1,0,0,0,0,1,0.125
imt演进系统基站,0,0,1,0,0,0,0,1,0.125
北斗移动终端,0,0,1,0,1,0,0,2,0.3666666666666667
性分析,0,0,1,0,0,0,0,1,0.125
发射频谱模板,0,0,1,0,0,0,0,1,0.125
配置参数,0,0,1,0,1,0,1,3,0.6083333333333334
干扰共存场,0,0,1,0,0,0,0,1,0.125
北斗rdss系统,0,0,1,0,0,0,0,1,0.125
s、c频段干扰分析,0,0,1,0,0,0,0,1,0.125
干扰计算,0,0,1,0,0,0,0,1,0.125
电磁兼容分析,0,0,1,0,0,0,0,1,0.125
卫星频率轨道资源,0,0,1,0,0,0,1,2,0.3666666666666667
共存保护策,1,0,1,0,0,0,1,3,1.3666666666666667
共存指标,1,0,1,0,1,0,1,4,1.6083333333333334
共存条件,1,0,1,0,0,0,1,3,1.3666666666666667
北斗rdss接收机,0,0,1,0,0,0,0,1,0.125
邻频imt,0,0,1,0,0,0,1,2,0.3666666666666667
北斗卫星,2,0,1,0,1,1,0,5,2.6083333333333334
卫星导航业务,0,0,2,0,0,0,0,2,0.25
保护区,0,0,0,0,0,1,0,1,0.24166666666666667
共存场,0,0,0,0,0,2,0,2,0.48333333333333334
集总干扰分析,0,0,0,0,0,1,1,2,0.48333333333333334
系统级分,0,0,0,0,0,1,0,1,0.24166666666666667
系统建模,0,0,0,0,0,1,0,1,0.24166666666666667
数学工具,0,0,0,0,0,1,0,1,0.24166666666666667
二维泊松点分布,1,0,0,0,0,1,0,2,1.2416666666666667
系统级,0,0,0,0,0,1,0,1,0.24166666666666667
蜂窝系统基站,0,0,0,0,0,1,0,1,0.24166666666666667
微蜂窝技术,0,0,0,0,0,1,0,1,0.24166666666666667
家庭基站,0,0,0,0,0,1,0,1,0.24166666666666667
微微蜂窝,0,0,0,0,0,1,0,1,0.24166666666666667
微蜂窝,0,0,0,0,0,1,0,1,0.24166666666666667
蜂窝小区,0,0,0,0,0,1,0,1,0.24166666666666667
吞吐量,0,0,0,0,0,1,0,1,0.24166666666666667
小区覆盖率,0,0,0,0,0,1,0,1,0.24166666666666667
业务量,0,0,0,0,1,1,0,2,0.48333333333333334
移动用户,0,0,0,0,0,1,0,1,0.24166666666666667
共存频段,0,0,1,1,0,0,0,2,0.25
邻频,0,0,2,0,3,0,0,5,0.975
支柱产业,0,0,1,0,0,0,0,1,0.125
移动通信产业,0,0,2,0,0,0,0,2,0.25
响力,0,0,1,0,0,0,0,1,0.125
军事,0,0,1,0,0,0,0,1,0.125
社会经济,0,0,1,0,0,0,0,1,0.125
卫星轨道资源,0,0,1,0,0,0,0,1,0.125
导航系统,0,0,2,0,0,0,0,2,0.25
导航定位,1,0,2,0,0,0,0,3,1.25
国防,0,0,2,0,0,0,0,2,0.25
全球卫星导航系统,0,0,9,0,0,0,0,9,1.125
卫星导航技术,0,0,1,0,0,0,0,1,0.125
路损模型,0,0,0,2,3,0,0,5,0.975
带外滤波特性,0,0,0,0,1,0,0,1,0.24166666666666667
北斗一代系,0,0,0,0,1,0,0,1,0.24166666666666667
收发滤波器,0,0,0,0,1,0,0,1,0.24166666666666667
aclr指,0,0,0,0,1,0,0,1,0.24166666666666667
北斗用户,0,0,0,0,1,0,0,1,0.24166666666666667
乡村环,0,0,0,0,1,0,0,1,0.24166666666666667
城区,0,0,0,0,1,0,0,1,0.24166666666666667
城区环境,0,0,0,0,1,0,0,1,0.24166666666666667
拓扑,0,0,0,0,1,0,0,1,0.24166666666666667
概率事件,0,0,0,0,1,0,0,1,0.24166666666666667
司时系统,0,0,0,0,1,0,0,1,0.24166666666666667
收发,0,0,0,0,1,0,0,1,0.24166666666666667
最大功率发射,0,0,0,0,1,0,0,1,0.24166666666666667
主瓣,0,0,1,0,1,0,0,2,0.3666666666666667
宏蜂窝城区环境,0,0,0,0,1,0,0,1,0.24166666666666667
s波段imt系统,0,0,0,0,3,0,0,3,0.725
邻频干扰,1,0,0,5,1,0,0,7,1.8666666666666667
功率控制参数,0,0,0,0,2,0,0,2,0.48333333333333334
pmax,0,0,0,0,2,0,0,2,0.48333333333333334
基站天线,0,0,2,0,2,1,0,5,0.975
pl,0,0,0,0,1,0,0,1,0.24166666666666667
平衡因子,0,0,0,0,1,0,0,1,0.24166666666666667
路损值,0,0,0,0,1,0,0,1,0.24166666666666667
路径损耗值,0,0,0,0,1,0,0,1,0.24166666666666667
plx,0,0,0,0,1,0,0,1,0.24166666666666667
低速率,0,0,0,0,1,0,0,1,0.24166666666666667
传输信道,0,0,0,0,1,0,0,1,0.24166666666666667
最大功率,0,0,0,0,1,0,0,1,0.24166666666666667
最小功率,0,0,0,0,1,0,0,1,0.24166666666666667
rmin,0,0,0,0,1,0,0,1,0.24166666666666667
波长,0,0,0,0,1,0,0,1,0.24166666666666667
主轴,0,0,2,0,1,0,0,3,0.4916666666666667
地球站天线,0,0,0,0,1,0,0,1,0.24166666666666667
地球站接收机,0,0,0,1,1,0,0,2,0.3666666666666667
7td-lte基站,0,0,0,0,1,0,0,1,0.24166666666666667
水平方向角,0,0,0,0,1,0,0,1,0.24166666666666667
垂直方,0,0,0,0,1,0,0,1,0.24166666666666667
垂直方向,0,0,0,0,1,0,0,1,0.24166666666666667
水平方向,0,0,0,0,1,0,0,1,0.24166666666666667
基站移动台,0,0,0,0,1,0,0,1,0.24166666666666667
基站天线模型,0,0,0,0,1,0,0,1,0.24166666666666667
8td-lte系统,0,0,0,0,1,0,0,1,0.24166666666666667
lte基站天线,0,0,0,0,1,0,0,1,0.24166666666666667
全向天线,0,0,0,0,2,0,0,2,0.48333333333333334
接收,0,0,0,0,1,0,0,1,0.24166666666666667
移动台,0,0,0,1,1,0,0,2,0.3666666666666667
lte系统,0,0,0,0,2,1,0,3,0.725
光平方系统,0,0,4,0,0,0,0,4,0.5
gnss,0,0,4,0,0,0,0,4,0.5
互干扰,0,0,3,0,0,0,0,3,0.375
电磁兼容性,0,0,3,0,0,0,0,3,0.375
光平方事件,0,0,3,0,0,0,0,3,0.375
rdss频率,0,0,2,0,0,0,0,2,0.25
移动卫星网络,0,0,2,0,0,0,0,2,0.25
干扰消除措施,0,0,2,0,0,0,0,2,0.25
gps用户,0,0,2,0,0,0,0,2,0.25
atellitesystem,0,0,3,0,0,0,0,3,0.375
频率资源保护,0,0,1,0,0,0,0,1,0.125
轨道卫星,0,0,1,0,0,0,0,1,0.125
保护系统,0,0,1,0,0,0,0,1,0.125
北斗导航信号,0,0,1,0,0,0,0,1,0.125
无线电业务,0,0,1,0,0,0,0,1,0.125
hz,0,0,2,1,1,0,0,4,0.6166666666666667
自干扰,0,0,1,0,0,0,0,1,0.125
gps系统,0,0,1,0,0,0,0,1,0.125
无线电通信系统,0,0,1,0,0,0,0,1,0.125
频率兼容性,0,0,1,0,0,0,0,1,0.125
导航卫星系统,0,0,1,0,0,0,0,1,0.125
频率协调,0,0,1,0,0,0,0,1,0.125
间干扰评估协调,0,0,1,0,0,0,0,1,0.125
电信联盟,0,0,1,0,0,0,0,1,0.125
兼容性,0,0,1,0,0,0,0,1,0.125
卫星导航信号,0,0,1,0,0,0,0,1,0.125
光平方公司,0,0,1,0,0,0,0,1,0.125
场外测试,0,0,1,0,0,0,0,1,0.125
干扰分,0,0,1,0,0,0,0,1,0.125
地面网,0,0,1,0,0,0,0,1,0.125
间干扰问题,0,0,1,0,0,0,0,1,0.125
邻频段异构系统,0,0,1,0,0,0,0,1,0.125
频谱重叠,0,0,1,0,0,0,0,1,0.125
radionavigations,0,0,1,0,0,0,0,1,0.125
干扰事件,0,0,2,0,0,0,0,2,0.25
地面无线系统,0,0,1,0,0,0,0,1,0.125
干扰gps系统,0,0,1,0,0,0,0,1,0.125
地面移动通信网,0,0,1,0,0,0,0,1,0.125
干扰监测,0,0,1,0,0,0,0,1,0.125
频谱保护,0,0,1,0,0,0,0,1,0.125
navigations,0,0,1,0,0,0,0,1,0.125
地面移动通信系统,0,0,1,0,0,0,0,1,0.125
农村,0,0,0,0,2,0,0,2,0.48333333333333334
小区,0,0,0,0,1,0,0,1,0.24166666666666667
热噪声,0,0,0,1,1,0,0,2,0.3666666666666667
噪声系数,0,0,0,0,1,0,0,1,0.24166666666666667
扇区天线,0,0,0,0,1,0,0,1,0.24166666666666667
全功率发射,0,0,0,0,1,0,0,1,0.24166666666666667
扇区数,0,0,0,0,1,0,0,1,0.24166666666666667
频率复用因子,0,0,0,0,1,0,0,1,0.24166666666666667
rb数,0,0,0,0,1,0,0,1,0.24166666666666667
基站间距,0,0,0,0,1,0,0,1,0.24166666666666667
宏蜂窝城市,0,0,0,0,1,0,0,1,0.24166666666666667
基站终端,0,0,0,0,1,0,0,1,0.24166666666666667
lte-advanced系统,0,0,0,0,1,0,0,1,0.24166666666666667
120mhz带宽,0,0,0,0,1,0,0,1,0.24166666666666667
3gppts,0,0,0,0,3,0,0,3,0.725
lte-adanced系统,0,0,0,0,1,0,0,1,0.24166666666666667
5g标准,0,0,0,0,1,0,0,1,0.24166666666666667
5g系统,0,0,0,0,1,0,0,1,0.24166666666666667
td-lte系统,1,0,0,0,1,2,0,4,1.725
用户接收机,0,0,3,0,0,0,0,3,0.375
地面中心控制系统,0,0,3,0,0,0,0,3,0.375
校准站,0,0,2,0,0,0,0,2,0.25
主控站,0,0,2,0,0,0,0,2,0.25
空间段,0,0,4,0,0,0,0,4,0.5
北斗一代卫星导航系统,0,0,2,1,0,0,0,3,0.375
用户位置,0,0,2,0,0,0,0,2,0.25
授时能力,0,0,1,0,0,0,0,1,0.125
精度,0,0,1,0,0,0,0,1,0.125
实时无源三维定位测速能力,0,0,1,0,0,0,0,1,0.125
中心系统,0,0,1,0,0,0,0,1,0.125
定位精度差,0,0,1,0,0,0,0,1,0.125
高速运动体,0,0,1,0,0,0,0,1,0.125
二维主动式定位,0,0,1,0,0,0,0,1,0.125
定位精度,0,0,2,0,0,0,0,2,0.25
赤道,0,0,1,0,0,0,0,1,0.125
区域性定位导航,0,0,1,0,0,0,0,1,0.125
搜索营救,0,0,1,0,0,0,0,1,0.125
调度指挥,0,0,1,0,0,0,0,1,0.125
交通运输,0,0,2,0,0,0,0,2,0.25
集团,0,0,1,0,0,0,0,1,0.125
无通信盲区,0,0,1,0,0,0,0,1,0.125
gps,0,0,2,0,0,0,0,2,0.25
通信系统,0,0,1,1,0,0,0,2,0.25
指挥型,0,0,1,0,0,0,0,1,0.125
集团管理,0,0,1,0,0,0,0,1,0.125
授时型,0,0,1,0,0,0,0,1,0.125
时间同步,0,0,1,0,0,0,0,1,0.125
通信型,0,0,1,0,0,0,0,1,0.125
数据采集,0,0,1,0,0,0,0,1,0.125
普通型,0,0,1,0,0,0,0,1,0.125
定位导航,0,0,1,0,0,0,0,1,0.125
用户机,0,0,1,0,0,0,0,1,0.125
地面中心,0,0,1,0,0,0,0,1,0.125
位置信息,0,0,1,0,0,0,0,1,0.125
定位结算,0,0,1,0,0,0,0,1,0.125
用户设备,0,0,1,0,0,0,0,1,0.125
应答信号,0,0,1,0,0,0,0,1,0.125
数据信息,0,0,1,0,0,0,0,1,0.125
s波段信号,0,0,1,0,0,0,0,1,0.125
接收卫星,0,0,1,0,0,0,0,1,0.125
转发器,0,0,1,0,0,0,0,1,0.125
接收、,0,0,1,0,0,0,0,1,0.125
全向收发天线,0,0,1,0,0,0,0,1,0.125
状况测控,0,0,1,0,0,0,0,1,0.125
信息,0,0,1,0,0,0,0,1,0.125
双星导航定位系统,0,0,1,0,0,0,0,1,0.125
测高站,0,0,1,0,0,0,0,1,0.125
测轨站,0,0,1,0,0,0,0,1,0.125
计算中心,0,0,1,0,0,0,0,1,0.125
双向无线电信号,0,0,1,0,0,0,0,1,0.125
收发信机,0,0,1,0,2,0,0,3,0.6083333333333334
空间卫星,0,0,1,0,0,0,0,1,0.125
区域性卫星导航系统,0,0,1,0,0,0,0,1,0.125
波束覆盖中心,0,0,1,0,0,0,0,1,0.125
波束,0,0,1,0,0,0,0,1,0.125
北斗一代卫星,0,0,1,0,0,0,0,1,0.125
备份星星,0,0,1,0,0,0,0,1,0.125
经度,0,0,1,0,0,0,0,1,0.125
在轨备份卫星,0,0,2,0,0,0,0,2,0.25
地球静止卫星,0,0,1,0,0,0,0,1,0.125
空间段卫星,0,0,1,0,0,0,0,1,0.125
北斗一代系统,0,0,4,0,0,0,0,4,0.5
一代系统,0,0,1,0,0,0,0,1,0.125
隔离带宽,0,0,0,0,4,0,0,4,0.9666666666666667
功率谱密度,0,0,0,0,3,0,0,3,0.725
等效aclr,0,0,0,0,2,0,0,2,0.48333333333333334
北斗接收机,0,0,0,0,2,0,0,2,0.48333333333333334
杂散辐射,0,0,0,0,2,0,0,2,0.48333333333333334
imt基站发射机,0,0,0,0,2,0,0,2,0.48333333333333334
带外杂散辐射,0,0,0,0,2,0,0,2,0.48333333333333334
测量滤波器,0,0,0,0,2,0,0,2,0.48333333333333334
带外发射模板,0,0,0,0,2,0,0,2,0.48333333333333334
带外辐射模板,0,0,0,0,2,0,0,2,0.48333333333333334
3gpptr,0,0,0,0,2,0,0,2,0.48333333333333334
受扰系统,0,0,0,14,2,0,0,16,2.2333333333333334
外杂散辐射,0,0,0,0,1,0,0,1,0.24166666666666667
终端带,0,0,0,0,1,0,0,1,0.24166666666666667
发射功率谱密度,0,0,0,0,1,0,0,1,0.24166666666666667
imt终端发射机,0,0,0,0,1,0,0,1,0.24166666666666667
bandwidth,0,0,0,0,1,0,0,1,0.24166666666666667
channelbandwidth,0,0,0,0,1,0,0,1,0.24166666666666667
spectrumemissionlimit,0,0,0,0,1,0,0,1,0.24166666666666667
频率间隔,0,0,0,1,1,0,0,2,0.3666666666666667
中心载频,0,0,0,0,1,0,0,1,0.24166666666666667
接收信道,0,0,0,0,1,0,0,1,0.24166666666666667
泄露功率,0,0,0,0,1,0,0,1,0.24166666666666667
imt基站系统,0,0,0,0,1,0,0,1,0.24166666666666667
功率泄露,0,0,0,0,1,0,0,1,0.24166666666666667
邻频功率泄露,0,0,0,0,1,0,0,1,0.24166666666666667
uaf,0,0,0,0,1,0,0,1,0.24166666666666667
coffsetmax,0,0,0,0,1,0,0,1,0.24166666666666667
loff,0,0,0,0,1,0,0,1,0.24166666666666667
市宽,0,0,0,0,1,0,0,1,0.24166666666666667
中心频率偏移量,0,0,0,0,1,0,0,1,0.24166666666666667
测量,0,0,0,0,1,0,0,1,0.24166666666666667
点频率偏移量,0,0,0,0,1,0,0,1,0.24166666666666667
320mhz,0,0,0,0,1,0,0,1,0.24166666666666667
参考带宽,0,0,0,0,1,0,0,1,0.24166666666666667
邻信道干扰,0,0,0,0,1,0,0,1,0.24166666666666667
抗干扰能力,0,0,0,1,1,0,0,2,0.3666666666666667
无用发射信号,0,0,0,1,1,0,0,2,0.3666666666666667
施扰系统,0,0,0,16,1,0,0,17,2.2416666666666667
概率,0,0,0,0,0,6,0,6,1.45
概率密度函数,0,0,0,0,0,3,0,3,0.725
随机变量,0,0,0,1,0,3,0,4,0.85
半径,0,0,0,0,0,3,0,3,0.725
平均密度,0,0,0,0,0,1,0,1,0.24166666666666667
泊松点,0,0,0,0,0,1,0,1,0.24166666666666667
二维,0,0,0,0,0,1,0,1,0.24166666666666667
发射信号,0,0,0,5,0,0,0,5,0.625
无线电磁干扰,0,0,0,6,0,0,0,6,0.75
异频干扰,0,0,0,4,0,0,0,4,0.5
内干扰,0,0,0,5,0,0,0,5,0.625
同频干扰,0,0,0,4,0,0,0,4,0.5
非线性器件,0,0,0,3,0,0,0,3,0.375
谐波产物,0,0,0,3,0,0,0,3,0.375
频率资源,0,0,0,3,0,0,0,3,0.375
受害接收机,0,0,0,2,0,0,0,2,0.25
互调产物,0,0,0,2,0,0,0,2,0.25
谐波干扰,0,0,0,2,0,0,0,2,0.25
互调干扰,0,0,0,2,0,0,0,2,0.25
杂散干扰,0,0,0,2,0,0,0,2,0.25
设备,0,0,0,2,0,0,0,2,0.25
系统间干扰,0,0,0,2,0,0,0,2,0.25
间邻频干扰分,0,0,0,1,0,0,0,1,0.125
共存干扰分析,0,0,0,1,0,0,0,1,0.125
imt业务,0,0,0,1,0,0,0,1,0.125
被干扰系统,0,0,0,1,0,0,0,1,0.125
线性组合频率,0,0,0,1,0,0,0,1,0.125
非线性电路,0,0,0,1,0,0,0,1,0.125
失真,0,0,0,1,0,0,0,1,0.125
受害接收机链路,0,0,0,1,0,0,0,1,0.125
气阻塞干扰,0,0,0,1,0,0,0,1,0.125
底噪抬升,0,0,0,2,0,0,0,2,0.25
有用信号接收机,0,0,0,1,0,0,0,1,0.125
接收频段,0,0,0,1,0,0,0,1,0.125
受害系统,0,0,0,1,0,0,0,1,0.125
频率转换产物,0,0,0,1,0,0,0,1,0.125
寄生辐射,0,0,0,1,0,0,0,1,0.125
谐波,0,0,0,1,0,0,0,1,0.125
分量,0,0,0,1,0,0,0,1,0.125
辐射信号,0,0,0,1,0,0,0,1,0.125
工作频带,0,0,0,1,0,0,0,1,0.125
混频器,0,0,0,1,0,0,0,1,0.125
功率放大器,0,0,0,1,0,0,0,1,0.125
差异性,0,0,0,1,0,0,0,1,0.125
无线电磁干扰来源,0,0,0,1,0,0,0,1,0.125
系统间,0,0,0,1,0,0,0,1,0.125
交调产物,0,0,0,1,0,0,0,1,0.125
间异频干扰,0,0,0,1,0,0,0,1,0.125
邻频信号,0,0,0,2,0,0,0,2,0.25
间干扰,0,0,0,1,0,0,0,1,0.125
异频频段,0,0,0,1,0,0,0,1,0.125
泄漏功率,0,0,0,1,0,0,0,1,0.125
远近效应,0,0,0,1,0,0,0,1,0.125
cdma系统,0,0,0,1,0,0,0,1,0.125
小区间干扰,0,0,0,1,0,0,0,1,0.125
蜂窝系统,0,0,0,1,0,0,1,2,0.3666666666666667
频率资料,0,0,0,1,0,0,0,1,0.125
系统内干扰,0,0,0,1,0,0,0,1,0.125
无线电磁环境,0,0,0,3,0,0,0,3,0.375
时施扰系统,0,0,0,1,0,0,0,1,0.125
通信设备,0,0,0,1,0,0,0,1,0.125
干扰类型,0,0,0,2,0,0,1,3,0.4916666666666667
b2链路,0,0,0,0,0,1,0,1,0.24166666666666667
地面接收端信号,0,0,0,0,0,1,0,1,0.24166666666666667
北斗卫星信号,0,0,1,0,0,1,0,2,0.3666666666666667
td.lte系统,0,0,0,0,0,1,0,1,0.24166666666666667
受扰系统基站,0,0,0,4,0,0,0,4,0.5
表达式,0,0,0,1,0,0,0,1,0.125
受扰系统接收机,0,0,0,1,0,0,0,1,0.125
邻频泄漏功率,0,0,0,1,0,0,0,1,0.125
共存性能,0,0,0,1,0,0,0,1,0.125
带外辐射功率,0,0,0,1,0,0,0,1,0.125
隔离度,0,0,0,1,0,0,0,1,0.125
邻道干扰抑制,0,0,0,1,0,0,0,1,0.125
保护带,0,0,0,1,0,0,0,1,0.125
空间隔离度,0,0,0,1,0,0,0,1,0.125
馈线损耗,0,0,0,1,0,0,0,1,0.125
接收天线,0,0,2,1,0,0,0,3,0.375
发射天线增益,0,0,0,1,0,0,0,1,0.125
tkpower,0,0,0,1,0,0,0,1,0.125
评估准则,0,0,0,1,0,0,0,1,0.125
业务特性,0,0,0,1,0,0,0,1,0.125
终端侧接收机,0,0,0,1,0,0,0,1,0.125
txpower,0,0,0,1,0,0,0,1,0.125
acir干扰保护准则,0,0,0,1,0,0,0,1,0.125
间隔离度,0,0,0,1,0,0,0,1,0.125
干扰强度,0,0,0,1,0,0,0,1,0.125
共存分析流程,0,0,0,0,0,1,0,1,0.24166666666666667
复杂度,0,0,0,0,0,2,0,2,0.48333333333333334
总干扰,0,0,0,0,0,1,0,1,0.24166666666666667
高斯拟合集,0,0,0,0,0,1,0,1,0.24166666666666667
imtj,0,0,0,0,0,1,0,1,0.24166666666666667
资源调度算法,0,0,0,0,0,2,1,3,0.725
北斗终端干扰,0,0,0,0,0,1,0,1,0.24166666666666667
干扰概率计算模型,0,0,0,0,0,1,0,1,0.24166666666666667
高斯分布,0,0,0,0,0,9,0,9,2.175
方差,0,0,0,0,0,8,0,8,1.9333333333333333
干扰门限,0,0,0,1,0,3,0,4,0.85
保护距离,0,0,0,0,0,4,0,4,0.9666666666666667
均值,0,0,0,0,0,6,0,6,1.45
置信度,0,0,0,0,0,3,0,3,0.725
基站密度,0,0,0,0,0,2,0,2,0.48333333333333334
瑞利衰落,0,0,0,0,0,2,0,2,0.48333333333333334
变量,0,0,0,0,0,3,0,3,0.725
干扰半径,0,0,0,0,0,1,0,1,0.24166666666666667
容忍干扰概率,0,0,0,0,0,1,0,1,0.24166666666666667
信道干扰比,0,0,0,0,0,1,0,1,0.24166666666666667
acirh,0,0,0,0,0,1,0,1,0.24166666666666667
北斗地球站天线,0,0,0,0,0,1,0,1,0.24166666666666667
pb,0,0,0,0,0,1,0,1,0.24166666666666667
fx,0,0,0,0,0,1,0,1,0.24166666666666667
莅丝皿牛,0,0,0,0,0,1,0,1,0.24166666666666667
阶跃函数,0,0,0,0,0,3,0,3,0.725
闭式,0,0,0,0,0,2,0,2,0.48333333333333334
数值,0,0,0,0,0,1,0,1,0.24166666666666667
mc,0,0,0,0,0,1,0,1,0.24166666666666667
中化,0,0,0,0,0,1,0,1,0.24166666666666667
服从,0,0,0,0,0,1,0,1,0.24166666666666667
干扰概率门限,0,0,0,0,0,1,0,1,0.24166666666666667
1mt基站,0,0,0,0,0,1,0,1,0.24166666666666667
隔离距,0,0,0,0,0,1,0,1,0.24166666666666667
同置信度,0,0,0,0,0,1,0,1,0.24166666666666667
k-s检验,0,0,0,0,0,2,0,2,0.48333333333333334
联合概率密度函数,0,0,0,0,0,2,0,2,0.48333333333333334
指数分布,0,0,0,0,0,1,0,1,0.24166666666666667
幅值,0,0,0,0,0,1,0,1,0.24166666666666667
条件概率密度函数,0,0,0,0,0,2,0,2,0.48333333333333334
环形区域,0,0,0,0,0,1,0,1,0.24166666666666667
外环半径,0,0,0,0,0,1,0,1,0.24166666666666667
内环半径,0,0,0,0,0,1,0,1,0.24166666666666667
密度,0,0,0,0,0,1,0,1,0.24166666666666667
下行信号,0,0,4,0,0,0,0,4,0.5
行信号,0,0,1,0,0,0,0,1,0.125
地面imt系统,0,0,1,0,0,0,0,1,0.125
噪声功率,0,0,1,1,0,0,0,2,0.25
l波段,0,0,1,0,0,0,0,1,0.125
资源块,0,0,0,0,0,8,0,8,1.9333333333333333
资源,0,0,0,0,0,5,0,5,1.2083333333333333
干扰用户,0,0,0,0,0,4,0,4,0.9666666666666667
北斗终端频段,0,0,0,0,0,3,0,3,0.725
lte带宽,0,0,0,0,0,2,0,2,0.48333333333333334
空间距离,0,0,0,0,0,2,0,2,0.48333333333333334
lte调度器,0,0,0,0,0,2,0,2,0.48333333333333334
上行资源调度算法,0,0,0,0,0,1,0,1,0.24166666666666667
max-acir调度算,0,0,0,0,0,1,0,1,0.24166666666666667
可调度,0,0,0,0,0,1,0,1,0.24166666666666667
北斗频段,0,0,0,0,0,1,0,1,0.24166666666666667
认知功能,0,0,0,0,0,1,0,1,0.24166666666666667
调度策略,0,0,0,0,0,1,0,1,0.24166666666666667
lte用户带,0,0,0,0,0,1,0,1,0.24166666666666667
acirxii,0,0,0,0,0,1,0,1,0.24166666666666667
平均发射功率,0,0,0,0,0,1,0,1,0.24166666666666667
基本数学,0,0,0,0,0,1,0,1,0.24166666666666667
个数,0,0,0,0,0,3,0,3,0.725
圆域,0,0,0,0,0,1,0,1,0.24166666666666667
终端个数,0,0,0,0,0,1,0,1,0.24166666666666667
用户密度,0,0,0,0,0,1,0,1,0.24166666666666667
面积,0,0,0,0,0,1,0,1,0.24166666666666667
邻近道干扰,0,0,2,0,0,0,0,2,0.25
移动通信,0,0,2,0,0,0,0,2,0.25
4g/lte,0,0,2,0,0,0,0,2,0.25
近邻频干扰,0,0,1,0,0,0,0,1,0.125
s、c频段,0,0,1,1,0,0,0,2,0.25
干扰态势,0,0,1,1,0,0,0,2,0.25
c频段,0,0,1,1,0,0,0,2,0.25
fixed-satelliteservice,0,0,1,0,0,0,0,1,0.125
fss,0,0,1,1,0,0,0,2,0.25
卫星固定业务,0,0,1,0,0,0,0,1,0.125
s频段,1,0,1,1,0,0,0,3,1.25
用频单位,0,0,1,0,0,0,0,1,0.125
频谱审计,0,0,1,0,0,0,0,1,0.125
无线电管理,0,0,1,0,0,0,0,1,0.125
拍照,0,0,1,0,0,0,0,1,0.125
附近频段,0,0,1,0,0,0,0,1,0.125
地面无线通信系统,1,0,1,0,0,0,0,2,1.125
星地,0,0,1,0,0,0,0,1,0.125
发送功率,0,0,1,0,0,0,0,1,0.125
卫星信号,0,0,1,0,0,0,0,1,0.125
干扰问,0,0,1,0,0,0,0,1,0.125
自然科学,0,0,1,0,0,0,0,1,0.125
5g技术,0,0,1,0,0,0,0,1,0.125
工信部,0,0,1,0,0,0,0,1,0.125
协议,0,0,1,0,0,0,0,1,0.125
imt-2000系统,0,0,1,0,0,0,0,1,0.125
is-95,0,0,1,0,0,0,0,1,0.125
移动通信技术,0,0,1,0,0,0,0,1,0.125
邻频通信系统,0,0,1,0,0,0,0,1,0.125
卫星导航,0,0,1,0,0,0,0,1,0.125
气全球卫星导航系统,0,0,1,0,0,0,0,1,0.125
空间基础设,0,0,1,0,0,0,0,1,0.125
速度测定,0,0,1,0,0,0,0,1,0.125
姿态,0,0,1,0,0,0,0,1,0.125
运动载体,0,0,1,0,0,0,0,1,0.125
授时信息,0,0,1,0,0,0,0,1,0.125
导航,0,0,1,0,0,0,0,1,0.125
compasso,0,0,1,0,0,0,0,1,0.125
galileo,0,0,1,0,0,0,0,1,0.125
伽利略,0,0,1,0,0,0,0,1,0.125
onass,0,0,1,0,0,0,0,1,0.125
格洛纳斯,0,0,1,0,0,0,0,1,0.125
卫星导航定位系统,0,0,1,0,0,0,0,1,0.125
资源配置,0,0,0,2,0,0,0,2,0.25
蒙特卡罗静态仿真,0,0,0,1,0,0,0,1,0.125
随机事件,0,0,0,1,0,0,0,1,0.125
快照个数,0,0,0,1,0,0,0,1,0.125
snapshot,0,0,0,1,0,0,0,1,0.125
干扰问题,0,0,0,1,0,0,0,1,0.125
montecarlo系统级仿真,0,0,0,1,0,0,0,1,0.125
数学模型,0,0,0,1,0,0,0,1,0.125
电磁干扰分析,0,0,0,1,0,0,0,1,0.125
终端接收机,0,0,0,1,0,0,0,1,0.125
终端数据速率,0,0,0,1,0,0,0,1,0.125
终端数,0,0,0,1,0,0,0,1,0.125
系统保护准,0,0,0,1,0,0,0,1,0.125
丢包率,0,0,0,1,0,0,0,1,0.125
误码率,0,0,0,2,0,0,0,2,0.25
总干扰值,0,0,0,1,0,1,0,2,0.3666666666666667
链路,0,0,0,1,0,0,0,1,0.125
阴影衰落模型,0,0,0,1,0,0,0,1,0.125
功率控制策略,0,0,0,1,0,0,0,1,0.125
接收机滤波器特性,0,0,0,1,0,0,0,1,0.125
参数配置,0,0,0,1,0,0,0,1,0.125
收发系统,0,0,0,1,0,0,0,1,0.125
地理信息,0,0,0,1,0,0,0,1,0.125
仿真场景,0,0,0,1,0,0,0,1,0.125
软件初始化,0,0,0,1,0,0,0,1,0.125
仿真分析,0,0,0,1,0,0,0,1,0.125
系统干扰,0,0,0,1,0,0,0,1,0.125
网络仿真,0,0,0,1,0,0,0,1,0.125
网络模型,0,0,0,1,0,0,0,1,0.125
系统仿真技术,0,0,0,1,0,0,0,1,0.125
接入率,0,0,0,1,0,0,0,1,0.125
控制策略,0,0,0,1,0,0,0,1,0.125
协议标准,0,0,0,1,0,0,0,1,0.125
链路级仿真接口,0,0,0,1,0,0,0,1,0.125
干扰计算机,0,0,0,1,0,0,0,1,0.125
通信业务,0,0,0,1,0,0,0,1,0.125
通用滤波器指标,0,0,0,0,2,0,0,2,0.48333333333333334
共存场景,0,0,0,0,2,0,0,2,0.48333333333333334
mcl准,0,0,0,0,1,0,0,1,0.24166666666666667
北斗终端系统,0,0,0,0,1,0,0,1,0.24166666666666667
minimumcoupl,0,0,0,0,1,0,0,1,0.24166666666666667
mcl,0,0,0,0,1,0,0,1,0.24166666666666667
耦合损耗,0,0,0,0,1,0,0,1,0.24166666666666667
北斗rdss移动终端,0,0,0,0,1,0,0,1,0.24166666666666667
集总干扰场景,0,0,0,0,1,0,0,1,0.24166666666666667
蒙特卡罗系统,0,0,0,0,1,1,0,2,0.48333333333333334
点对点干扰场景,0,0,0,0,1,0,0,1,0.24166666666666667
1mt系统,0,0,0,0,1,0,0,1,0.24166666666666667
共存场景搭,0,0,0,0,1,0,0,1,0.24166666666666667
ghz,0,0,0,0,5,0,0,5,1.2083333333333333
itu,0,0,0,1,3,0,0,4,0.85
大气压,0,0,0,0,2,0,0,2,0.48333333333333334
压强,0,0,0,0,2,0,0,2,0.48333333333333334
exp,0,0,0,0,2,0,0,2,0.48333333333333334
温度,0,0,0,0,2,0,0,2,0.48333333333333334
干燥空气,0,0,0,0,2,0,0,2,0.48333333333333334
大气气体衰减,0,0,0,0,2,0,0,2,0.48333333333333334
空对地模型,0,0,0,0,2,0,0,2,0.48333333333333334
水汽密度,0,0,0,0,1,0,0,1,0.24166666666666667
大气衰减值,0,0,0,0,1,0,0,1,0.24166666666666667
水汽,0,0,0,0,1,0,0,1,0.24166666666666667
温度数据,0,0,0,0,1,0,0,1,0.24166666666666667
hpa,0,0,0,0,1,0,0,1,0.24166666666666667
压力,0,0,0,0,1,0,0,1,0.24166666666666667
总空气压力,0,0,0,0,1,0,0,1,0.24166666666666667
大气衰减,0,0,0,0,1,0,0,1,0.24166666666666667
总路径,0,0,0,0,1,0,0,1,0.24166666666666667
水蒸气密度,0,0,0,0,1,0,0,1,0.24166666666666667
定衰减,0,0,0,0,1,0,0,1,0.24166666666666667
水蒸气,0,0,0,0,1,0,0,1,0.24166666666666667
气体吸收,0,0,0,0,1,0,0,1,0.24166666666666667
基本传输损耗,0,0,0,0,1,0,0,1,0.24166666666666667
自由空间传播,0,0,0,0,1,0,0,1,0.24166666666666667
短期效应,0,0,0,0,1,0,0,1,0.24166666666666667
视距传输,0,0,0,0,1,0,0,1,0.24166666666666667
地对地传输,0,0,0,0,1,0,0,1,0.24166666666666667
地对地模型,0,0,0,0,1,0,0,1,0.24166666666666667
自由空间传播模型,0,0,0,0,1,0,0,1,0.24166666666666667
地对地传输路径,0,0,0,0,1,0,0,1,0.24166666666666667
传输路径,0,0,0,0,1,0,0,1,0.24166666666666667
q函数,0,0,0,0,0,2,0,2,0.48333333333333334
cdf,0,0,0,0,0,2,0,2,0.48333333333333334
离散干扰分布,0,0,0,0,0,2,0,2,0.48333333333333334
高斯拟合曲线,0,0,0,0,0,2,0,2,0.48333333333333334
高斯拟合,0,0,0,0,0,2,0,2,0.48333333333333334
12ppp模型,0,0,0,0,0,1,0,1,0.24166666666666667
q函数仿真,0,0,0,0,0,1,0,1,0.24166666666666667
仿真结果,0,0,0,0,0,1,0,1,0.24166666666666667
ppp模型理论,0,0,0,0,0,1,0,1,0.24166666666666667
相邻频率隔离变,0,0,0,0,0,1,0,1,0.24166666666666667
1mt,0,0,0,0,0,1,0,1,0.24166666666666667
ppp,0,0,0,0,0,1,0,1,0.24166666666666667
dmetaaci,0,0,0,0,0,1,0,1,0.24166666666666667
等效,0,0,0,0,0,1,0,1,0.24166666666666667
高斯函数,0,0,0,0,0,1,1,2,0.48333333333333334
高斯分布曲线,0,0,0,0,0,1,0,1,0.24166666666666667
高斯曲线,0,0,0,0,0,1,0,1,0.24166666666666667
高斯分布式,0,0,0,0,0,1,0,1,0.24166666666666667
离散分布,0,0,0,0,0,1,0,1,0.24166666666666667
高斯拟合分布,0,0,0,0,0,1,0,1,0.24166666666666667
干扰值分布,0,0,0,0,0,1,0,1,0.24166666666666667
仿真干扰值,0,0,0,0,0,1,0,1,0.24166666666666667
蒙特卡罗离散分布,0,0,0,0,0,1,0,1,0.24166666666666667
衰落因子,0,0,0,0,0,1,0,1,0.24166666666666667
小速度,0,0,0,0,0,1,0,1,0.24166666666666667
集总干扰九,0,0,0,0,0,1,0,1,0.24166666666666667
iss,0,0,0,0,0,1,0,1,0.24166666666666667
中心地面站,0,0,0,0,0,1,0,1,0.24166666666666667
同心环,0,0,0,0,0,1,0,1,0.24166666666666667
宽度,0,0,0,0,0,1,0,1,0.24166666666666667
内径,0,0,0,0,0,1,0,1,0.24166666666666667
性质,0,0,0,0,0,1,0,1,0.24166666666666667
非参数检验,0,0,0,0,0,1,0,1,0.24166666666666667
概率分布,0,0,0,0,0,1,0,1,0.24166666666666667
-smirnov,0,0,0,0,0,1,0,1,0.24166666666666667
ogor,0,0,0,0,0,1,0,1,0.24166666666666667
和k-s检,0,0,0,0,0,1,0,1,0.24166666666666667
蒙特卡罗统计仿,0,0,0,0,0,1,0,1,0.24166666666666667
独立分布,0,0,0,0,0,1,0,1,0.24166666666666667
中心极限,0,0,0,0,0,1,0,1,0.24166666666666667
授时,0,0,2,0,0,0,0,2,0.25
开放服务,0,0,2,0,0,0,0,2,0.25
公安,0,0,1,0,0,0,0,1,0.125
灾害预报,0,0,1,0,0,0,0,1,0.125
森林防火,0,0,1,0,0,0,0,1,0.125
海洋,0,0,1,0,0,0,0,1,0.125
石油,0,0,1,0,0,0,0,1,0.125
气象,0,0,1,0,0,0,0,1,0.125
系统组网,0,0,1,0,0,0,0,1,0.125
北斗导航卫星,0,0,1,0,0,0,0,1,0.125
通信服务,0,0,1,0,0,0,0,1,0.125
授权用户,0,0,1,0,0,0,0,1,0.125
授权服务,0,0,1,0,0,0,0,1,0.125
测速精度,0,0,1,0,0,0,0,1,0.125
授时精度,0,0,1,0,0,0,0,1,0.125
服务,0,0,1,0,0,0,0,1,0.125
授权服,0,0,1,0,0,0,0,1,0.125
非静止轨道卫星,0,0,1,0,0,0,0,1,0.125
高精度授时能力,0,0,1,0,0,0,0,1,0.125
实时无源三维定位测速,0,0,1,0,0,0,0,1,0.125
compassnavigations,0,0,1,0,0,0,0,1,0.125
system,0,0,1,0,0,0,0,1,0.125
beidounavigation,0,0,1,0,0,0,0,1,0.125
北斗卫星导航试验系统,0,0,1,0,0,0,0,1,0.125
北斗一代导航系统,0,0,1,0,0,0,0,1,0.125
导航定位功能,0,0,1,0,0,0,0,1,0.125
民用客户,0,0,1,0,0,0,0,1,0.125
地球静止轨道卫星,0,0,1,0,0,0,0,1,0.125
短报文通信,0,0,1,0,0,0,0,1,0.125
卫星导航信息,0,0,1,0,0,0,0,1,0.125
静止卫星定位导航系统,0,0,1,0,0,0,0,1,0.125
beidou,0,0,1,0,0,0,0,1,0.125
compass,1,0,1,0,0,0,0,2,1.125
imt基,0,0,3,0,0,0,0,3,0.375
北斗地面站天线,0,0,2,0,0,0,0,2,0.25
北斗地球站,0,0,2,0,0,0,0,2,0.25
可得增益,0,0,1,0,0,0,0,1,0.125
imghz,0,0,1,0,0,0,0,1,0.125
参数接口,0,0,0,1,0,0,0,1,0.125
数学建模,0,0,0,1,0,0,0,1,0.125
干扰共存机制,0,0,0,1,0,0,0,1,0.125
电磁兼容,0,0,0,1,0,0,0,1,0.125
滤波器指标,0,0,0,0,0,0,2,2,0.48333333333333334
标准滤波器,0,0,0,0,0,0,2,2,0.48333333333333334
频谱分配,0,0,0,0,0,0,1,1,0.24166666666666667
干扰共存分,0,0,0,0,0,0,1,1,0.24166666666666667
异构系统,0,0,0,0,0,0,1,1,0.24166666666666667
分布,0,0,0,0,0,0,1,1,0.24166666666666667
同区域共存,0,0,0,0,0,0,1,1,0.24166666666666667
邻频】mt系统,0,0,0,0,0,0,1,1,0.24166666666666667
系统间干扰共存,1,0,0,0,0,0,1,2,1.2416666666666667
共存研究,0,0,0,0,0,0,1,1,0.24166666666666667
终端盒,0,0,0,0,0,0,1,1,0.24166666666666667
频谱密度,0,0,0,3,0,0,0,3,0.375
入站信号,0,0,0,3,0,0,0,3,0.375
出站信号,0,0,0,3,0,0,0,3,0.375
后相关器,0,0,0,2,0,0,0,2,0.25
过程衰减,0,0,0,2,0,0,0,2,0.25
地面站控制中心,0,0,0,2,0,0,0,2,0.25
热噪声权衡因子,0,0,0,1,0,0,0,1,0.125
玻尔兹曼常数,0,0,0,1,0,0,0,1,0.125
通用门限,0,0,0,1,0,0,0,1,0.125
rs,0,0,0,1,0,0,0,1,0.125
等效c,0,0,0,1,0,0,0,1,0.125
合计干扰,0,0,0,1,0,0,0,1,0.125
无线电信号,0,0,0,1,0,0,0,1,0.125
等效白噪声功率,0,0,0,1,0,0,0,1,0.125
有效接收器,0,0,0,1,0,0,0,1,0.125
有效热噪声因数,0,0,0,1,0,0,0,1,0.125
无量纲,0,0,0,1,0,0,0,1,0.125
前相关器,0,0,0,1,0,0,0,1,0.125
接收器,0,0,0,1,0,0,0,1,0.125
星群,0,0,0,1,0,0,0,1,0.125
相关器,0,0,0,1,0,0,0,1,0.125
等效c/n,0,0,0,1,0,0,0,1,0.125
连续干扰,0,0,0,1,0,0,0,1,0.125
干扰解析法,0,0,0,1,0,0,0,1,0.125
viterbi译码,0,0,0,1,0,0,0,1,0.125
卷积码编码,0,0,0,1,0,0,0,1,0.125
效率,0,0,0,1,0,0,0,1,0.125
约束长度,0,0,0,1,0,0,0,1,0.125
数据编码,0,0,0,1,0,0,0,1,0.125
解调损失,0,0,0,1,0,0,0,1,0.125
终端解扩,0,0,0,1,0,0,0,1,0.125
通信基本理论,0,0,0,1,0,0,0,1,0.125
单边噪声功率谱密度,0,0,0,1,0,0,0,1,0.125
平均比特能量,0,0,0,1,0,0,0,1,0.125
数据解调,0,0,0,1,0,0,0,1,0.125
bpsk调制,0,0,0,1,0,0,0,1,0.125
0qpsk调制,0,0,0,1,0,0,0,1,0.125
编码,0,0,0,1,0,0,0,1,0.125
ps,0,0,0,1,0,0,0,1,0.125
初始速率,0,0,0,1,0,0,0,1,0.125
卫星箱,0,0,0,1,0,0,0,1,0.125
卫星系统,0,0,0,1,0,0,0,1,0.125
通信信号,0,0,0,1,0,0,0,1,0.125
北斗终端干扰保护准则,0,0,0,1,0,0,0,1,0.125
入端,0,0,0,1,0,0,0,1,0.125
容许干扰功率,0,0,0,1,0,0,0,1,0.125
lte接收机,0,0,0,1,0,0,0,1,0.125
3gppltets,0,0,0,1,0,0,0,1,0.125
北斗卫星导航系统卫星无线电测定业务TD-LTE系统,0,1,0,0,0,0,0,1,2.0
 IMT及其演进系统干扰共存二维泊松点分布,0,1,0,0,0,0,0,1,2.0
频谱资源,2,0,0,0,0,0,0,2,2.0
链路预算准则,1,0,0,0,0,0,0,1,1.0
无线电测定业务,1,0,0,0,0,0,0,1,1.0
radiodeterminations,1,0,0,0,0,0,0,1,1.0
atelliteservice,1,0,0,0,0,0,0,1,1.0
北斗固定地面站,1,0,0,0,0,0,0,1,1.0
共存评估条,1,0,0,0,0,0,0,1,1.0
poissonpointprocess,1,0,0,0,0,0,0,1,1.0
随机几何原理,1,0,0,0,0,0,0,1,1.0
干扰共存评估,1,0,0,0,0,0,0,1,1.0
国民经济,1,0,0,0,0,0,0,1,1.0
国防建设,1,0,0,0,0,0,0,1,1.0
基础设施,1,0,0,0,0,0,0,1,1.0
无线通信业务,1,0,0,0,0,0,0,1,1.0
mobiletelecommunications,1,0,0,0,0,0,0,1,1.0
移动宽带,1,0,0,0,0,0,0,1,1.0
