,摘要,关键词,第一章,第二章,第三章,第四章,第五章,总词频,加权得分
虚拟网络,11,0,22,43,28,51,11,166,40.875
底层网络,7,0,6,34,10,81,12,150,36.891666666666666
重映射,2,0,5,7,0,48,2,64,15.583333333333334
重映射算法,3,0,12,6,0,28,6,55,13.466666666666667
映射,1,0,3,17,18,8,0,47,9.783333333333333
请求,2,0,4,16,11,16,5,54,12.233333333333334
负载,2,0,1,4,0,12,0,19,5.525
能量消耗,0,0,0,3,0,0,0,3,0.375
虚拟链路,1,0,0,15,8,9,1,34,7.225
负载均衡,0,0,0,5,0,7,0,12,2.3166666666666664
资源瓶颈,1,0,5,3,0,12,3,24,5.625
底层链路,0,0,1,7,4,6,0,18,3.4166666666666665
静态虚拟网络,1,0,1,3,0,0,0,5,1.5
启发式算法,1,0,0,5,4,0,2,12,3.075
被动机制,0,0,0,2,0,0,0,2,0.25
虚拟节点,1,0,1,15,16,65,2,100,23.058333333333334
链路,0,0,0,9,0,15,0,24,4.75
底层节点,2,0,3,10,21,75,1,112,27.066666666666666
动态虚拟网络,0,0,1,2,0,0,0,3,0.375
故障,0,0,0,3,0,0,0,3,0.375
备份资源,0,0,0,1,0,0,0,1,0.125
备份链路,0,0,0,1,0,0,0,1,0.125
路径,0,0,0,1,1,1,0,3,0.6083333333333334
网络运营商,1,0,2,2,0,0,0,5,1.5
底层资源,0,0,0,2,0,3,0,5,0.975
拟网络映射,0,0,0,1,0,0,0,1,0.125
可生存性,0,0,0,1,0,0,0,1,0.125
保护机制,0,0,0,1,0,0,0,1,0.125
恢复机制,0,0,0,1,0,0,0,1,0.125
运营,0,0,0,1,0,0,0,1,0.125
能耗,0,0,0,1,0,0,0,1,0.125
数学建模,0,0,0,1,0,0,0,1,0.125
混合整数线性规划,0,0,0,1,0,0,0,1,0.125
动态变化,0,0,0,1,0,0,0,1,0.125
拓扑结构,0,0,0,2,2,0,0,4,0.7333333333333334
资源,3,0,0,11,1,11,2,28,7.758333333333333
网络拓扑结构,0,0,0,1,0,0,0,1,0.125
资源需求,0,0,0,1,0,0,0,1,0.125
虚拟网络请求,1,0,2,5,10,12,1,31,7.433333333333334
重映射开,0,0,0,1,0,0,0,1,0.125
运营收益,0,0,0,1,0,0,0,1,0.125
仿真实验,0,0,0,1,2,1,0,4,0.85
启动周期,0,0,0,1,0,0,0,1,0.125
重映射操作,0,0,0,1,0,7,2,10,2.3
自适应区间,0,0,0,1,0,0,0,1,0.125
接受率,1,0,2,6,6,13,3,31,7.316666666666666
目标函数,0,0,1,2,0,0,0,3,0.375
负载压力,0,0,0,1,0,6,0,7,1.575
瓶颈链路,0,0,0,1,0,0,0,1,0.125
瓶颈节点,0,0,0,1,0,1,0,2,0.3666666666666667
重映射资源,0,0,0,1,0,0,0,1,0.125
负载均衡度,0,0,0,1,0,0,0,1,0.125
过载链路,0,0,0,1,0,0,0,1,0.125
过载节点,0,0,0,1,0,0,0,1,0.125
节点,5,0,14,12,12,200,8,251,61.416666666666664
负载状态,0,0,0,1,0,7,0,8,1.8166666666666667
周期,0,0,0,1,0,1,0,2,0.3666666666666667
主动式重映射算法,0,0,0,1,0,0,0,1,0.125
被动式重映射算法,0,0,0,1,0,0,0,1,0.125
主动式,0,0,0,1,0,0,0,1,0.125
被动式,0,0,0,1,0,0,0,1,0.125
触发时机,0,0,0,1,0,0,0,1,0.125
重映射过程,0,0,0,1,0,0,0,1,0.125
资源碎片化,1,0,1,1,0,4,1,8,2.458333333333333
动态调整过程,0,0,0,1,0,0,0,1,0.125
映射方案,0,0,0,2,2,3,0,7,1.4583333333333333
映射算法,1,0,3,6,2,0,0,12,2.6083333333333334
动态,0,0,0,1,0,0,0,1,0.125
性能指标,0,0,1,1,3,2,2,9,1.9416666666666667
虚拟网络映射算法,0,0,8,12,8,3,2,33,5.641666666666667
仿真环境,0,0,1,0,3,1,0,5,1.0916666666666668
曲线,0,0,0,0,1,0,0,1,0.24166666666666667
算法性能,0,0,0,1,1,0,0,2,0.3666666666666667
收益开销比,0,0,0,0,1,0,0,1,0.24166666666666667
均运营收益,0,0,0,0,1,0,0,1,0.24166666666666667
持续时间,0,0,0,0,1,0,0,1,0.24166666666666667
带宽资源,0,0,0,5,3,4,0,12,2.3166666666666664
计算资源,0,0,0,4,3,4,0,11,2.1916666666666664
拓扑参数,0,0,0,0,1,0,0,1,0.24166666666666667
虚拟网络拓扑,0,0,0,0,1,0,0,1,0.24166666666666667
底层网络拓扑,0,0,0,0,3,3,0,6,1.45
仿真场景,0,0,0,0,1,0,0,1,0.24166666666666667
内存,0,0,0,1,1,0,0,2,0.3666666666666667
四核处理器,0,0,0,0,1,0,0,1,0.24166666666666667
i7,0,0,0,0,1,0,0,1,0.24166666666666667
英特尔,0,0,0,0,1,0,0,1,0.24166666666666667
中央处理器,0,0,0,0,1,0,0,1,0.24166666666666667
操作系统,0,0,0,0,1,0,0,1,0.24166666666666667
结果分析模块,0,0,0,0,1,0,0,1,0.24166666666666667
数据更新模块,0,0,0,0,1,0,0,1,0.24166666666666667
算法执行模块,0,0,0,0,1,0,0,1,0.24166666666666667
处理模块,0,0,0,0,1,0,0,1,0.24166666666666667
读取,0,0,0,0,1,0,0,1,0.24166666666666667
网络拓扑,0,0,0,0,1,8,0,9,2.175
仿真平台,0,0,0,0,3,1,1,5,1.2083333333333333
仿真,2,0,2,1,3,3,2,13,4.308333333333334
映射仿真实验平台,0,0,0,0,1,0,0,1,0.24166666666666667
科学计算,0,0,0,0,1,0,0,1,0.24166666666666667
matplotlib,0,0,0,0,1,0,0,1,0.24166666666666667
sciy,0,0,0,0,1,0,0,1,0.24166666666666667
数据分析,0,0,0,0,1,0,0,1,0.24166666666666667
代码量,0,0,0,0,1,0,0,1,0.24166666666666667
可移植性,0,0,0,0,1,0,0,1,0.24166666666666667
可扩展性,0,0,0,1,1,0,0,2,0.3666666666666667
效率,0,0,0,0,1,0,0,1,0.24166666666666667
可阅读性,0,0,0,0,1,0,0,1,0.24166666666666667
python语言,0,0,0,0,1,0,0,1,0.24166666666666667
服务供应商,0,0,2,9,0,0,0,11,1.375
基础设施供应商,0,0,3,19,0,0,0,22,2.75
网络,0,0,7,9,0,3,3,22,3.45
同轴电缆,0,0,0,2,0,0,0,2,0.25
光纤,0,0,0,2,0,0,0,2,0.25
路由器,0,0,0,4,0,0,0,4,0.5
交换机,0,0,0,4,0,0,0,4,0.5
互联网服务,0,0,0,2,0,0,0,2,0.25
互联网业务供应商,0,0,1,2,0,0,0,3,0.375
网络虚拟化,1,0,2,11,0,0,1,15,2.8666666666666667
网络设备,0,0,2,2,0,0,0,4,0.5
设备,0,0,0,4,0,0,0,4,0.5
互联网,1,0,7,2,0,0,1,11,2.3666666666666667
架构,0,0,0,1,0,0,0,1,0.125
技术,0,0,1,1,0,0,0,2,0.25
网络设备资源,0,0,0,1,0,0,0,1,0.125
网络虚拟化技术,1,0,7,14,0,0,1,23,3.8666666666666667
拓扑,0,0,0,1,0,0,0,1,0.125
通信链路,0,0,0,1,0,0,0,1,0.125
计算设备,0,0,0,1,0,0,0,1,0.125
供应商,0,0,0,2,0,0,0,2,0.25
网络带宽资源,0,0,0,1,0,0,0,1,0.125
双绞线,0,0,0,1,0,0,0,1,0.125
底层物理网络,0,0,1,3,0,0,0,4,0.5
服务器,0,0,0,4,0,0,0,4,0.5
虚拟化架构,0,0,0,1,0,0,0,1,0.125
网络硬件设备,0,0,0,1,0,0,0,1,0.125
底层物理设备,0,0,0,1,0,0,0,1,0.125
佣金,0,0,0,1,0,0,0,1,0.125
网络基础设施,0,0,0,1,0,0,0,1,0.125
硬件设,0,0,0,1,0,0,0,1,0.125
网络业务,0,0,0,1,0,0,0,1,0.125
网络结构,0,0,0,1,0,0,0,1,0.125
网络业务供应商,0,0,0,1,0,0,0,1,0.125
网络体系,1,0,3,2,0,0,0,6,1.625
新技术,0,0,0,1,0,0,0,1,0.125
厂商,0,0,0,1,0,0,0,1,0.125
软件,0,0,0,1,0,0,0,1,0.125
硬件,0,0,1,1,0,0,0,2,0.25
网络硬件厂商,0,0,0,1,0,0,0,1,0.125
传统网络架构,0,0,0,1,0,0,0,1,0.125
硬件设备,0,0,1,1,0,0,0,2,0.25
网络架构,0,0,3,2,0,0,1,6,0.8666666666666667
网络虚拟化架构,0,0,0,1,0,0,0,1,0.125
负载率,0,0,3,0,1,32,1,37,8.591666666666667
动态阈值,0,0,1,0,0,8,1,10,2.3
待重映射,0,0,0,0,0,12,0,12,2.9
过载,0,0,1,0,0,9,0,10,2.3
rt,0,0,0,0,0,2,0,2,0.48333333333333334
伪代码,0,0,0,0,2,2,0,4,0.9666666666666667
vnr-ni,0,0,0,0,0,20,0,20,4.833333333333333
迁移,0,0,0,0,0,3,0,3,0.725
目标节点,0,0,0,0,0,7,0,7,1.6916666666666667
重要节点,0,0,0,0,0,4,0,4,0.9666666666666667
要节点,0,0,1,0,0,4,0,5,1.0916666666666668
vnr-ni算法,0,0,0,0,0,5,1,6,1.45
substratenetwork,0,0,0,0,0,1,0,1,0.24166666666666667
rithmupdate,0,0,0,0,0,1,0,1,0.24166666666666667
th,0,0,0,0,0,1,0,1,0.24166666666666667
rtual,0,0,0,0,0,1,0,1,0.24166666666666667
tondwithminimum,0,0,0,0,0,1,0,1,0.24166666666666667
nv,0,0,0,1,0,4,0,5,1.0916666666666668
ocalcula,0,0,0,0,0,1,0,1,0.24166666666666667
ce,0,0,0,0,0,1,0,1,0.24166666666666667
in,0,0,0,0,0,1,0,1,0.24166666666666667
according,0,0,0,0,0,1,0,1,0.24166666666666667
des,0,0,0,0,0,1,0,1,0.24166666666666667
sortthevirtual,0,0,0,0,0,1,0,1,0.24166666666666667
firstm,0,0,0,0,0,1,0,1,0.24166666666666667
loadra,0,0,0,0,0,1,0,1,0.24166666666666667
tm,0,0,0,0,0,1,0,1,0.24166666666666667
fi,0,0,0,0,0,1,0,1,0.24166666666666667
ra,0,0,0,0,0,1,0,1,0.24166666666666667
ula,0,0,0,0,0,1,0,1,0.24166666666666667
ndi,0,0,0,0,0,1,0,1,0.24166666666666667
om,0,0,0,0,0,1,0,1,0.24166666666666667
int,0,0,0,0,0,1,0,1,0.24166666666666667
ti,0,0,0,0,1,1,0,2,0.48333333333333334
load,0,0,0,0,0,1,0,1,0.24166666666666667
omm,0,0,0,0,0,1,0,1,0.24166666666666667
ldubyformula,0,0,0,0,0,1,0,1,0.24166666666666667
loadratethres,0,0,0,0,0,1,0,1,0.24166666666666667
calculatedynamic,0,0,0,0,0,1,0,1,0.24166666666666667
ns,0,0,0,0,0,1,0,1,0.24166666666666667
链路约束条件,0,0,0,0,1,1,0,2,0.48333333333333334
状态,0,0,0,0,0,1,0,1,0.24166666666666667
nd,0,0,0,0,1,2,0,3,0.725
lc,0,0,0,0,0,1,0,1,0.24166666666666667
重映射链路,1,0,1,0,0,4,0,6,2.091666666666667
n血询,0,0,0,0,0,1,0,1,0.24166666666666667
ncandidate,0,0,0,0,0,1,0,1,0.24166666666666667
动态阈,0,0,0,0,0,1,0,1,0.24166666666666667
底层节点集合,0,0,0,0,0,1,0,1,0.24166666666666667
多维度属性,1,0,2,0,0,11,1,15,4.15
初始化,0,0,0,0,4,1,0,5,1.2083333333333333
负載率,0,0,0,0,0,1,0,1,0.24166666666666667
底层节,0,0,0,0,0,1,0,1,0.24166666666666667
映射集合,0,0,0,0,0,1,0,1,0.24166666666666667
牧益比,0,0,0,0,0,1,0,1,0.24166666666666667
平均负载率,0,0,0,0,0,3,0,3,0.725
遗传算法,1,0,2,3,40,0,2,48,11.775
粒子群算法,1,1,2,1,34,0,1,40,11.833333333333334
选择操作,0,0,0,0,2,0,0,2,0.48333333333333334
元胞自动机,1,0,4,0,29,0,1,35,8.75
元胞遗传,0,0,2,0,4,0,0,6,1.2166666666666668
粒子群,1,0,2,0,23,0,0,26,6.808333333333334
变异算子,1,0,1,0,8,0,1,11,3.3
选择算子,0,0,0,0,3,0,0,3,0.725
变异操作,2,0,0,0,11,0,2,15,5.141666666666667
扩散,0,0,1,0,1,0,0,2,0.3666666666666667
超级个体,0,0,0,0,4,0,1,5,1.2083333333333333
全局搜索,0,0,0,0,2,0,0,2,0.48333333333333334
变异操,0,0,0,0,5,0,0,5,1.2083333333333333
交叉,1,0,0,0,9,0,0,10,3.175
早熟,0,0,0,0,1,0,0,1,0.24166666666666667
收敛速度,3,0,2,1,19,0,1,26,8.208333333333332
带宽资源量,0,0,0,3,0,0,0,3,0.375
资源量,0,0,0,6,4,8,0,18,3.65
生存时间,0,0,0,2,1,1,0,4,0.7333333333333334
数字,0,0,0,2,0,0,0,2,0.25
链路集合,0,0,0,2,0,0,0,2,0.25
节点集合,0,0,0,2,0,0,0,2,0.25
eveev,0,0,0,1,0,0,0,1,0.125
nvenv,0,0,0,1,0,0,0,1,0.125
带权无向全连通,0,0,0,1,0,0,0,1,0.125
可用链路,0,0,0,1,0,0,0,1,0.125
esees,0,0,0,1,0,0,0,1,0.125
带权无向全连通图,0,0,0,1,0,0,0,1,0.125
网络模型,0,0,0,1,0,0,0,1,0.125
带宽约束条件,0,0,0,0,3,2,0,5,1.2083333333333333
虚拟链路带宽,0,0,0,0,0,2,0,2,0.48333333333333334
跳数,0,0,0,0,0,2,0,2,0.48333333333333334
短路径,0,0,0,0,0,6,0,6,1.45
邻居,0,0,0,0,8,3,0,11,2.658333333333333
邻居节点集合,0,0,0,0,0,2,0,2,0.48333333333333334
neigh,0,0,0,0,0,2,0,2,0.48333333333333334
剩余带宽,0,0,0,0,0,1,0,1,0.24166666666666667
最短路径,0,0,0,0,0,3,0,3,0.725
dijkstra算法,0,0,0,0,2,1,0,3,0.725
ndgncandidate,0,0,0,0,0,1,0,1,0.24166666666666667
候选目标节点,0,0,0,0,0,1,0,1,0.24166666666666667
nv计算资源,0,0,0,0,0,1,0,1,0.24166666666666667
剩余资源,0,0,0,0,0,4,0,4,0.9666666666666667
元胞空间,0,0,0,0,11,0,0,11,2.658333333333333
中心元胞,0,0,0,0,6,0,0,6,1.45
个体,0,0,2,0,29,0,2,33,7.741666666666667
演化规则,1,0,4,0,15,0,1,21,5.366666666666667
生存状态,0,0,0,0,8,0,0,8,1.9333333333333333
自然界,0,0,0,0,5,0,0,5,1.2083333333333333
元胞,1,0,0,0,4,0,0,5,1.9666666666666668
摩尔型邻居,0,0,0,0,4,0,0,4,0.9666666666666667
生物个体,0,0,0,0,2,0,0,2,0.48333333333333334
三角形,0,0,0,0,2,0,0,2,0.48333333333333334
二维元胞自动机,0,0,0,0,2,0,0,2,0.48333333333333334
二进制,0,0,0,0,3,0,0,3,0.725
元胞状态,0,0,0,0,2,0,0,2,0.48333333333333334
元胞邻居,0,0,0,0,2,0,0,2,0.48333333333333334
元胞个体,0,0,0,0,7,0,0,7,1.6916666666666667
生命游戏,0,0,0,0,2,0,0,2,0.48333333333333334
动力学行为,0,0,0,0,1,0,0,1,0.24166666666666667
邻居元胞,0,0,0,0,1,0,0,1,0.24166666666666667
时刻,0,0,0,1,1,0,0,2,0.3666666666666667
时刻中心元胞,0,0,0,0,1,0,0,1,0.24166666666666667
状态转移函数,0,0,0,0,2,0,0,2,0.48333333333333334
自动机,0,0,0,0,1,0,0,1,0.24166666666666667
动态概,0,0,0,0,1,0,0,1,0.24166666666666667
演化过程,0,0,0,0,1,0,0,1,0.24166666666666667
空间结构,0,0,1,0,5,0,0,6,1.3333333333333333
边界元胞邻居,0,0,0,0,1,0,0,1,0.24166666666666667
圆环面,0,0,0,0,1,0,0,1,0.24166666666666667
边界,0,0,0,0,2,0,0,2,0.48333333333333334
周期型边界条件,0,0,0,0,2,0,0,2,0.48333333333333334
冯诺依曼型邻居,0,0,0,0,1,0,0,1,0.24166666666666667
邻居类型,0,0,0,0,1,0,0,1,0.24166666666666667
四边形,0,0,0,0,1,0,0,1,0.24166666666666667
然界,0,0,0,0,1,0,0,1,0.24166666666666667
六边形排列,0,0,0,0,1,0,0,1,0.24166666666666667
四边形网格,0,0,0,0,1,0,0,1,0.24166666666666667
计算机,0,0,1,0,1,0,0,2,0.3666666666666667
六边形,0,0,0,0,1,0,0,1,0.24166666666666667
矩形,0,0,0,0,1,0,0,1,0.24166666666666667
二维状态,0,0,0,0,1,0,0,1,0.24166666666666667
多进制,0,0,0,0,1,0,0,1,0.24166666666666667
晶格空间,0,0,0,0,1,0,0,1,0.24166666666666667
进化群体,0,0,0,0,1,0,0,1,0.24166666666666667
自然现象,0,0,0,0,1,0,0,1,0.24166666666666667
灭绝,0,0,0,0,1,0,0,1,0.24166666666666667
生存,0,0,0,0,4,0,0,4,0.9666666666666667
生物演化,0,0,0,0,1,0,0,1,0.24166666666666667
计算机游戏,0,0,0,0,1,0,0,1,0.24166666666666667
机器,0,0,0,0,1,0,0,1,0.24166666666666667
cellularautomata,0,0,0,0,1,0,0,1,0.24166666666666667
自我复制行为,0,0,0,0,1,0,0,1,0.24166666666666667
生物,0,0,0,0,1,0,0,1,0.24166666666666667
uma,0,0,0,0,1,0,0,1,0.24166666666666667
诺依曼,0,0,0,0,1,0,0,1,0.24166666666666667
染色体,0,0,0,0,46,0,0,46,11.116666666666667
初始种群,0,0,0,0,22,0,0,22,5.316666666666666
种群,0,0,3,0,25,0,1,29,6.658333333333333
基因,0,0,0,0,11,0,0,11,2.658333333333333
适应度函数,0,0,0,0,10,0,0,10,2.4166666666666665
交叉概率,0,0,0,0,3,0,0,3,0.725
选择压力,0,0,0,0,5,0,0,5,1.2083333333333333
算法,2,0,3,2,13,0,1,21,6.008333333333333
质量,0,0,1,0,11,0,0,12,2.783333333333333
压力,0,0,0,0,2,0,0,2,0.48333333333333334
适应度数,0,0,0,0,5,0,0,5,1.2083333333333333
父代,0,0,0,0,2,0,0,2,0.48333333333333334
轮盘赌策略,0,0,0,0,2,0,0,2,0.48333333333333334
极值,0,0,0,0,4,0,0,4,0.9666666666666667
变异,0,0,0,0,8,0,1,9,2.175
最优染色体,0,0,0,0,2,0,0,2,0.48333333333333334
代数,0,0,0,0,2,0,0,2,0.48333333333333334
迭代,0,0,0,0,3,0,0,3,0.725
高斯变异,0,0,0,0,1,0,0,1,0.24166666666666667
一致变异,0,0,0,0,1,0,0,1,0.24166666666666667
基础变异,0,0,0,0,1,0,0,1,0.24166666666666667
基因多样性,0,0,0,0,1,0,0,1,0.24166666666666667
概率,0,0,0,0,6,7,0,13,3.1416666666666666
均匀交叉,0,0,0,0,1,0,0,1,0.24166666666666667
多点交叉,0,0,0,0,1,0,0,1,0.24166666666666667
单点交叉,0,0,0,0,1,0,0,1,0.24166666666666667
演化速度,0,0,0,0,1,0,0,1,0.24166666666666667
扩散速度,0,0,0,0,2,0,0,2,0.48333333333333334
内部结构,0,0,0,0,2,0,0,2,0.48333333333333334
优质染色体,0,0,0,0,2,0,0,2,0.48333333333333334
种群进化,0,0,0,0,2,0,0,2,0.48333333333333334
基因片段,0,0,0,0,1,0,0,1,0.24166666666666667
父代染色体,0,0,0,0,3,0,0,3,0.725
交叉操作,0,0,0,0,5,0,0,5,1.2083333333333333
生态多样性,0,0,0,0,1,0,0,1,0.24166666666666667
动态调节,0,0,0,0,1,0,0,1,0.24166666666666667
调节因子,0,0,0,0,1,0,0,1,0.24166666666666667
适应度,0,0,0,0,8,0,0,8,1.9333333333333333
平均适应度,0,0,0,0,2,0,0,2,0.48333333333333334
自适应排序,0,0,0,0,1,0,0,1,0.24166666666666667
随机数,0,0,0,0,3,0,0,3,0.725
累加概率,0,0,0,0,1,0,0,1,0.24166666666666667
适应度数值,0,0,0,0,1,0,0,1,0.24166666666666667
随机搜索,0,0,0,0,1,0,0,1,0.24166666666666667
搜索过程,0,0,0,0,1,0,0,1,0.24166666666666667
种群多样性,0,0,0,0,2,0,0,2,0.48333333333333334
性能,0,0,1,1,4,0,0,6,1.2166666666666668
基因传导,0,0,0,0,1,0,0,1,0.24166666666666667
速度,0,0,0,1,8,0,0,9,2.0583333333333336
空间变换,0,0,0,0,1,0,0,1,0.24166666666666667
随机种群,0,0,0,0,1,0,0,1,0.24166666666666667
基因质量,0,0,0,0,1,0,0,1,0.24166666666666667
初始染色体,0,0,0,0,3,0,0,3,0.725
机制,0,0,0,0,1,0,0,1,0.24166666666666667
随机,0,0,0,0,1,0,0,1,0.24166666666666667
解集,0,0,0,0,1,0,0,1,0.24166666666666667
遗传编码,0,0,0,0,1,0,0,1,0.24166666666666667
编码,0,0,0,0,3,0,0,3,0.725
初始,0,0,0,0,1,0,0,1,0.24166666666666667
可行解集,0,0,0,0,1,0,0,1,0.24166666666666667
基因位点,0,0,0,0,2,0,0,2,0.48333333333333334
变量,0,0,0,0,1,0,0,1,0.24166666666666667
变量序列,0,0,0,0,3,0,0,3,0.725
全局搜索能力,0,0,1,0,3,0,1,5,1.0916666666666668
生物学理论,0,0,0,0,1,0,0,1,0.24166666666666667
优胜劣汰,0,0,0,0,1,0,0,1,0.24166666666666667
mutation,0,0,0,0,1,0,0,1,0.24166666666666667
crossover,0,0,0,0,1,0,0,1,0.24166666666666667
杂交,0,0,0,0,1,0,0,1,0.24166666666666667
selection,0,0,0,0,1,0,0,1,0.24166666666666667
自然选择,0,0,0,0,1,0,0,1,0.24166666666666667
遗传理论,0,0,0,0,1,0,0,1,0.24166666666666667
进化学说,0,0,0,0,1,0,0,1,0.24166666666666667
评价指标,0,0,0,0,0,5,0,5,1.2083333333333333
高负载,0,0,0,0,0,6,0,6,1.45
高负载节点,0,0,0,0,0,5,0,5,1.2083333333333333
价指,0,0,0,0,0,2,0,2,0.48333333333333334
重要性,0,0,0,0,0,1,0,1,0.24166666666666667
nodeimportance,0,0,0,0,0,1,0,1,0.24166666666666667
gorithmbase,0,0,0,0,0,1,0,1,0.24166666666666667
tional,0,0,0,0,0,1,0,1,0.24166666666666667
fig,0,0,0,0,0,1,0,1,0.24166666666666667
virtualnetwork,0,0,0,0,1,1,0,2,0.48333333333333334
连通性,1,0,0,0,0,17,1,19,5.35
动态调,0,0,0,0,0,1,0,1,0.24166666666666667
底层网络资源,1,0,0,1,1,2,1,6,2.091666666666667
资源利用率,0,0,0,1,0,2,0,3,0.6083333333333334
资源分配方案,0,0,0,0,0,1,0,1,0.24166666666666667
静态条件,0,0,0,0,0,1,0,1,0.24166666666666667
gaca,0,0,0,0,8,0,0,8,1.9333333333333333
蚁群融合算法,0,0,0,0,2,0,0,2,0.48333333333333334
遗传,0,0,0,0,2,0,0,2,0.48333333333333334
vne-pso-ga,0,0,0,0,8,0,0,8,1.9333333333333333
混合群智能优化算法,0,0,0,1,2,0,0,3,0.6083333333333334
请求接受率,2,0,0,0,2,3,0,7,3.208333333333333
长期收益,0,0,0,1,1,0,0,2,0.3666666666666667
vne-pcga算法,0,0,0,0,11,0,1,12,2.9
vne-pcga,0,0,0,0,13,5,0,18,4.35
元胞遗传虚拟网络映射算法,1,0,0,0,4,0,0,5,1.9666666666666668
算法仿真,0,0,0,0,1,1,0,2,0.48333333333333334
ta-vnr,0,0,0,0,0,13,0,13,3.1416666666666666
lc-vnr,0,0,0,0,0,10,0,10,2.4166666666666665
邻居节点,0,0,0,0,0,4,0,4,0.9666666666666667
链路重映射,0,0,0,0,0,1,0,1,0.24166666666666667
拓扑感知,0,0,0,0,0,2,0,2,0.48333333333333334
剩余资源量,0,0,0,0,1,5,0,6,1.45
算法复杂度,0,0,0,1,0,0,0,1,0.125
分母,0,0,0,1,0,0,0,1,0.125
请求数量,0,0,0,1,0,0,0,1,0.125
时间,0,0,0,2,8,9,0,19,4.358333333333333
分子,0,0,0,1,0,2,0,3,0.6083333333333334
基础设施,0,0,3,3,0,0,0,6,0.75
虚拟网络映射,1,1,5,9,15,2,2,35,9.341666666666667
服务提供,0,0,0,1,0,0,0,1,0.125
元胞遗传算法,1,1,3,0,1,0,0,6,3.6166666666666667
扩散性,1,0,2,0,0,0,0,3,1.25
优势个体,0,0,2,0,0,0,0,2,0.25
仿真实,0,0,1,0,1,0,0,2,0.3666666666666667
属性,0,0,1,0,0,16,0,17,3.9916666666666667
融合理论,0,0,1,0,0,0,0,1,0.125
拓扑属性,0,0,1,0,0,10,0,11,2.5416666666666665
序列结构,0,0,1,0,1,0,0,2,0.3666666666666667
变异点,1,0,1,0,12,0,0,14,4.025
个体信息,0,0,1,0,0,0,0,1,0.125
选择,0,0,1,0,0,0,0,1,0.125
融合式,0,0,1,0,0,0,0,1,0.125
网络虚拟化进程,0,0,1,0,0,0,0,1,0.125
网络技术,0,0,2,0,0,0,1,3,0.4916666666666667
虚拟网络映射问,0,0,1,0,0,0,1,2,0.3666666666666667
网络僵化,2,0,3,0,0,0,2,7,2.8583333333333334
智能化,0,0,1,0,0,0,0,1,0.125
信息化,0,0,1,0,0,0,0,1,0.125
虚拟网络映射模型,0,0,0,1,0,0,0,1,0.125
子代个体,0,0,0,0,7,0,0,7,1.6916666666666667
中心元胞个体,0,0,0,0,5,0,0,5,1.2083333333333333
子代,0,0,0,0,3,0,0,3,0.725
遗传操作,0,0,0,0,6,0,0,6,1.45
cellularstatebyform,0,0,0,0,1,0,0,1,0.24166666666666667
父代个体,0,0,0,0,2,0,0,2,0.48333333333333334
字代个体,0,0,0,0,1,0,0,1,0.24166666666666667
cha,0,0,0,0,1,0,0,1,0.24166666666666667
remainx,0,0,0,0,1,0,0,1,0.24166666666666667
fitnessvalue,0,0,0,0,1,0,0,1,0.24166666666666667
ba,0,0,0,0,1,0,0,1,0.24166666666666667
better,0,0,0,0,1,0,0,1,0.24166666666666667
ate,0,0,0,0,1,0,0,1,0.24166666666666667
bility,0,0,0,0,1,0,0,1,0.24166666666666667
feas,0,0,0,0,1,0,0,1,0.24166666666666667
交叉变异操,0,0,0,0,1,0,0,1,0.24166666666666667
状态元胞,0,0,0,0,1,0,0,1,0.24166666666666667
executemutationoperation,0,0,0,0,1,0,0,1,0.24166666666666667
executecrossoveroperation,0,0,0,0,1,0,0,1,0.24166666666666667
neighborhoods,0,0,0,0,1,0,0,1,0.24166666666666667
cellular,0,0,0,0,1,0,0,1,0.24166666666666667
pop,0,0,0,0,1,0,0,1,0.24166666666666667
mutationprobability,0,0,0,0,1,0,0,1,0.24166666666666667
ld,0,0,0,0,1,0,0,1,0.24166666666666667
res,0,0,0,0,1,0,0,1,0.24166666666666667
maxtimetmiteration,0,0,0,0,1,0,0,1,0.24166666666666667
nsfes,0,0,0,0,1,0,0,1,0.24166666666666667
pcga,0,0,0,0,1,5,0,6,1.45
链路映射,0,0,0,3,7,3,2,15,3.275
节点映射,0,0,0,2,9,0,0,11,2.425
终止条,0,0,0,0,1,0,0,1,0.24166666666666667
终止,0,0,0,0,1,0,0,1,0.24166666666666667
迭代次数,0,0,0,0,5,0,0,5,1.2083333333333333
个体更新,0,0,0,0,1,0,0,1,0.24166666666666667
带宽,0,0,0,0,1,1,0,2,0.48333333333333334
链路映射方案,0,0,0,0,1,0,0,1,0.24166666666666667
节点资源约束条件,0,0,0,0,3,0,0,3,0.725
可行性检查,0,0,0,0,1,0,0,1,0.24166666666666667
速度向量,0,0,0,0,2,0,0,2,0.48333333333333334
冲突,0,0,0,0,1,0,0,1,0.24166666666666667
片段,0,0,0,0,1,0,0,1,0.24166666666666667
配偶,0,0,0,0,1,0,0,1,0.24166666666666667
自适应调整因子,0,0,0,0,3,0,0,3,0.725
种群适应度,0,0,0,0,1,0,0,1,0.24166666666666667
初始速度,0,0,0,0,2,0,0,2,0.48333333333333334
pcga算法,0,0,0,0,1,0,0,1,0.24166666666666667
vne,0,0,0,0,1,1,0,2,0.48333333333333334
资源属性,0,0,0,0,0,12,0,12,2.9
证据合成规则,0,0,0,0,0,2,1,3,0.725
距离,0,0,0,0,0,3,0,3,0.725
紧密度,0,0,0,0,0,5,0,5,1.2083333333333333
随机游走模型,0,0,0,0,0,2,0,2,0.48333333333333334
介数中心性,0,0,0,0,0,5,0,5,1.2083333333333333
紧密度中心性,0,0,0,0,0,4,0,4,0.9666666666666667
度中心性,0,0,0,0,0,4,0,4,0.9666666666666667
收益,1,0,0,1,0,2,0,4,1.6083333333333334
成功率,0,0,0,0,0,1,0,1,0.24166666666666667
富度,0,0,0,0,0,1,0,1,0.24166666666666667
节点剩余,0,0,0,0,0,1,0,1,0.24166666666666667
节点度数,0,0,0,0,0,1,0,1,0.24166666666666667
可用带宽,0,0,0,0,0,1,0,1,0.24166666666666667
评价指,0,0,0,0,0,1,1,2,0.48333333333333334
拓扑连通性,0,0,0,0,0,1,0,1,0.24166666666666667
马尔科夫,0,0,0,0,0,1,0,1,0.24166666666666667
pagerank,0,0,0,0,0,1,0,1,0.24166666666666667
网页排名算法,0,0,0,0,0,1,0,1,0.24166666666666667
搜索引擎,0,0,0,0,0,1,0,1,0.24166666666666667
nk,0,0,0,0,0,1,0,1,0.24166666666666667
信息,0,0,0,1,1,4,0,6,1.3333333333333333
制网络,0,0,0,0,0,1,0,1,0.24166666666666667
中心性,0,0,0,0,0,6,0,6,1.45
位置信息,0,0,0,0,0,1,0,1,0.24166666666666667
局部网络,0,0,0,0,0,2,0,2,0.48333333333333334
度中心属性,0,0,0,0,0,1,0,1,0.24166666666666667
基本拓扑属性,0,0,0,0,0,1,0,1,0.24166666666666667
维度,0,0,0,0,1,6,0,7,1.6916666666666667
桥梁节点,0,0,0,0,0,2,0,2,0.48333333333333334
中心,0,0,0,0,0,1,0,1,0.24166666666666667
节点a,0,0,0,0,0,1,0,1,0.24166666666666667
总量,0,0,0,0,0,1,0,1,0.24166666666666667
贪婪算法,0,0,1,0,0,1,0,2,0.3666666666666667
节点勺,0,0,0,0,0,1,0,1,0.24166666666666667
降序,0,0,0,0,0,1,0,1,0.24166666666666667
重映射效果,0,0,0,0,0,1,0,1,0.24166666666666667
剩余带宽资源,0,0,0,0,0,2,0,2,0.48333333333333334
底层节点心,0,0,0,0,0,2,0,2,0.48333333333333334
收益比,0,0,0,0,0,1,0,1,0.24166666666666667
映射开销收益比,0,0,0,0,0,1,0,1,0.24166666666666667
过载重,0,0,0,0,0,1,0,1,0.24166666666666667
虚拟链路映射,0,0,0,0,0,1,0,1,0.24166666666666667
资源分配,0,0,0,0,0,1,0,1,0.24166666666666667
虚拟节点集合,0,0,0,0,0,1,0,1,0.24166666666666667
间均匀分布,0,0,0,0,5,5,0,10,2.4166666666666665
时间单位,0,0,0,0,2,3,0,5,1.2083333333333333
变异概率,0,0,0,0,1,0,0,1,0.24166666666666667
局部搜索能力,0,0,0,0,1,0,0,1,0.24166666666666667
阈值,0,0,0,0,1,2,0,3,0.725
个体数量,0,0,0,0,1,0,0,1,0.24166666666666667
指数分布,0,0,0,0,1,1,0,2,0.48333333333333334
均值,0,0,0,0,1,1,0,2,0.48333333333333334
泊松分布,0,0,0,0,1,1,0,2,0.48333333333333334
gt-itm工具,0,0,0,0,1,1,0,2,0.48333333333333334
实验参数,0,0,0,0,1,1,0,2,0.48333333333333334
跷跷板,0,0,0,0,0,7,1,8,1.9333333333333333
主动型算法,0,0,0,0,0,3,0,3,0.725
碎片化,1,0,0,0,0,7,0,8,2.6916666666666664
非重要节点,0,0,0,0,0,2,0,2,0.48333333333333334
距离因素,0,0,0,0,0,1,0,1,0.24166666666666667
重构,0,0,0,0,0,1,0,1,0.24166666666666667
虚拟网络服务,0,0,0,1,0,1,0,2,0.3666666666666667
主动型虚拟网络,0,0,0,0,0,1,0,1,0.24166666666666667
主动型策略,0,0,0,0,0,1,0,1,0.24166666666666667
被动型算法,0,0,0,0,0,1,0,1,0.24166666666666667
被动重映射,0,0,0,0,0,1,0,1,0.24166666666666667
主动重映射,0,0,0,0,0,1,0,1,0.24166666666666667
重映射机制,0,0,0,0,0,2,0,2,0.48333333333333334
负载阈值,0,0,0,0,0,1,0,1,0.24166666666666667
重映射操,0,0,0,0,0,2,0,2,0.48333333333333334
跷跷板问题,0,0,0,0,0,1,0,1,0.24166666666666667
网络资源,0,0,0,3,0,1,1,5,0.8583333333333334
参数,0,0,0,0,3,1,0,4,0.9666666666666667
二进制变量,0,0,0,0,2,0,0,2,0.48333333333333334
映射成本,0,0,0,1,1,0,0,2,0.3666666666666667
dijkstra,0,0,0,0,1,0,0,1,0.24166666666666667
迪杰斯特拉算法,0,0,0,0,1,0,0,1,0.24166666666666667
计算时间,0,0,0,0,1,0,0,1,0.24166666666666667
编号,0,0,0,0,1,0,0,1,0.24166666666666667
取值,0,0,0,0,1,1,0,2,0.48333333333333334
虚拟节点数量,0,0,0,0,1,0,0,1,0.24166666666666667
实数编码,0,0,0,0,1,0,0,1,0.24166666666666667
染色体编码,0,0,0,0,1,0,0,1,0.24166666666666667
基因编码,0,0,0,0,1,0,0,1,0.24166666666666667
速率,0,0,0,0,4,4,0,8,1.9333333333333333
到达速率,0,0,0,0,4,3,0,7,1.6916666666666667
平均重映射链路,0,0,0,0,0,4,0,4,0.9666666666666667
vnr,0,0,0,0,0,3,0,3,0.725
lgvnr,0,0,0,0,0,2,0,2,0.48333333333333334
达速率,0,0,0,0,1,2,0,3,0.725
收益开销,0,0,0,0,2,2,0,4,0.9666666666666667
数量,0,0,0,0,0,1,0,1,0.24166666666666667
连通,0,0,0,0,0,2,0,2,0.48333333333333334
负载率阈值,0,0,0,0,0,6,0,6,1.45
nrt,0,0,0,0,0,1,0,1,0.24166666666666667
重映射时间,0,0,0,0,0,1,0,1,0.24166666666666667
ne,0,0,0,0,0,1,0,1,0.24166666666666667
-vnr,0,0,0,0,0,1,0,1,0.24166666666666667
总长度,0,0,0,0,0,1,0,1,0.24166666666666667
重映射路径,0,0,0,0,0,1,0,1,0.24166666666666667
开销,0,0,0,0,0,1,0,1,0.24166666666666667
迁移位置,0,0,0,0,0,1,0,1,0.24166666666666667
vn,0,0,0,0,0,1,0,1,0.24166666666666667
性能分,0,0,2,0,1,1,0,4,0.7333333333333334
初始个体,0,0,0,0,7,0,0,7,1.6916666666666667
初始种群生成机制,0,0,0,0,3,0,0,3,0.725
生成速度,0,0,0,0,3,0,0,3,0.725
生成机制,0,0,0,0,2,0,0,2,0.48333333333333334
约束条件,0,0,1,5,3,0,0,9,1.475
链路资源约束条件,0,0,0,0,1,0,0,1,0.24166666666666667
周期型,0,0,0,0,4,0,0,4,0.9666666666666667
交叉点,0,0,0,0,3,0,0,3,0.725
元胞种群,0,0,0,0,3,0,0,3,0.725
复杂型,0,0,0,0,3,0,0,3,0.725
种群密度,0,0,0,0,3,0,0,3,0.725
空间坐标,0,0,0,0,4,0,0,4,0.9666666666666667
生物种群,0,0,0,0,3,0,0,3,0.725
稳定型,0,0,0,0,2,0,0,2,0.48333333333333334
演化,0,0,0,0,3,0,1,4,0.9666666666666667
邻居结构,0,0,0,0,2,0,0,2,0.48333333333333334
信息扩散速度,0,0,0,0,2,0,0,2,0.48333333333333334
矩阵,0,0,0,0,2,0,0,2,0.48333333333333334
t冲突,0,0,0,0,1,0,0,1,0.24166666666666667
重复序号,0,0,0,0,1,0,0,1,0.24166666666666667
匹配,0,0,0,0,1,0,0,1,0.24166666666666667
节点序号,0,0,0,0,3,0,0,3,0.725
交叉结,0,0,0,0,1,0,0,1,0.24166666666666667
交叉算子设计,0,0,0,0,1,0,0,1,0.24166666666666667
邻居空间,0,0,0,0,1,0,0,1,0.24166666666666667
变异步骤,0,0,0,0,2,0,0,2,0.48333333333333334
t时刻空间坐标,0,0,0,0,1,0,0,1,0.24166666666666667
周期型演化规,0,0,0,0,1,0,0,1,0.24166666666666667
周期型演化规则,0,0,0,0,1,0,0,1,0.24166666666666667
多峰,0,0,0,0,1,0,0,1,0.24166666666666667
寻优,0,0,0,0,3,0,0,3,0.725
进化过程,0,0,0,0,1,0,0,1,0.24166666666666667
稳定型演化规则,0,0,0,0,1,0,0,1,0.24166666666666667
杂中间状态,0,0,0,0,1,0,0,1,0.24166666666666667
秩序,0,0,0,0,1,0,0,1,0.24166666666666667
动态演化过程,0,0,0,0,1,0,0,1,0.24166666666666667
大自然规则,0,0,0,0,1,0,0,1,0.24166666666666667
静态空间,0,0,0,0,1,0,0,1,0.24166666666666667
生存资源,0,0,0,0,1,0,0,1,0.24166666666666667
密度,0,0,0,0,1,0,0,1,0.24166666666666667
集合心,0,0,0,0,1,0,0,1,0.24166666666666667
邻居个体,0,0,0,0,1,0,0,1,0.24166666666666667
上下边界,0,0,0,0,1,0,0,1,0.24166666666666667
周期型边界,0,0,0,0,1,0,0,1,0.24166666666666667
染色体邻居,0,0,0,0,1,0,0,1,0.24166666666666667
摻滲滲撐浄,0,0,0,0,1,0,0,1,0.24166666666666667
种群演化,0,0,0,0,4,0,0,4,0.9666666666666667
邻居规模,0,0,0,0,1,0,0,1,0.24166666666666667
摩尔型,0,0,0,0,1,0,0,1,0.24166666666666667
散速度,0,0,0,0,1,0,0,1,0.24166666666666667
信息扩,0,0,0,0,1,0,0,1,0.24166666666666667
冯诺依曼型,0,0,0,0,1,0,0,1,0.24166666666666667
邻域结构,0,0,0,0,1,0,0,1,0.24166666666666667
元胞晶格,0,0,0,0,1,0,0,1,0.24166666666666667
二进制位,0,0,0,0,1,0,0,1,0.24166666666666667
元胞遗传机制,0,0,0,0,1,0,0,1,0.24166666666666667
元胞自动机理论,0,0,0,0,1,0,0,1,0.24166666666666667
演变现,0,0,0,0,1,0,0,1,0.24166666666666667
空间模型,0,0,0,0,1,0,0,1,0.24166666666666667
动力系统,0,0,0,0,1,0,0,1,0.24166666666666667
大陆,0,0,0,0,1,0,0,1,0.24166666666666667
多样性,0,0,0,0,2,0,0,2,0.48333333333333334
隔离,0,0,0,0,1,0,0,1,0.24166666666666667
分布,0,0,0,0,1,0,0,1,0.24166666666666667
尔文,0,0,0,0,1,0,0,1,0.24166666666666667
传统遗传算法,0,0,1,0,1,0,0,2,0.3666666666666667
粒子,0,0,0,0,28,0,0,28,6.766666666666667
搜索,0,0,0,2,2,0,0,4,0.7333333333333334
粒子速度,0,0,0,0,9,0,0,9,2.175
空间,0,0,0,1,1,0,0,2,0.3666666666666667
半径粒子群算法,0,0,0,0,1,0,0,1,0.24166666666666667
最大代数,0,0,0,0,1,0,0,1,0.24166666666666667
循环迭代,0,0,0,0,1,0,0,1,0.24166666666666667
粒子位置,0,0,0,0,2,0,0,2,0.48333333333333334
惯性系数,0,0,0,0,1,0,0,1,0.24166666666666667
随机机制,0,0,0,0,1,0,0,1,0.24166666666666667
初始化粒子群,0,0,0,0,1,0,0,1,0.24166666666666667
优粒子,0,0,0,0,1,0,0,1,0.24166666666666667
前速度,0,0,0,0,1,0,0,1,0.24166666666666667
位置属性,0,0,0,0,1,0,0,1,0.24166666666666667
无线传感器,0,0,0,0,1,0,0,1,0.24166666666666667
调度,0,0,0,0,1,0,0,1,0.24166666666666667
云计算,0,0,1,4,1,0,0,6,0.8666666666666667
智能搜索算法,0,0,1,0,1,0,0,2,0.3666666666666667
捕食活动,0,0,0,0,1,0,0,1,0.24166666666666667
鸟群,0,0,0,0,1,0,0,1,0.24166666666666667
dy,0,0,0,0,1,0,0,1,0.24166666666666667
尼迪,0,0,0,0,1,0,0,1,0.24166666666666667
particleswarmoptimiza,0,0,0,0,1,0,0,1,0.24166666666666667
初始资源,0,0,0,0,0,3,0,3,0.725
重要性评价,0,0,0,0,0,2,0,2,0.48333333333333334
受率,0,0,0,0,0,1,0,1,0.24166666666666667
络拓扑,0,0,0,0,0,1,0,1,0.24166666666666667
初始资源量,0,0,0,0,0,2,0,2,0.48333333333333334
影响力,0,0,0,0,0,2,0,2,0.48333333333333334
早熟现象,0,0,0,0,2,0,0,2,0.48333333333333334
链路资源,0,0,0,2,2,0,0,4,0.7333333333333334
复杂,0,0,0,0,1,0,0,1,0.24166666666666667
请求到达速率,0,0,0,0,1,0,0,1,0.24166666666666667
vne-pso-gao,0,0,0,0,1,0,0,1,0.24166666666666667
复杂度,0,0,0,0,1,0,0,1,0.24166666666666667
ca,0,0,0,0,1,0,0,1,0.24166666666666667
底层链路资源,0,0,0,0,1,0,1,2,0.48333333333333334
性能表,0,0,0,0,1,0,0,1,0.24166666666666667
链路映射步骤,0,0,0,0,1,0,0,1,0.24166666666666667
映射方,0,0,0,1,2,0,0,3,0.6083333333333334
基因排序结构,0,0,0,0,1,0,0,1,0.24166666666666667
排序结构,0,0,0,0,1,0,0,1,0.24166666666666667
内部基因,0,0,0,0,1,0,0,1,0.24166666666666667
信息素,0,0,0,0,2,0,0,2,0.48333333333333334
信息素概,0,0,0,0,1,0,0,1,0.24166666666666667
蚁群算法,0,0,0,3,3,0,0,6,1.1
演化规,0,0,0,0,1,0,0,1,0.24166666666666667
元胞自动机模型,0,0,0,0,1,0,0,1,0.24166666666666667
父代选择,0,0,0,0,1,0,0,1,0.24166666666666667
轮盘赌机制,0,0,0,0,1,0,0,1,0.24166666666666667
最终映射,0,0,0,0,1,0,0,1,0.24166666666666667
对比算法,0,0,0,0,1,0,0,1,0.24166666666666667
性能表现,0,0,0,0,1,0,0,1,0.24166666666666667
多维度,0,0,0,0,0,0,1,1,0.24166666666666667
最优个体,0,0,0,0,1,0,1,2,0.48333333333333334
扩散能力,0,0,0,0,0,0,1,1,0.24166666666666667
负载不,0,0,0,0,0,0,1,1,0.24166666666666667
约束,1,0,1,0,0,0,1,3,1.3666666666666667
网络体系结构,0,0,0,0,0,0,1,1,0.24166666666666667
虚拟化,0,0,1,2,0,0,1,4,0.6166666666666667
网络流量,0,0,0,0,0,0,1,1,0.24166666666666667
文明,0,0,0,0,0,0,1,1,0.24166666666666667
信息素数,0,0,0,0,3,0,0,3,0.725
终止条件,0,0,0,0,1,0,0,1,0.24166666666666667
交叉操,0,0,0,0,1,0,0,1,0.24166666666666667
轮盘赌,0,0,0,0,1,0,0,1,0.24166666666666667
行重映射操作,0,0,0,0,0,1,0,1,0.24166666666666667
动态节点,0,0,0,0,0,1,0,1,0.24166666666666667
常数,0,0,0,0,0,2,0,2,0.48333333333333334
cpu,0,0,0,0,0,1,0,1,0.24166666666666667
ecpu,0,0,0,0,0,1,0,1,0.24166666666666667
权重,0,0,0,0,0,9,0,9,2.175
节点属性,0,0,0,0,0,7,0,7,1.6916666666666667
基本概率指派函数,0,0,0,0,0,10,0,10,2.4166666666666665
证据合成理论,0,0,0,0,0,5,0,5,1.2083333333333333
综合概率指派函数,0,0,0,0,0,3,0,3,0.725
折扣因子,0,0,0,0,0,3,0,3,0.725
证据,0,0,0,0,0,7,0,7,1.6916666666666667
概率指派函数,0,0,0,0,0,4,0,4,0.9666666666666667
介数,0,0,0,0,0,3,0,3,0.725
权重值,0,0,0,0,0,3,0,3,0.725
要性,1,0,0,0,0,2,0,3,1.4833333333333334
参考值,0,0,0,0,0,2,0,2,0.48333333333333334
d-s证据合成规则,0,0,0,0,0,5,0,5,1.2083333333333333
节点属性特征,0,0,0,0,0,1,0,1,0.24166666666666667
指标数,0,0,0,0,0,1,0,1,0.24166666666666667
平均分配,0,0,0,0,0,1,0,1,0.24166666666666667
基本信度,0,0,0,0,0,2,0,2,0.48333333333333334
基本信度值,0,0,0,0,0,2,0,2,0.48333333333333334
不确定信息,0,0,0,0,0,1,0,1,0.24166666666666667
确定性信息,0,0,0,0,0,1,0,1,0.24166666666666667
证据折扣因子,0,0,0,0,0,1,0,1,0.24166666666666667
证据折扣理论,0,0,0,0,0,1,0,1,0.24166666666666667
全局极值,0,0,0,0,0,1,0,1,0.24166666666666667
证据融合,0,0,0,0,0,1,0,1,0.24166666666666667
信度,0,0,0,0,0,1,0,1,0.24166666666666667
辨识框架,0,0,0,0,0,9,0,9,2.175
节点度,0,0,0,0,0,1,0,1,0.24166666666666667
计算量,0,0,0,0,0,1,0,1,0.24166666666666667
信息融合框架,0,0,0,0,0,1,0,1,0.24166666666666667
d-s证据理论,0,0,0,0,0,5,0,5,1.2083333333333333
节点重要性评价指标,0,0,0,0,0,1,0,1,0.24166666666666667
重要性评价指标,0,0,1,0,0,1,0,2,0.3666666666666667
d-s证据合成,0,0,0,0,0,1,0,1,0.24166666666666667
nz,0,0,0,0,0,1,0,1,0.24166666666666667
重要节点识别理论,0,0,0,0,0,1,0,1,0.24166666666666667
复杂网络,0,0,0,0,0,1,0,1,0.24166666666666667
映射约束条,0,0,0,1,0,0,0,1,0.125
单一映射约束,0,0,0,1,0,0,0,1,0.125
通路,0,0,0,1,0,0,0,1,0.125
链路带宽约束,0,0,0,1,0,0,0,1,0.125
计算资源量,0,0,0,1,0,0,0,1,0.125
计算,0,0,0,1,0,0,0,1,0.125
节点容量约束,0,0,0,1,0,0,0,1,0.125
apn,0,0,0,5,0,0,0,5,0.625
vlan,0,0,0,5,0,0,0,5,0.625
抽象层,0,0,0,4,0,0,0,4,0.5
广播域,0,0,0,3,0,0,0,3,0.375
数据,0,0,0,3,0,0,0,3,0.375
数据中心,0,0,0,3,0,0,0,3,0.375
sdn,0,0,0,3,0,0,0,3,0.375
虚拟服务器,0,0,0,3,0,0,0,3,0.375
计算机网络,0,0,0,2,0,0,0,2,0.25
工作组,0,0,0,2,0,0,0,2,0.25
vpn,0,0,0,2,0,0,0,2,0.25
通信活动,0,0,0,2,0,0,0,2,0.25
主动可编程网络,0,0,0,2,0,0,0,2,0.25
网络管理,0,0,0,2,0,0,0,2,0.25
通信,0,0,0,2,0,0,0,2,0.25
控制器,0,0,0,2,0,0,0,2,0.25
数据平面,0,0,0,2,0,0,0,2,0.25
网络硬件,0,0,0,2,0,0,0,2,0.25
网络服务,0,0,1,2,0,0,0,3,0.375
数据中心网络,0,0,0,1,0,0,0,1,0.125
基础网络设备,0,0,0,1,0,0,0,1,0.125
基础网络,0,0,0,1,0,0,0,1,0.125
overlaynetwork,0,0,0,1,0,0,0,1,0.125
覆盖网络,0,0,0,1,0,0,0,1,0.125
switchware,0,0,0,1,0,0,0,1,0.125
交换件系统,0,0,0,1,0,0,0,1,0.125
服务质量,0,0,0,1,0,0,0,1,0.125
网络协议,0,0,2,1,0,0,0,3,0.375
网络体系架构,0,0,0,1,0,0,0,1,0.125
节点资源,0,0,0,1,0,0,0,1,0.125
可编程能力,0,0,0,1,0,0,0,1,0.125
中间节点,0,0,0,1,0,0,0,1,0.125
可编程分组交换网络结构,0,0,0,1,0,0,0,1,0.125
activeprogrammablenetwork,0,0,0,1,0,0,0,1,0.125
广播风暴,0,0,0,1,0,0,0,1,0.125
网络带宽,0,0,1,1,0,0,0,2,0.25
信息流,0,0,0,1,0,0,0,1,0.125
路由,0,0,0,1,0,0,0,1,0.125
通信技术,0,0,0,1,0,0,0,1,0.125
用户,0,0,0,1,0,0,0,1,0.125
局域网络,0,0,0,1,0,0,0,1,0.125
tw,0,0,0,1,0,0,0,1,0.125
virtuallocalare,0,0,0,1,0,0,0,1,0.125
虚拟局域网络,0,0,0,1,0,0,0,1,0.125
数据丢失,0,0,0,1,0,0,0,1,0.125
无线网络,0,0,0,1,0,0,0,1,0.125
扩展性,0,0,0,1,0,0,0,1,0.125
通信开支,0,0,0,1,0,0,0,1,0.125
物理信道,0,0,0,1,0,0,0,1,0.125
保密性,0,0,0,1,0,0,0,1,0.125
加密,0,0,0,1,0,0,0,1,0.125
传输,0,0,0,1,0,0,0,1,0.125
虚拟专用通路,0,0,0,1,0,0,0,1,0.125
vpn用户,0,0,0,1,0,0,0,1,0.125
专属通道,0,0,0,1,0,0,0,1,0.125
公共网络,0,0,0,1,0,0,0,1,0.125
隧道技,0,0,0,1,0,0,0,1,0.125
专用网络,0,0,0,1,0,0,0,1,0.125
专用网络设备,0,0,0,1,0,0,0,1,0.125
物理链路,0,0,0,1,0,0,0,1,0.125
vpn节点,0,0,0,1,0,0,0,1,0.125
远程访问技术,0,0,0,1,0,0,0,1,0.125
覆盖网络结构,0,0,0,1,0,0,0,1,0.125
公共基础设施,0,0,0,1,0,0,0,1,0.125
virtualprivatenet,0,0,0,1,0,0,0,1,0.125
虚拟专用网络,0,0,0,1,0,0,0,1,0.125
虚拟局域网,0,0,0,1,0,0,0,1,0.125
虚拟专用网,0,0,0,1,0,0,0,1,0.125
网络管理员,0,0,0,1,0,0,0,1,0.125
故障资源,0,0,0,1,0,0,0,1,0.125
底层设备,0,0,0,1,0,0,0,1,0.125
虚拟环境,0,0,0,1,0,0,0,1,0.125
物理层,0,0,0,1,0,0,0,1,0.125
网络应用,0,0,0,1,0,0,0,1,0.125
统网络,0,0,0,1,0,0,0,1,0.125
网络资源利用率,0,0,0,1,0,0,0,1,0.125
部署时间,0,0,0,1,0,0,0,1,0.125
部署,0,0,0,1,0,0,0,1,0.125
写程序,0,0,0,1,0,0,0,1,0.125
编程接口,0,0,0,1,0,0,0,1,0.125
集中控制,0,0,0,1,0,0,0,1,0.125
部署效率,0,0,0,1,0,0,0,1,0.125
编程,0,0,0,1,0,0,0,1,0.125
软件开发,0,0,0,1,0,0,0,1,0.125
应用程序,0,0,0,1,0,0,0,1,0.125
应用层,0,0,0,1,0,0,0,1,0.125
北向编程接口,0,0,0,1,0,0,0,1,0.125
网络控制,0,0,0,1,0,0,0,1,0.125
拓扑管理,0,0,0,1,0,0,0,1,0.125
南向编程接口,0,0,0,1,0,0,0,1,0.125
转发设备,0,0,0,1,0,0,0,1,0.125
网络交换机,0,0,0,1,0,0,0,1,0.125
逻辑集中控制器,0,0,0,1,0,0,0,1,0.125
决策,0,0,0,1,0,0,0,1,0.125
控制平面,0,0,0,1,0,0,0,1,0.125
u71.sdn,0,0,0,1,0,0,0,1,0.125
资源交互性,0,0,0,1,0,0,0,1,0.125
高性能虚拟网络技术,0,0,0,1,0,0,0,1,0.125
混合云,0,0,0,1,0,0,0,1,0.125
分布式计算,0,0,0,1,0,0,0,1,0.125
definednetwork,0,0,0,1,0,0,0,1,0.125
software-,0,0,0,1,0,0,0,1,0.125
软件定义网络,0,0,0,1,0,0,0,1,0.125
cloudcomputing,0,0,0,1,0,0,0,1,0.125
实体网络资源,0,0,0,1,0,0,0,1,0.125
接口,0,0,0,1,0,0,0,1,0.125
实体网络设备,0,0,0,1,0,0,0,1,0.125
网络工程,0,0,0,1,0,0,0,1,0.125
网络虚拟化概,0,0,0,1,0,0,0,1,0.125
存储资源,0,0,0,1,0,0,0,1,0.125
内存资源,0,0,0,1,0,0,0,1,0.125
中央处理器资源,0,0,0,1,0,0,0,1,0.125
虚拟路由器,0,0,0,1,0,0,0,1,0.125
资源切片,0,0,0,1,0,0,0,1,0.125
实体网络,0,0,0,1,0,0,0,1,0.125
底层,0,0,0,1,0,0,0,1,0.125
多项式,0,0,0,1,1,0,0,2,0.3666666666666667
资源约束条件,0,0,1,2,0,0,0,3,0.375
定性多项式难题,0,0,0,1,0,0,0,1,0.125
多项式难题,0,0,0,1,0,0,0,1,0.125
虚拟网络映射问题,0,0,1,1,0,0,0,2,0.25
链路带宽资源约束,0,0,0,1,0,0,0,1,0.125
资源约束,0,0,0,1,0,0,0,1,0.125
单映射约束,0,0,0,1,0,0,0,1,0.125
内容,0,0,0,1,0,0,0,1,0.125
速度迭代公式,0,0,0,0,2,0,0,2,0.48333333333333334
粒子位置向量,0,0,0,0,2,0,0,2,0.48333333333333334
链路映射成本,0,0,0,0,2,0,0,2,0.48333333333333334
信息素值,0,0,0,0,2,0,0,2,0.48333333333333334
速度分量,0,0,0,0,1,0,0,1,0.24166666666666667
基因序列,0,0,0,0,1,0,0,1,0.24166666666666667
惯性数值,0,0,0,0,1,0,0,1,0.24166666666666667
个体间,0,0,0,0,1,0,0,1,0.24166666666666667
必弓号,0,0,0,0,1,0,0,1,0.24166666666666667
逻辑加法,0,0,0,0,1,0,0,1,0.24166666666666667
时刻染色体,0,0,0,0,1,0,0,1,0.24166666666666667
位置减法,0,0,0,0,1,0,0,1,0.24166666666666667
进化,0,0,0,0,1,0,0,1,0.24166666666666667
种群迭代次数,0,0,0,0,1,0,0,1,0.24166666666666667
粒子惯性,0,0,0,0,1,0,0,1,0.24166666666666667
元胞遗传操作,0,0,0,0,1,0,0,1,0.24166666666666667
粒子位置差值,0,0,0,0,1,0,0,1,0.24166666666666667
节点编号,0,0,0,0,1,0,0,1,0.24166666666666667
惯性,0,0,0,0,1,0,0,1,0.24166666666666667
染色体变异点,0,0,0,0,1,0,0,1,0.24166666666666667
节点数量,0,0,0,0,1,0,0,1,0.24166666666666667
离散优化问,0,0,0,0,1,0,0,1,0.24166666666666667
连续域,0,0,0,0,1,0,0,1,0.24166666666666667
全局搜索能,0,0,0,0,2,0,0,2,0.48333333333333334
选择操,0,0,0,0,1,0,0,1,0.24166666666666667
虚拟网络映射方案,0,0,0,0,1,0,0,1,0.24166666666666667
反馈机制,0,0,0,0,1,0,0,1,0.24166666666666667
子集,0,0,0,0,0,3,0,3,0.725
证据理论,0,0,0,0,0,3,0,3,0.725
概率论,0,0,0,0,0,3,0,3,0.725
焦元,0,0,0,0,0,2,0,2,0.48333333333333334
融合,0,0,0,0,0,1,0,1,0.24166666666666667
结合律,0,0,0,0,0,1,0,1,0.24166666666666667
交换律,0,0,0,0,0,1,0,1,0.24166666666666667
合成规则,0,0,0,0,0,1,0,1,0.24166666666666667
幕集,0,0,0,0,0,1,0,1,0.24166666666666667
集合映射函数,0,0,0,0,0,1,0,1,0.24166666666666667
崙集,0,0,0,0,0,1,0,1,0.24166666666666667
有限非空集合,0,0,0,0,0,1,0,1,0.24166666666666667
内部元素,0,0,0,0,0,1,0,1,0.24166666666666667
风速预测,0,0,0,0,0,1,0,1,0.24166666666666667
数据融合,0,0,0,0,0,1,0,1,0.24166666666666667
传感器网络,0,0,0,0,0,1,0,1,0.24166666666666667
传感器技术,0,0,0,0,0,1,0,1,0.24166666666666667
计算机技术,0,0,0,0,0,1,0,1,0.24166666666666667
贝叶斯推理,0,0,0,0,0,1,0,1,0.24166666666666667
数学理论,0,0,0,0,0,1,0,1,0.24166666666666667
不确定性,0,0,0,0,0,1,0,1,0.24166666666666667
数学,0,0,0,0,0,1,0,1,0.24166666666666667
dst,0,0,0,0,0,1,0,1,0.24166666666666667
ster,0,0,0,0,0,1,0,1,0.24166666666666667
de,0,0,0,0,0,1,0,1,0.24166666666666667
邓普斯特沙弗理论,0,0,0,0,0,1,0,1,0.24166666666666667
证据融合理论,0,0,0,0,0,1,0,1,0.24166666666666667
内部细节,0,0,0,0,1,0,0,1,0.24166666666666667
演化型元胞自动机,0,0,0,0,1,0,0,1,0.24166666666666667
vnp,0,0,0,4,0,0,0,4,0.5
单域,0,0,0,4,0,0,0,4,0.5
虚拟节点映射,0,0,0,3,0,0,0,3,0.375
协同映射算法,0,0,0,2,0,0,0,2,0.25
信息垄断,0,0,0,2,0,0,0,2,0.25
内部信息,0,0,0,2,0,0,0,2,0.25
多域虚拟网络,0,0,0,2,0,0,0,2,0.25
因子,0,0,0,1,0,0,0,1,0.125
拓扑相,0,0,0,1,0,0,0,1,0.125
整形规划,0,0,0,1,0,0,0,1,0.125
周围链路,0,0,0,1,0,0,0,1,0.125
二阶段算法,0,0,0,1,0,0,0,1,0.125
全局寻优能力,1,0,0,1,0,0,0,2,1.125
模拟退火算法,0,0,0,1,0,0,0,1,0.125
退火虚拟网络映射算法,0,0,0,1,0,0,0,1,0.125
自适应遗传模拟,0,0,0,1,0,0,0,1,0.125
资源碎片,0,0,0,1,0,0,0,1,0.125
代价函数,0,0,0,1,0,0,0,1,0.125
模拟退火,0,0,0,1,0,0,0,1,0.125
启发式信息素,0,0,0,1,0,0,0,1,0.125
二阶段虚拟网络映射算法,0,0,0,1,0,0,0,1,0.125
一阶段算法,0,0,0,1,0,0,0,1,0.125
映射过程,0,0,0,1,0,0,0,1,0.125
段算法,0,0,0,1,0,0,0,1,0.125
一阶段映射算法,0,0,0,1,0,0,0,1,0.125
阶段映射算法,0,0,0,1,0,0,0,1,0.125
分布式映射,0,0,0,1,0,0,0,1,0.125
映射问,0,0,0,1,0,0,0,1,0.125
动态环境,0,0,0,1,0,0,0,1,0.125
多域虚拟网络映射算法,0,0,0,1,0,0,0,1,0.125
网络信息,0,0,0,1,0,0,0,1,0.125
资源调配,0,0,0,1,0,0,0,1,0.125
信息共享,0,0,0,1,0,0,0,1,0.125
全局映射,0,0,0,1,0,0,0,1,0.125
传统,0,0,0,1,0,0,0,1,0.125
virtualnetworkprovider,0,0,0,1,0,0,0,1,0.125
虚拟网络供应商,0,0,0,1,0,0,0,1,0.125
多域映射,0,0,0,1,0,0,0,1,0.125
地理,0,0,0,1,0,0,0,1,0.125
萤火虫算法,0,0,0,1,0,0,0,1,0.125
麻雀算法,0,0,0,1,0,0,0,1,0.125
多域,0,0,0,1,0,0,0,1,0.125
新网络,0,0,2,0,0,0,0,2,0.25
补丁,0,0,2,0,0,0,0,2,0.25
信息行业,0,0,2,0,0,0,0,2,0.25
动态重映射,1,0,1,0,0,0,0,2,1.125
收敛能力,0,0,1,0,0,0,0,1,0.125
多项式难,0,0,1,0,0,0,0,1,0.125
解耦合,0,0,1,0,0,0,0,1,0.125
功能,0,0,1,0,0,0,0,1,0.125
电子银行,0,0,1,0,0,0,0,1,0.125
在线电子游戏,0,0,1,0,0,0,0,1,0.125
serviceproviders,0,0,1,0,0,0,0,1,0.125
底层网络设备,0,0,1,0,0,0,0,1,0.125
inps,0,0,1,0,0,0,0,1,0.125
infrastructureproviders,0,0,1,0,0,0,0,1,0.125
isps,0,0,1,0,0,0,0,1,0.125
internetserviceprovider,0,0,1,0,0,0,0,1,0.125
社会资源,0,0,1,0,0,0,0,1,0.125
网络设,0,0,1,0,0,0,0,1,0.125
新型网络技术,0,0,1,0,0,0,0,1,0.125
分布式云测试平台,0,0,1,0,0,0,0,1,0.125
测试,0,0,1,0,0,0,0,1,0.125
服务,0,0,1,0,0,0,0,1,0.125
协议,0,0,1,0,0,0,0,1,0.125
可编程接口,0,0,1,0,0,0,0,1,0.125
网络虚化技术,0,0,1,0,0,0,0,1,0.125
既得利益者,0,0,1,0,0,0,0,1,0.125
天文数字,0,0,1,0,0,0,0,1,0.125
重建式,0,0,1,0,0,0,0,1,0.125
网络系统,0,0,1,0,0,0,0,1,0.125
业务,0,0,1,0,0,0,0,1,0.125
组件,0,0,1,0,0,0,0,1,0.125
修补,0,0,1,0,0,0,0,1,0.125
互联网改革,0,0,1,0,0,0,0,1,0.125
网络提供商,0,0,1,0,0,0,0,1,0.125
网络设备供应商,0,0,1,0,0,0,0,1,0.125
大数据,0,0,1,0,0,0,0,1,0.125
移动互联网,0,0,1,0,0,0,0,1,0.125
互联网应用,0,0,1,0,0,0,0,1,0.125
互联网用户,0,0,1,0,0,0,0,1,0.125
网络时代,0,0,1,0,0,0,0,1,0.125
人类文明,0,0,1,0,0,0,0,1,0.125
巨蟒,0,0,1,0,0,0,0,1,0.125
融合算法,0,0,1,0,0,0,0,1,0.125
数学模型,0,0,1,0,0,0,0,1,0.125
warmoptimiza,0,0,0,0,1,0,0,1,0.24166666666666667
particles,0,0,0,0,1,0,0,1,0.24166666666666667
mw,0,0,0,0,1,0,0,1,0.24166666666666667
ri,0,0,0,0,1,0,0,1,0.24166666666666667
doncellulargenetical,0,0,0,0,1,0,0,1,0.24166666666666667
embeddingbase,0,0,0,0,1,0,0,1,0.24166666666666667
综合性能,0,0,0,0,1,0,0,1,0.24166666666666667
虚拟网络重映射,0,1,0,0,0,0,0,1,2.0
价指标,1,0,0,0,0,0,0,1,1.0
超级解,1,0,0,0,0,0,0,1,1.0
