,摘要,关键词,第一章,第二章,第三章,第四章,第五章,总词频,加权得分
模型,0,0,10,14,23,13,0,60,11.7
视觉感知,0,0,1,0,7,4,0,12,2.783333333333333
视点,2,0,4,4,20,4,2,36,9.283333333333333
周围机制,0,0,0,0,6,0,0,6,1.45
兴趣区域,6,0,5,21,9,5,3,49,13.358333333333334
网格模型,5,0,21,28,21,10,5,90,19.825
三维场景,4,1,14,18,7,11,2,57,14.833333333333332
渐进式传输,2,1,17,15,8,12,2,57,13.316666666666666
视觉质量,2,0,2,1,9,2,3,19,5.758333333333333
屏幕分辨率,0,0,0,0,3,3,0,6,1.45
扇区,0,0,0,0,2,0,0,2,0.48333333333333334
fov,0,0,0,1,3,0,0,4,0.85
aoi,0,0,0,3,2,0,0,5,0.8583333333333334
视觉,1,0,2,1,12,8,1,25,6.45
优先级,0,0,1,2,2,1,0,6,1.1
模型传输,1,0,1,0,2,0,0,4,1.6083333333333334
场景重建,0,0,0,0,2,1,0,3,0.725
传输保护,0,0,0,0,2,1,0,3,0.725
场景,1,0,4,1,3,1,0,10,2.591666666666667
中心-,0,0,0,0,1,0,0,1,0.24166666666666667
模型多姿态,0,0,0,0,1,1,0,2,0.48333333333333334
模型内容,0,0,0,0,1,0,0,1,0.24166666666666667
渐进式传输策略,0,0,1,1,1,0,0,3,0.4916666666666667
三维,0,0,4,5,9,0,0,18,3.3
可视化增强运算符,0,0,0,0,1,0,0,1,0.24166666666666667
视觉显着性中心,0,0,0,0,1,0,0,1,0.24166666666666667
信息论分析,0,0,0,0,1,0,0,1,0.24166666666666667
显著图,0,0,0,0,1,0,0,1,0.24166666666666667
三维网格,0,0,0,0,3,0,0,3,0.725
显著图计算,0,0,0,0,1,0,0,1,0.24166666666666667
多边形互信息,0,0,0,0,1,0,0,1,0.24166666666666667
图形网格,0,0,0,0,1,0,0,1,0.24166666666666667
中心,0,0,0,0,4,0,0,4,0.9666666666666667
高斯权重,0,0,0,0,1,0,0,1,0.24166666666666667
网格分辨率,0,0,0,0,1,0,0,1,0.24166666666666667
近距离,0,0,0,0,1,0,0,1,0.24166666666666667
兴趣区,0,0,0,2,3,2,0,7,1.4583333333333333
权重,0,0,0,1,2,0,0,3,0.6083333333333334
宽度,0,0,0,0,2,0,0,2,0.48333333333333334
fov内模型,0,0,0,0,1,0,0,1,0.24166666666666667
视线中心偏转角,0,0,0,0,1,0,0,1,0.24166666666666667
距离,1,0,2,1,9,0,1,14,3.7916666666666665
aoi计算模型,0,0,0,0,1,0,0,1,0.24166666666666667
程度计算,0,0,0,0,1,1,0,2,0.48333333333333334
反比例函数,0,0,0,0,1,0,0,1,0.24166666666666667
视点距离,1,0,1,0,1,0,0,3,1.3666666666666667
模型视觉,0,0,0,0,2,3,1,6,1.45
模型传输顺序,0,0,0,0,1,0,0,1,0.24166666666666667
非对等差错保护算法,0,0,0,0,1,0,0,1,0.24166666666666667
uep-ltcode,0,0,0,0,1,0,0,1,0.24166666666666667
简化算法,0,0,0,1,1,0,0,2,0.3666666666666667
兴趣区域管理,0,0,1,1,1,3,2,8,1.7
编码,0,0,0,1,1,0,0,2,0.3666666666666667
模型简化,0,0,0,0,1,0,0,1,0.24166666666666667
网格,0,0,2,1,18,3,0,24,5.45
简化率,0,0,0,2,6,4,2,14,3.15
相机坐标系,0,0,0,0,10,0,0,10,2.4166666666666665
投影坐标系,0,0,0,0,4,0,0,4,0.9666666666666667
相机,0,0,0,0,12,3,0,15,3.625
视距,0,0,1,0,5,0,1,7,1.575
三维模型,2,1,14,18,15,1,4,55,12.833333333333332
视觉注意机制,0,0,1,0,3,1,0,5,1.0916666666666668
面积,0,0,0,2,3,0,0,5,0.975
近裁剪平面,0,0,0,0,3,0,0,3,0.725
透视投影,0,0,0,0,3,1,0,4,0.9666666666666667
lod模型,0,0,0,0,4,0,0,4,0.9666666666666667
三角面,0,0,1,6,14,0,0,21,4.258333333333333
精度,0,0,0,0,3,0,0,3,0.725
armadillo模型,0,0,0,0,3,2,0,5,1.2083333333333333
平均高斯权重,0,0,0,0,2,0,0,2,0.48333333333333334
曲率,0,0,0,0,2,0,0,2,0.48333333333333334
特征,0,0,0,0,2,0,0,2,0.48333333333333334
gl,0,0,0,0,2,0,0,2,0.48333333333333334
像素数,0,0,0,0,3,0,0,3,0.725
屏幕坐标系,0,0,0,0,3,0,0,3,0.725
宽高比,0,0,0,0,2,0,0,2,0.48333333333333334
像素,0,0,0,3,2,0,0,5,0.8583333333333334
平均面部,0,0,0,0,2,0,0,2,0.48333333333333334
模型边缘盒,0,0,0,0,2,0,0,2,0.48333333333333334
包围盒,0,0,0,0,3,0,0,3,0.725
三维网格模型,1,0,4,8,4,1,0,18,3.708333333333333
对角线长度,0,0,0,0,2,0,0,2,0.48333333333333334
顶点,0,0,2,15,5,1,0,23,3.575
视觉机制,0,0,0,0,2,0,0,2,0.48333333333333334
平滑,0,0,0,0,1,0,0,1,0.24166666666666667
著性区域,0,0,0,0,1,0,0,1,0.24166666666666667
模型网格,0,0,0,0,3,0,0,3,0.725
截止尺度,0,0,0,0,1,0,0,1,0.24166666666666667
尺度,1,0,3,1,1,2,1,9,2.466666666666667
中心-周围机制,0,0,0,0,1,0,0,1,0.24166666666666667
均值曲率,0,0,0,0,1,0,0,1,0.24166666666666667
oint,0,0,0,0,1,0,0,1,0.24166666666666667
mes,0,0,0,0,1,0,0,1,0.24166666666666667
均值,0,0,0,0,1,0,0,1,0.24166666666666667
维度,0,0,0,0,1,1,0,2,0.48333333333333334
显著性,0,0,0,0,1,0,0,1,0.24166666666666667
视觉感知特征,0,0,0,0,1,0,0,1,0.24166666666666667
视觉感知质量,0,0,0,0,1,0,0,1,0.24166666666666667
分辨率,0,0,5,3,7,2,0,17,3.175
显示设备,0,0,0,0,1,0,0,1,0.24166666666666667
相机参数,0,0,0,0,2,0,0,2,0.48333333333333334
areacamera,0,0,0,0,1,0,0,1,0.24166666666666667
边缘盒顶点坐标,0,0,0,0,1,0,0,1,0.24166666666666667
areanear,0,0,0,0,1,0,0,1,0.24166666666666667
areaobj,0,0,0,0,1,0,0,1,0.24166666666666667
显示屏幕,0,0,0,0,1,0,0,1,0.24166666666666667
pscr,0,0,0,0,1,0,0,1,0.24166666666666667
远裁剪平面,0,0,0,0,1,0,0,1,0.24166666666666667
near,0,0,0,0,1,0,0,1,0.24166666666666667
投影平面,0,0,0,0,1,0,0,1,0.24166666666666667
开角角度,0,0,0,0,1,0,0,1,0.24166666666666667
视锥体,0,0,0,0,8,0,0,8,1.9333333333333333
视场,0,0,0,0,1,0,0,1,0.24166666666666667
参数,0,0,0,0,2,1,0,3,0.725
ne,0,0,0,0,1,0,0,1,0.24166666666666667
erspective,0,0,0,0,1,0,0,1,0.24166666666666667
透视矩阵,0,0,0,0,1,0,0,1,0.24166666666666667
函数,0,0,0,0,2,0,0,2,0.48333333333333334
3dapis,0,0,0,0,1,0,0,1,0.24166666666666667
d3d,0,0,0,0,1,0,0,1,0.24166666666666667
投影后,0,0,0,0,1,0,0,1,0.24166666666666667
世界坐标系,0,0,0,0,10,0,0,10,2.4166666666666665
中心轴向偏移,0,0,0,0,1,0,0,1,0.24166666666666667
成像平面,0,0,0,0,2,0,0,2,0.48333333333333334
焦距,0,0,0,0,1,0,0,1,0.24166666666666667
内参,0,0,0,0,2,0,0,2,0.48333333333333334
3d渲染,0,0,0,0,1,0,0,1,0.24166666666666667
视觉系统,0,0,1,0,1,0,0,2,0.3666666666666667
正交投影,0,0,0,0,1,0,0,1,0.24166666666666667
投影过,0,0,0,0,1,0,0,1,0.24166666666666667
质量,0,0,0,1,1,1,0,3,0.6083333333333334
面部区域,0,0,0,0,1,0,0,1,0.24166666666666667
像素面积,0,0,0,0,1,0,0,1,0.24166666666666667
三维网格简化模型,0,0,0,0,1,0,0,1,0.24166666666666667
边界框,0,0,0,0,1,0,0,1,0.24166666666666667
视觉退化,0,0,0,0,1,0,0,1,0.24166666666666667
对象,0,0,0,0,1,0,0,1,0.24166666666666667
vs,0,0,0,0,1,1,0,2,0.48333333333333334
几何信息,0,0,0,0,1,0,0,1,0.24166666666666667
三角形,0,0,0,1,1,0,0,2,0.3666666666666667
顶点数,0,0,0,0,1,1,0,2,0.48333333333333334
视觉分辨率,2,0,3,0,1,0,2,8,3.1
humanvisualsystem,0,0,0,0,1,0,0,1,0.24166666666666667
人类视觉系统,0,0,0,0,1,0,0,1,0.24166666666666667
视觉感知实验,0,0,0,0,1,0,0,1,0.24166666666666667
mipmap技术,0,0,0,0,5,0,0,5,1.2083333333333333
纹理贴图,0,0,3,1,1,0,0,5,0.7416666666666667
三角形网格,0,0,1,1,1,0,0,3,0.4916666666666667
化编码,0,0,0,0,0,1,0,1,0.24166666666666667
仿真实验,0,0,0,0,0,4,0,4,0.9666666666666667
模型视觉质量,0,0,0,0,0,1,0,1,0.24166666666666667
模型内容视觉感知,0,0,0,0,0,1,0,1,0.24166666666666667
传输队列,0,0,0,3,0,11,0,14,3.033333333333333
客户端,0,0,8,10,2,10,4,34,6.116666666666667
纹理图片,9,0,18,20,22,11,11,91,24.383333333333333
内容,0,0,2,3,2,2,0,9,1.5916666666666668
请求队列,0,0,0,0,0,5,0,5,1.2083333333333333
请求数据,0,0,0,0,0,4,0,4,0.9666666666666667
网络,1,0,1,0,0,4,0,6,2.091666666666667
信道编码,0,0,0,0,0,2,0,2,0.48333333333333334
数据预处理,0,0,0,0,0,3,0,3,0.725
服务器端,0,0,0,0,0,4,3,7,1.6916666666666667
场景视觉,0,0,0,0,0,1,0,1,0.24166666666666667
请求,0,0,0,0,0,4,0,4,0.9666666666666667
纹理,0,0,0,1,10,2,0,13,3.025
细节层次模型,0,0,0,0,0,1,0,1,0.24166666666666667
网络拥塞,0,0,0,0,0,1,0,1,0.24166666666666667
队列,0,0,0,0,0,1,0,1,0.24166666666666667
数据,0,0,2,3,4,2,0,11,2.075
模型文件,0,0,1,0,1,1,0,3,0.6083333333333334
渐进式编码,0,0,0,1,1,2,2,6,1.3333333333333333
数据预处理器,0,0,0,0,0,1,0,1,0.24166666666666667
系统框架,0,0,0,0,0,1,0,1,0.24166666666666667
解码,0,0,1,1,1,1,0,4,0.7333333333333334
子模块,0,0,0,0,0,1,0,1,0.24166666666666667
服务器客户端,0,0,0,0,0,1,0,1,0.24166666666666667
服务器,0,0,0,2,0,6,1,9,1.9416666666666667
传输方案,0,0,0,0,0,1,0,1,0.24166666666666667
渲染管线,2,0,3,2,16,3,2,28,7.7
渐进式传输技术,0,0,2,3,0,0,0,5,0.625
性能,0,0,2,3,0,0,0,5,0.625
画面视觉质量,1,0,2,0,0,1,0,4,1.4916666666666667
画面质量,0,0,1,0,2,5,0,8,1.8166666666666667
仿真环境,0,0,1,0,0,2,0,3,0.6083333333333334
性能评估,0,0,1,0,0,0,0,1,0.125
三维虚拟场景传输系统,0,0,1,0,0,0,0,1,0.125
场景传输,0,0,1,0,0,0,0,1,0.125
渐进式传输优化,0,0,1,0,1,0,0,2,0.3666666666666667
纹理图片压缩,0,0,1,1,0,0,0,2,0.25
场景渐进式传输技术,0,0,1,0,0,0,0,1,0.125
三维流,0,0,3,4,0,0,0,7,0.875
点云模型,0,0,5,16,0,0,0,21,2.625
虚拟场景,0,0,6,4,2,0,1,13,1.975
传输技术,0,0,0,1,0,0,0,1,0.125
增强层,0,0,0,2,9,2,0,13,2.908333333333333
基础网格,0,0,0,1,3,0,0,4,0.85
编号,0,0,0,0,3,0,0,3,0.725
基网格,0,0,0,0,3,0,0,3,0.725
udp,0,0,0,0,2,0,0,2,0.48333333333333334
实时性,0,0,0,1,2,2,0,5,1.0916666666666668
传输,0,0,7,6,2,4,2,21,3.5583333333333336
基础层,0,0,2,2,3,1,0,8,1.4666666666666668
场景视觉排序,0,0,0,0,1,0,0,1,0.24166666666666667
数据请求,0,0,0,0,1,3,0,4,0.9666666666666667
数据量,1,0,3,8,2,5,1,20,4.308333333333334
lod,0,0,0,0,1,0,0,1,0.24166666666666667
视点信息,0,0,0,0,1,0,0,1,0.24166666666666667
用户,0,0,0,1,1,1,0,3,0.6083333333333334
纹理质量,0,0,0,0,1,0,0,1,0.24166666666666667
画面视觉,0,0,0,0,1,0,0,1,0.24166666666666667
纹理层次,0,0,0,0,1,0,0,1,0.24166666666666667
网格层次,0,0,0,0,1,0,0,1,0.24166666666666667
传输效率,0,0,1,2,1,0,0,4,0.6166666666666667
传输延迟,0,0,0,0,1,0,0,1,0.24166666666666667
靠通道,0,0,0,0,1,0,0,1,0.24166666666666667
渲染模型,0,0,0,0,1,0,0,1,0.24166666666666667
tcp,0,0,0,0,1,0,0,1,0.24166666666666667
可靠传输,0,0,0,0,1,0,0,1,0.24166666666666667
3d模型,1,0,1,0,7,0,0,9,2.8166666666666664
基础纹理,0,0,0,0,1,0,0,1,0.24166666666666667
细化层,0,0,0,0,1,0,0,1,0.24166666666666667
原始质量,0,0,0,0,1,0,0,1,0.24166666666666667
最低分辨率纹理图片,0,0,0,0,1,0,0,1,0.24166666666666667
延迟,0,0,0,0,1,0,0,1,0.24166666666666667
次要数据,0,0,0,0,1,0,0,1,0.24166666666666667
用户数据报协议,0,0,0,0,1,0,0,1,0.24166666666666667
tcp传输,0,0,0,0,1,0,0,1,0.24166666666666667
制协议,0,0,0,0,1,0,0,1,0.24166666666666667
传输控,0,0,0,0,1,0,0,1,0.24166666666666667
可靠性,0,0,0,0,1,2,0,3,0.725
带宽资源,1,0,0,2,1,0,0,4,1.4916666666666667
信息,0,0,1,2,2,1,0,6,1.1
依赖关系,0,0,0,0,1,0,0,1,0.24166666666666667
纹理信息数据,0,0,0,0,1,0,0,1,0.24166666666666667
纹理数据,0,0,0,0,1,0,0,1,0.24166666666666667
网格数据,0,0,0,0,1,0,0,1,0.24166666666666667
渐进式网格编码,0,0,0,0,1,0,0,1,0.24166666666666667
增强层信息,0,0,0,0,1,0,0,1,0.24166666666666667
纹理信息,0,0,0,1,1,0,0,2,0.3666666666666667
网格信息,0,0,0,0,2,0,0,2,0.48333333333333334
纹理增强层集合,0,0,0,0,1,0,0,1,0.24166666666666667
基纹理集合,0,0,0,0,1,0,0,1,0.24166666666666667
网格增强层集合,0,0,0,0,1,0,0,1,0.24166666666666667
基网格集合,0,0,0,0,1,0,0,1,0.24166666666666667
三维模型信息,0,0,0,0,1,0,0,1,0.24166666666666667
纹理人,0,0,0,0,1,0,0,1,0.24166666666666667
模型信息集合,0,0,0,0,1,0,0,1,0.24166666666666667
纹理心,0,0,0,0,1,0,0,1,0.24166666666666667
纹理层,0,0,0,0,1,0,0,1,0.24166666666666667
映射关,0,0,0,0,1,0,0,1,0.24166666666666667
纹理图,0,0,0,0,1,0,0,1,0.24166666666666667
增强层数据,0,0,0,0,1,0,0,1,0.24166666666666667
压缩编码,1,0,0,1,1,0,0,3,1.3666666666666667
姿态,0,0,0,0,8,1,0,9,2.175
变量,0,0,0,0,4,0,0,4,0.9666666666666667
旋转矩阵,0,0,0,0,4,0,0,4,0.9666666666666667
位移矩阵,0,0,0,0,3,0,0,3,0.725
误差,0,0,0,1,2,0,0,3,0.6083333333333334
方程,0,0,0,0,2,0,0,2,0.48333333333333334
空间,0,0,1,2,2,0,0,5,0.8583333333333334
ar应用,0,0,0,0,2,0,0,2,0.48333333333333334
刚体模型,0,0,0,0,1,0,0,1,0.24166666666666667
计算过程,0,0,0,0,1,0,0,1,0.24166666666666667
facs系数,0,0,0,0,1,0,0,1,0.24166666666666667
人脸,0,0,0,0,1,0,0,1,0.24166666666666667
计算,0,0,0,0,1,0,0,1,0.24166666666666667
非刚体模型,0,0,0,0,1,0,0,1,0.24166666666666667
拟合运算,0,0,0,0,1,0,0,1,0.24166666666666667
图像识别,0,0,0,0,1,0,0,1,0.24166666666666667
平移矩阵,0,0,0,0,1,0,0,1,0.24166666666666667
矩阵方程,0,0,0,0,1,0,0,1,0.24166666666666667
投影矩阵方程,0,0,0,0,1,0,0,1,0.24166666666666667
位姿,0,0,0,0,1,0,0,1,0.24166666666666667
物体,0,0,3,4,11,0,0,18,3.533333333333333
投影映射关系,0,0,0,0,1,0,0,1,0.24166666666666667
成像点,0,0,0,0,1,0,0,1,0.24166666666666667
图像成像,0,0,0,0,1,0,0,1,0.24166666666666667
特征关键点,0,0,0,0,1,0,0,1,0.24166666666666667
现实空间,0,0,0,0,1,0,0,1,0.24166666666666667
perspective-n-point,0,0,0,0,1,0,0,1,0.24166666666666667
pnp,0,0,0,0,1,0,0,1,0.24166666666666667
姿态求解,0,0,0,0,1,0,0,1,0.24166666666666667
旋转角度,0,0,0,0,1,0,0,1,0.24166666666666667
位移距离,0,0,0,0,1,0,0,1,0.24166666666666667
姿态矩阵,0,0,0,0,1,0,0,1,0.24166666666666667
相机视角宽,0,0,0,0,1,0,0,1,0.24166666666666667
dy,0,0,0,0,1,0,0,1,0.24166666666666667
主轴偏移,0,0,0,0,1,0,0,1,0.24166666666666667
相机焦距,0,0,0,0,1,0,0,1,0.24166666666666667
投影变换过程,0,0,0,0,1,0,0,1,0.24166666666666667
二维平面,0,0,0,0,1,0,0,1,0.24166666666666667
投影矩阵变换,0,0,0,0,1,0,0,1,0.24166666666666667
姿态矩阵变换,0,0,0,0,1,0,0,1,0.24166666666666667
投影变换,0,0,0,0,1,0,0,1,0.24166666666666667
位置信息,0,0,0,1,1,0,0,2,0.3666666666666667
二维图片,0,0,0,0,1,0,0,1,0.24166666666666667
变换,0,0,0,0,1,0,0,1,0.24166666666666667
坐标,0,0,0,1,18,0,0,19,4.475
坐标系,0,0,0,0,4,0,0,4,0.9666666666666667
坐标转换过,0,0,0,0,1,0,0,1,0.24166666666666667
成像过程,0,0,0,0,1,0,0,1,0.24166666666666667
定位,0,0,0,0,1,0,0,1,0.24166666666666667
世界,0,0,0,0,1,0,0,1,0.24166666666666667
3d游戏,0,0,0,0,1,0,0,1,0.24166666666666667
渲染流程,0,0,0,0,1,0,0,1,0.24166666666666667
纹理图像,0,0,0,5,0,0,0,5,0.625
纹理压缩,0,1,0,4,0,0,0,5,2.5
纹理压缩标准,0,0,0,3,0,0,0,3,0.375
失真,0,0,0,3,0,0,0,3,0.375
纹理空间,0,0,0,2,0,0,0,2,0.25
s3tc,0,0,0,2,0,0,0,2,0.25
opengl,0,0,0,2,0,0,0,2,0.25
框架,0,0,0,2,0,0,0,2,0.25
编码速度,0,0,0,2,0,0,0,2,0.25
解压,0,0,0,2,0,0,0,2,0.25
降采样系数,1,0,1,1,1,0,1,5,1.7333333333333334
细节,1,0,0,1,0,1,1,4,1.6083333333333334
分段线性形变平衡图像频谱,0,0,0,1,0,0,0,1,0.125
傅里叶,0,0,0,1,0,0,0,1,0.125
频率,0,0,0,1,0,0,0,1,0.125
coherb,0,0,0,1,0,0,0,1,0.125
hunter,0,0,0,1,0,0,0,1,0.125
多级形变,0,0,0,1,0,0,0,1,0.125
图像,0,0,0,1,1,0,0,2,0.3666666666666667
纹理曲翘,0,0,0,1,0,0,0,1,0.125
纹理变形,0,0,0,1,0,0,0,1,0.125
变形纹理图片,0,0,0,1,0,0,0,1,0.125
细节特征,0,0,0,1,0,0,0,1,0.125
细节特征分布,0,0,0,1,0,0,0,1,0.125
像素预算,0,0,0,1,0,0,1,2,0.3666666666666667
采样,1,0,0,1,0,0,1,3,1.3666666666666667
渐进式传输系统,1,0,1,1,0,0,1,4,1.4916666666666667
lods网格模型,0,0,0,1,0,0,0,1,0.125
纹理图像压缩,0,0,0,1,0,0,0,1,0.125
directx,0,0,0,1,0,0,0,1,0.125
接口,0,0,0,1,0,0,0,1,0.125
多媒体组件,0,0,0,1,0,0,0,1,0.125
blocktruncationcoding,0,0,0,1,0,0,0,1,0.125
块剪裁编码,0,0,0,1,0,0,0,1,0.125
纹理图片压缩算法,0,0,0,1,0,0,0,1,0.125
图形处理器,0,0,0,2,4,0,0,6,1.2166666666666668
爱立信纹理压缩,0,0,0,1,0,0,0,1,0.125
directx纹理压缩,0,0,0,1,0,0,0,1,0.125
tc,0,0,0,1,0,0,0,1,0.125
adaptivescalabletexturecompression,0,0,0,1,0,0,0,1,0.125
自适应可伸缩纹理纹理压缩方法,0,0,0,1,0,0,0,1,0.125
arm,0,0,0,1,0,0,0,1,0.125
读取,0,0,0,1,0,0,0,1,0.125
通图片,0,0,0,1,0,0,0,1,0.125
随机访问,0,0,0,1,0,0,0,1,0.125
系统效率,0,0,0,1,0,0,0,1,0.125
压缩编码效率,0,0,0,1,0,0,0,1,0.125
压缩,0,0,0,3,0,0,1,4,0.6166666666666667
压缩比,0,0,0,2,0,0,0,2,0.25
高精度,0,0,0,1,0,0,0,1,0.125
压缩率,0,0,0,1,0,0,0,1,0.125
图像质量,0,0,0,1,0,0,0,1,0.125
渲染,0,0,2,3,1,0,1,7,1.1083333333333334
实时渲染,0,0,0,1,0,0,0,1,0.125
处理器,0,0,0,2,0,0,0,2,0.25
解压速度,0,0,0,1,0,0,0,1,0.125
图像压缩算法,0,0,0,1,0,0,0,1,0.125
网格模型素材,0,0,0,1,1,0,0,2,0.3666666666666667
传输数据量,0,0,0,1,1,0,0,2,0.3666666666666667
mmorpg游戏,0,0,0,1,0,0,0,1,0.125
属性信息,0,0,1,2,1,0,0,4,0.6166666666666667
强度信息,0,0,0,3,0,0,0,3,0.375
点数,0,0,0,2,0,0,0,2,0.25
噪声,0,0,0,2,0,0,0,2,0.25
三维坐标,0,0,0,2,1,0,0,3,0.4916666666666667
数据信息,0,0,0,3,0,0,0,3,0.375
点云,0,0,0,2,0,0,0,2,0.25
模型质量,0,0,0,2,0,0,0,2,0.25
点数驱动算法,0,0,0,1,0,0,0,1,0.125
误差驱动算法,0,0,0,1,0,0,0,1,0.125
点数驱动,0,0,0,1,0,0,0,1,0.125
误差驱动,0,0,0,1,0,0,0,1,0.125
客户端处理器,0,0,0,1,0,0,0,1,0.125
实时传输带宽,0,0,0,1,0,0,0,1,0.125
tail,0,0,0,1,0,0,0,1,0.125
level,0,0,0,1,0,0,0,1,0.125
细节层次,0,0,0,1,0,0,0,1,0.125
颜色信息,0,0,0,2,0,0,0,2,0.25
光照角度,0,0,0,1,0,0,0,1,0.125
粗糙程度,0,0,0,1,0,0,0,1,0.125
材质信息,0,0,0,2,0,0,0,2,0.25
反射强度,0,0,0,1,0,0,0,1,0.125
光线,0,0,0,1,0,0,0,1,0.125
激光波长,0,0,0,1,0,0,0,1,0.125
发射能量,0,0,0,1,0,0,0,1,0.125
探测设备,0,0,0,1,0,0,0,1,0.125
入射角,0,0,0,1,0,0,0,1,0.125
粗糙,0,0,0,1,0,0,0,1,0.125
材质,0,0,0,1,0,0,0,1,0.125
激光反射强度,0,0,0,1,0,0,0,1,0.125
数据信,0,0,0,1,0,0,0,1,0.125
激光扫描仪,0,0,0,1,0,0,0,1,0.125
3d扫描设备,0,0,0,1,0,0,0,1,0.125
多图建模,0,0,0,3,0,0,0,3,0.375
3d扫描建模,0,0,0,3,0,0,0,3,0.375
pointcloud,0,0,0,1,0,0,0,1,0.125
集合,0,0,0,2,1,0,0,3,0.4916666666666667
空间坐标,0,0,0,1,0,0,0,1,0.125
采样点,0,0,0,1,2,0,0,3,0.6083333333333334
海量点,0,0,0,1,0,0,0,1,0.125
表面特性,0,0,0,1,0,0,0,1,0.125
空间分布,0,0,0,1,0,0,0,1,0.125
空间参考系,0,0,0,1,0,0,0,1,0.125
云模型,0,0,0,1,0,0,0,1,0.125
多分辨率压缩,0,0,0,3,0,0,0,3,0.375
单分辨率压缩,0,0,0,2,0,0,0,2,0.25
存储空间,0,0,2,4,1,0,0,7,0.9916666666666667
光照材质信息,0,0,0,3,0,0,0,3,0.375
连接关系,0,0,0,2,0,0,0,2,0.25
模型压缩,0,0,0,1,0,0,0,1,0.125
最低分辨率模型,0,0,0,1,0,0,0,1,0.125
模型数据,0,0,0,1,0,1,0,2,0.3666666666666667
avid模型,0,0,0,1,0,0,0,1,0.125
网络带宽,0,0,0,2,0,0,0,2,0.25
计算能力,0,0,0,1,0,0,0,1,0.125
计算机,0,0,0,3,0,0,0,3,0.375
高精度模型,0,0,0,1,0,0,0,1,0.125
沉浸式,1,0,1,1,0,0,0,3,1.25
米开朗基罗工程,0,0,0,1,0,0,0,1,0.125
数字,0,0,0,1,0,0,0,1,0.125
计算机软件硬件,0,0,0,1,0,0,0,1,0.125
三维模型采集技术,0,0,0,1,0,0,0,1,0.125
菲涅尔发射系数,0,0,0,2,0,0,0,2,0.25
光泽度,0,0,0,2,0,0,0,2,0.25
粗糙度,0,0,0,2,0,0,0,2,0.25
三维信息,0,0,0,1,0,0,0,1,0.125
位置坐标,0,0,0,1,1,0,0,2,0.3666666666666667
贴图,0,0,0,1,0,0,0,1,0.125
纹理集合,0,0,0,1,1,0,0,2,0.3666666666666667
属性数据,0,0,0,1,0,0,0,1,0.125
顶点集合,0,0,0,1,0,0,0,1,0.125
拓扑数据,0,0,0,1,0,0,0,1,0.125
坐标信息,0,0,0,1,0,0,0,1,0.125
位置,0,0,0,1,0,2,0,3,0.6083333333333334
几何数据,0,0,0,1,0,0,0,1,0.125
三角形网格模型,0,0,0,1,0,0,0,1,0.125
多边形网格,0,0,0,1,0,0,0,1,0.125
包围球,0,0,0,0,8,0,0,8,1.9333333333333333
近平面,0,0,0,0,5,0,0,5,1.2083333333333333
远平面,0,0,0,0,4,0,0,4,0.9666666666666667
物体消除,0,0,0,0,2,0,0,2,0.48333333333333334
x轴,0,0,0,0,3,0,0,3,0.725
球心,0,0,0,0,2,0,0,2,0.48333333333333334
z轴,0,0,0,0,3,0,0,3,0.725
视椎体,0,0,2,0,2,0,0,4,0.7333333333333334
半径,1,0,0,1,3,0,0,5,1.85
球体,0,0,0,1,2,0,0,3,0.6083333333333334
渲染管线物体,0,0,0,0,1,0,0,1,0.24166666666666667
传输数据,0,0,0,0,1,0,1,2,0.48333333333333334
剪裁平面,0,0,0,0,1,0,0,1,0.24166666666666667
系统参数,0,0,0,0,1,0,0,1,0.24166666666666667
远平面距离,0,0,0,0,1,0,0,1,0.24166666666666667
近平面距离,0,0,0,0,1,0,0,1,0.24166666666666667
视平面宽度,0,0,0,0,1,0,0,1,0.24166666666666667
球心坐标,0,0,0,0,1,0,0,1,0.24166666666666667
消除条件,0,0,0,0,1,0,0,1,0.24166666666666667
左平面,0,0,0,0,1,0,0,1,0.24166666666666667
视锥体右平面,0,0,0,0,1,0,0,1,0.24166666666666667
端点,0,0,0,0,1,0,0,1,0.24166666666666667
平面方程,0,0,0,0,1,0,0,1,0.24166666666666667
内包围球,0,0,0,0,1,0,0,1,0.24166666666666667
y平面,0,0,0,0,1,0,0,1,0.24166666666666667
平面,0,0,0,0,1,0,0,1,0.24166666666666667
平面俯视图,0,0,0,0,1,0,0,1,0.24166666666666667
球心连线,0,0,0,0,1,0,0,1,0.24166666666666667
平行土x轴,0,0,0,0,1,0,0,1,0.24166666666666667
包围球半径,0,0,0,0,1,0,0,1,0.24166666666666667
远剪裁平面,1,0,0,0,1,0,0,2,1.2416666666666667
视线,1,0,1,2,1,1,0,6,1.8583333333333334
视点相机,0,0,0,0,1,0,0,1,0.24166666666666667
显著值,0,0,0,0,2,0,0,2,0.48333333333333334
azimuth,0,0,0,0,2,0,0,2,0.48333333333333334
仰角,0,0,0,0,3,0,0,3,0.725
方位角,0,0,0,0,4,0,0,4,0.9666666666666667
基视点,0,0,0,0,2,0,0,2,0.48333333333333334
整数,0,0,0,0,1,0,0,1,0.24166666666666667
曲线,0,0,0,0,2,1,0,3,0.725
线性相关,0,0,0,0,1,0,0,1,0.24166666666666667
ny,0,0,0,0,1,0,0,1,0.24166666666666667
单位区间,0,0,0,0,1,0,0,1,0.24166666666666667
非线性映射,0,0,0,0,1,0,0,1,0.24166666666666667
标准差,0,0,0,0,1,0,0,1,0.24166666666666667
盘墨,0,0,0,0,1,0,0,1,0.24166666666666667
nv,0,0,0,0,1,0,0,1,0.24166666666666667
多视点,0,0,0,0,1,1,0,2,0.48333333333333334
量量化,0,0,0,0,1,0,0,1,0.24166666666666667
信息量,0,0,0,0,2,0,0,2,0.48333333333333334
三维空间,0,0,0,0,1,0,0,1,0.24166666666666667
著性,0,0,0,0,1,0,0,1,0.24166666666666667
可见像素,0,0,0,0,1,0,0,1,0.24166666666666667
视点坐标,0,0,0,0,1,2,0,3,0.725
距离坐标,0,0,0,0,1,0,0,1,0.24166666666666667
球坐标系,0,0,0,0,1,0,0,1,0.24166666666666667
度量,0,0,0,0,2,0,0,2,0.48333333333333334
相机坐标,0,0,0,0,5,2,0,7,1.6916666666666667
观看视点,0,0,0,0,1,0,0,1,0.24166666666666667
视觉内容,0,0,2,1,2,0,2,7,1.3416666666666668
对象流,0,0,0,5,0,0,0,5,0.625
场景流,0,0,0,4,0,0,0,4,0.5
三维场景流,0,0,2,4,0,0,0,6,0.75
三维虚拟场景,1,0,6,3,3,0,4,17,3.8166666666666664
图像流,0,0,0,2,0,0,0,2,0.25
可视化流,0,0,0,2,0,0,0,2,0.25
场景模型,0,0,0,1,0,0,0,1,0.125
内场可视内容,0,0,0,1,0,0,0,1,0.125
漫游,0,0,0,1,0,0,0,1,0.125
可见对象集合,0,0,0,1,0,0,0,1,0.125
视野,0,0,3,2,0,1,0,6,0.8666666666666667
预编码,0,0,1,1,0,0,0,2,0.25
模型对象,0,0,0,1,0,1,0,2,0.3666666666666667
视频压缩,0,0,1,1,0,0,0,2,0.25
信号传输,0,0,1,1,0,0,0,2,0.25
颗粒度,0,0,0,1,0,0,0,1,0.125
5g网络,0,0,1,1,0,0,0,2,0.25
刷新,0,0,1,1,0,0,0,2,0.25
刷新率,0,0,1,1,0,0,0,2,0.25
画面,0,0,1,1,0,0,0,2,0.25
动态场景,0,0,1,1,0,0,0,2,0.25
流畅性,0,0,1,1,0,0,0,2,0.25
高实时性应用,0,0,1,1,0,0,0,2,0.25
视频,0,0,2,1,0,0,0,3,0.375
应用内容,0,0,1,1,0,0,0,2,0.25
云端,0,0,1,1,0,0,0,2,0.25
云游戏,0,0,0,1,0,0,0,1,0.125
视频流,0,0,0,1,0,0,0,1,0.125
传输介质,0,0,0,1,0,0,0,1,0.125
传输序列,0,0,0,1,0,0,0,1,0.125
视角,0,0,0,1,1,0,0,2,0.3666666666666667
传输顺序,0,0,1,1,0,0,0,2,0.25
媒体内容,0,0,0,1,0,0,0,1,0.125
数据内容,0,0,0,1,0,0,0,1,0.125
时间序列,0,0,0,2,0,0,0,2,0.25
音视频流,0,0,0,1,0,0,0,1,0.125
音视频媒体流,0,0,0,1,0,0,0,1,0.125
下载,0,0,0,1,0,0,0,1,0.125
等待时间,0,0,0,1,0,0,0,1,0.125
启动延时,0,0,0,1,0,0,0,1,0.125
音视频流媒体,0,0,0,1,0,0,0,1,0.125
三维内容,0,0,0,1,1,0,0,2,0.3666666666666667
3dstreaming,0,0,0,1,0,0,0,1,0.125
混合传输协议,0,0,0,0,0,3,0,3,0.725
先级,0,0,0,0,0,1,0,1,0.24166666666666667
三维模型传输,0,0,0,0,0,1,0,1,0.24166666666666667
视觉特,0,0,0,0,0,1,0,1,0.24166666666666667
多分辨率编码,0,0,0,0,1,2,0,3,0.725
场景三维模型,0,0,0,0,0,2,0,2,0.48333333333333334
渐进式纹理,0,0,0,0,0,1,0,1,0.24166666666666667
渐进式网格技术,0,0,0,0,0,1,0,1,0.24166666666666667
兴趣管理机制,0,0,0,0,0,2,0,2,0.48333333333333334
传输列表,0,0,2,0,0,0,0,2,0.25
遮挡,0,0,2,0,0,0,0,2,0.25
渐进式加载,0,0,2,0,0,0,0,2,0.25
拓扑结构,0,0,2,6,0,0,0,8,1.0
灵活性,0,0,1,1,0,0,0,2,0.25
质量对象,0,0,1,1,0,0,0,2,0.25
数据总量,0,0,1,1,0,0,0,2,0.25
有效数据,0,0,1,1,0,0,0,2,0.25
采样率,1,0,1,1,0,0,0,3,1.25
网络延时,0,0,1,1,0,0,0,2,0.25
漫游视觉效果,0,0,1,1,0,0,0,2,0.25
多分辨率建模技,0,0,1,1,0,0,0,2,0.25
可视内容,0,0,1,1,0,0,0,2,0.25
椎体,0,0,1,0,0,0,0,1,0.125
interest,0,0,1,0,0,0,0,1,0.125
interestmanagement,0,0,1,0,0,0,0,1,0.125
兴趣管理技术,0,0,1,1,0,0,0,2,0.25
模型数据传输,0,0,1,0,0,0,0,1,0.125
可视对,0,0,1,0,0,0,0,1,0.125
体验,0,0,1,0,0,0,0,1,0.125
可视,0,0,1,0,0,0,0,1,0.125
可视距离,0,0,1,3,0,1,0,5,0.7416666666666667
增量信息网格,0,0,1,0,0,0,0,1,0.125
基础信息网格,0,0,1,0,0,0,0,1,0.125
边缘折叠,0,0,1,0,0,0,0,1,0.125
progressivemesh,0,0,1,0,0,0,0,1,0.125
渐进网格,0,0,1,0,0,0,0,1,0.125
hoppe,0,0,1,1,0,0,0,2,0.25
优化层,0,0,1,0,0,0,0,1,0.125
三维媒体,0,0,1,0,0,0,0,1,0.125
三维场,0,0,1,0,0,0,0,1,0.125
本地存储空间,0,0,3,0,0,0,0,3,0.375
虚拟场景应用,0,0,1,0,0,0,0,1,0.125
时间,0,0,1,0,0,2,0,3,0.6083333333333334
实时漫游,0,0,1,1,0,0,0,2,0.25
网格模型数据,0,0,1,0,0,0,0,1,0.125
视频传输,0,0,1,0,0,0,0,1,0.125
云服务器,0,0,1,0,0,0,0,1,0.125
移动设备,0,0,1,0,0,1,0,2,0.3666666666666667
存储,0,0,1,1,0,0,0,2,0.25
复用率,0,0,1,1,0,0,0,2,0.25
储存连接关系,0,0,1,1,0,0,0,2,0.25
几何连接,0,0,1,1,0,0,0,2,0.25
三维重建,0,0,1,1,0,0,0,2,0.25
复用,0,0,1,1,0,0,0,2,0.25
光照材质,0,0,1,0,0,0,0,1,0.125
边折叠,0,0,0,6,0,0,0,6,0.75
点分裂,0,0,0,5,0,0,0,5,0.625
pm算法,0,0,0,4,0,1,0,5,0.7416666666666667
渐进式压缩,0,0,4,4,1,1,1,11,1.725
边结构,0,0,0,2,0,0,0,2,0.25
拓扑结构信息,0,0,0,2,0,0,0,2,0.25
空间坐标信息,0,0,0,2,0,0,0,2,0.25
progressivemeshes,0,0,0,2,0,0,0,2,0.25
渐进式网格,0,0,0,2,0,0,0,2,0.25
渐边折叠,0,0,0,1,0,0,0,1,0.125
逆过程,0,0,0,1,0,0,0,1,0.125
点分裂操,0,0,0,1,0,0,0,1,0.125
顶点vs,0,0,0,1,0,0,0,1,0.125
顶点班,0,0,0,1,0,0,0,1,0.125
增强信息,0,0,0,1,0,0,0,1,0.125
半边折叠,0,0,0,1,0,0,0,1,0.125
边折叠操作,0,0,0,1,0,0,0,1,0.125
compressed,0,0,0,1,0,0,0,1,0.125
la,0,0,0,1,0,0,0,1,0.125
压缩几何数据,0,0,0,1,0,0,0,1,0.125
森林分裂操作,0,0,0,1,0,0,0,1,0.125
progressiveforests,0,0,0,1,0,0,0,1,0.125
渐进森林分裂表示算法,0,0,0,1,0,0,0,1,0.125
vertex-split,0,0,0,1,0,0,0,1,0.125
edge-collapse,0,0,0,1,0,0,0,1,0.125
算法,1,0,1,1,0,0,0,3,1.25
虚拟现实,1,0,2,0,0,0,0,3,1.25
高质量三维模型,0,0,1,0,0,0,0,1,0.125
沉浸式体验,0,0,1,0,0,0,0,1,0.125
游戏,0,0,1,1,0,1,0,3,0.4916666666666667
我的,0,0,1,0,0,0,0,1,0.125
移动端ar游戏,0,0,1,0,0,0,0,1,0.125
交互功能,0,0,1,0,0,0,0,1,0.125
终端,0,0,1,0,0,0,0,1,0.125
二维场景,0,0,1,0,0,0,0,1,0.125
媒体承载,0,0,1,0,0,0,0,1,0.125
网络游戏,1,0,1,0,0,0,0,2,1.125
在线家装,1,0,1,0,0,0,0,2,1.125
虚拟看房,1,0,1,0,0,0,0,2,1.125
电商,1,0,1,0,0,0,0,2,1.125
vr/ar技术,0,0,2,0,0,0,1,3,0.4916666666666667
虚拟世界,0,0,1,0,0,0,0,1,0.125
感官感受,0,0,1,0,0,0,0,1,0.125
触觉,0,0,1,0,0,0,0,1,0.125
听觉,0,0,1,0,0,0,0,1,0.125
人机交互界面,0,0,1,0,0,0,0,1,0.125
三维虚拟世界,0,0,1,0,0,0,0,1,0.125
计算机图形渲染能,0,0,1,0,0,0,0,1,0.125
传感器技术,0,0,1,0,0,0,0,1,0.125
显示技术,0,0,1,0,0,0,0,1,0.125
计算机仿真技术,0,0,1,0,0,0,0,1,0.125
计算机图形技术,0,0,1,0,0,0,0,1,0.125
计算平台,0,0,1,0,0,0,0,1,0.125
互联网,0,0,1,0,0,0,0,1,0.125
虚拟现实技术,0,0,1,0,0,0,0,1,0.125
技术,0,0,1,0,0,0,0,1,0.125
ar,0,0,1,0,0,0,0,1,0.125
augmentedreality,1,0,1,0,0,0,0,2,1.125
增强现实,1,0,1,0,0,0,0,2,1.125
virtualreality,1,0,1,0,0,0,0,2,1.125
计算机科学技术,1,0,1,0,0,0,0,2,1.125
处理速度,0,0,0,1,0,0,0,1,0.125
图形处理效率,0,0,0,1,0,0,0,1,0.125
c/s框架,0,0,0,2,0,0,0,2,0.25
模型信息,0,0,0,3,0,0,0,3,0.375
场景信息,0,0,0,2,0,0,0,2,0.25
传输优先级,0,0,0,4,1,0,0,5,0.7416666666666667
实验环境,0,0,0,1,0,0,1,2,0.3666666666666667
p2p网络,0,0,0,1,0,0,0,1,0.125
server,0,0,0,1,0,0,0,1,0.125
p2p网络框架,0,0,0,1,0,0,0,1,0.125
网络框架,0,0,0,1,0,0,0,1,0.125
模型优先级,0,0,0,1,0,0,0,1,0.125
分辨压缩,0,0,0,1,0,0,0,1,0.125
传输过程,0,0,0,2,0,1,0,3,0.4916666666666667
渐进式,0,0,0,1,0,0,0,1,0.125
视觉贡献,0,0,0,1,0,0,0,1,0.125
空间特征,0,0,0,1,0,0,0,1,0.125
光照,0,0,0,1,0,0,0,1,0.125
音频,0,0,0,1,0,0,0,1,0.125
quadricerrormetrics,0,0,0,1,0,0,0,1,0.125
二次误差度量,0,0,0,1,0,0,0,1,0.125
传输对,0,0,0,1,0,0,0,1,0.125
多分辨率网格模型,0,0,1,1,0,1,0,3,0.4916666666666667
三维场景传输,0,0,0,1,0,0,0,1,0.125
多分辨率模型,0,0,0,1,0,0,0,1,0.125
方向向量,0,0,0,0,6,0,0,6,1.45
模型传输顺,0,0,0,0,1,0,0,1,0.24166666666666667
显著性信息,1,0,1,0,1,0,1,4,1.6083333333333334
视觉感知程度,0,0,0,0,1,0,0,1,0.24166666666666667
夹角,0,0,0,0,2,0,0,2,0.48333333333333334
点积公,0,0,0,0,1,0,0,1,0.24166666666666667
向量,0,0,0,0,3,0,0,3,0.725
pm-pc,0,0,0,0,1,0,0,1,0.24166666666666667
模型坐标,0,0,0,0,1,0,0,1,0.24166666666666667
笛卡尔坐标,0,0,0,0,1,0,0,1,0.24166666666666667
仰角坐标,0,0,0,0,1,0,0,1,0.24166666666666667
降序,0,0,0,0,1,0,0,1,0.24166666666666667
az,0,0,0,0,1,0,0,1,0.24166666666666667
描述变量,0,0,0,0,1,0,0,1,0.24166666666666667
mpd,0,0,0,0,1,0,0,1,0.24166666666666667
模型描述文件,0,0,0,0,1,0,0,1,0.24166666666666667
仿真场景,0,0,0,0,1,0,0,1,0.24166666666666667
vr/ar,0,0,5,0,0,0,0,5,0.625
流媒体,0,0,3,0,0,0,0,3,0.375
带宽,1,0,5,1,0,1,2,10,2.475
5g技术,0,0,2,0,0,0,0,2,0.25
三维场景数据,0,0,1,0,0,0,0,1,0.125
实时传输,0,0,1,0,0,0,0,1,0.125
实时下载,0,0,1,0,0,0,0,1,0.125
杀手级应用,0,0,1,0,0,0,0,1,0.125
低时延,0,0,1,0,0,0,0,1,0.125
ar头显产,0,0,1,0,0,0,0,1,0.125
眼镜,0,0,1,0,0,0,0,1,0.125
pl,0,0,1,0,0,0,0,1,0.125
ar眼镜,0,0,1,0,0,0,0,1,0.125
magicleap,0,0,1,0,0,0,0,1,0.125
hololens,0,0,1,0,0,0,0,1,0.125
vr头显,0,0,1,0,0,0,0,1,0.125
vr/ar头显设备,0,0,1,0,0,0,0,1,0.125
内容创作平台,0,0,1,0,0,0,0,1,0.125
虚拟现实拍摄设备,0,0,1,0,0,0,0,1,0.125
头戴式显示设备,0,0,1,0,0,0,0,1,0.125
媒体,0,0,1,0,0,1,0,2,0.3666666666666667
5g时代,0,0,1,0,0,0,0,1,0.125
媒体文件,0,0,1,0,0,0,0,1,0.125
移动通信技术,0,0,1,0,0,0,0,1,0.125
宽带互联网,0,0,1,0,0,0,0,1,0.125
窄带互联网,0,0,1,0,0,0,0,1,0.125
音视频内容,0,0,1,0,0,0,0,1,0.125
流媒体技术,0,0,1,0,0,0,0,1,0.125
音频文件,0,0,2,0,0,0,0,2,0.25
渐进式压缩编码,0,0,0,0,1,0,2,3,0.725
模型失真评估算法,2,0,3,0,0,0,2,7,2.8583333333333334
视觉特征,1,0,2,0,0,0,2,5,1.7333333333333334
观看质量,0,0,0,0,0,0,1,1,0.24166666666666667
meshlab,0,0,0,0,0,0,1,1,0.24166666666666667
webgl,0,0,0,0,0,0,1,1,0.24166666666666667
浏览器,0,0,0,0,0,1,1,2,0.48333333333333334
node.js,0,0,0,0,0,1,1,2,0.48333333333333334
渐进式传输框架,0,0,0,0,0,0,1,1,0.24166666666666667
模型失真评估,1,0,0,0,0,0,1,2,1.2416666666666667
匹配结果,0,0,0,0,0,0,1,1,0.24166666666666667
压缩编码标准,0,0,0,0,1,0,1,2,0.48333333333333334
视觉画面质量,1,0,1,0,0,0,1,3,1.3666666666666667
体验场景,0,0,1,0,0,0,1,2,0.3666666666666667
偏转角度,0,0,0,4,0,0,1,5,0.7416666666666667
视线中,0,0,0,0,0,0,1,1,0.24166666666666667
失真评估算法,1,0,1,0,0,0,1,3,1.3666666666666667
视觉体验质量,0,0,0,0,0,0,1,1,0.24166666666666667
数学建模,0,0,1,0,0,0,1,2,0.3666666666666667
用户行为,0,0,1,0,0,0,1,2,0.3666666666666667
最优分辨率计算算法,0,0,1,0,0,0,1,2,0.3666666666666667
兴趣管理算法,0,0,1,0,0,0,1,2,0.3666666666666667
有限带宽,0,0,0,0,0,0,1,1,0.24166666666666667
海量数据,0,0,0,0,0,0,1,1,0.24166666666666667
加载,0,0,0,0,0,0,1,1,0.24166666666666667
快速传输,0,0,0,0,0,0,1,1,0.24166666666666667
多媒体,0,0,0,0,0,0,1,1,0.24166666666666667
三维多媒体,0,0,0,0,0,0,1,1,0.24166666666666667
移动端硬件,0,0,0,0,0,0,1,1,0.24166666666666667
数据预处理模块,0,0,0,0,0,2,0,2,0.48333333333333334
基网格传输,0,0,0,0,0,1,0,1,0.24166666666666667
错误保护编码,0,0,0,0,0,1,0,1,0.24166666666666667
内容数据量,0,0,0,0,0,1,0,1,0.24166666666666667
状态,0,0,0,0,0,1,0,1,0.24166666666666667
数据库,0,0,0,0,0,3,0,3,0.725
兴趣,0,0,0,1,0,1,0,2,0.3666666666666667
降采样,0,0,2,0,1,0,0,3,0.4916666666666667
传输带宽,1,0,2,0,0,0,0,3,1.25
数学模型,0,0,1,0,0,0,0,1,0.125
图片,0,0,1,0,0,0,0,1,0.125
失真评估,0,0,1,0,0,0,0,1,0.125
降采样系统,0,0,1,0,0,0,0,1,0.125
中心偏转角度,1,0,1,0,0,0,0,2,1.125
实时,0,0,1,0,0,0,0,1,0.125
总采样像素数,0,0,1,0,1,0,0,2,0.3666666666666667
简化信息,0,0,1,0,1,0,0,2,0.3666666666666667
场景更新策略,0,0,1,0,0,0,0,1,0.125
失真估计算法,0,0,1,0,0,0,0,1,0.125
骨骼动画,0,0,1,0,0,0,0,1,0.125
坐标轴,0,0,0,0,2,0,0,2,0.48333333333333334
屏幕投影,0,0,0,0,2,0,0,2,0.48333333333333334
虚拟空间,0,0,0,0,2,0,0,2,0.48333333333333334
世界坐标,0,0,0,0,2,0,0,2,0.48333333333333334
预处理器,0,0,0,0,2,0,0,2,0.48333333333333334
平面二维坐标,0,0,0,0,1,0,0,1,0.24166666666666667
列数,0,0,0,0,1,0,0,1,0.24166666666666667
行数,0,0,0,0,1,0,0,1,0.24166666666666667
v轴,0,0,0,0,1,0,0,1,0.24166666666666667
u轴,0,0,0,0,1,0,0,1,0.24166666666666667
二维图像,0,0,0,0,1,0,0,1,0.24166666666666667
图像坐标系,0,0,0,0,1,0,0,1,0.24166666666666667
相机光轴,0,0,0,0,1,0,0,1,0.24166666666666667
zc轴,0,0,0,0,1,0,0,1,0.24166666666666667
xc轴,0,0,0,0,1,0,0,1,0.24166666666666667
相机透镜,0,0,0,0,1,0,0,1,0.24166666666666667
虚拟相机,0,0,0,0,1,0,0,1,0.24166666666666667
物体坐标,0,0,0,0,1,0,0,1,0.24166666666666667
空间剪裁,0,0,0,0,1,0,0,1,0.24166666666666667
透视变换,0,0,0,0,1,0,0,1,0.24166666666666667
背面消除,0,0,0,0,4,0,0,4,0.9666666666666667
局部坐标,0,0,0,0,1,0,0,1,0.24166666666666667
模型空间坐标系,0,0,0,0,1,0,0,1,0.24166666666666667
局部坐标系,0,0,0,0,1,0,0,1,0.24166666666666667
坐标变换,0,0,0,0,1,0,0,1,0.24166666666666667
3d渲染管线,0,0,0,0,1,0,0,1,0.24166666666666667
几何变换,0,0,0,0,1,0,0,1,0.24166666666666667
纹理映射,0,0,0,1,1,0,0,2,0.3666666666666667
着色处理,0,0,0,0,1,0,0,1,0.24166666666666667
光照计算,0,0,0,1,1,0,0,2,0.3666666666666667
渲染过程,0,0,0,0,1,0,0,1,0.24166666666666667
编程,0,0,0,0,1,0,0,1,0.24166666666666667
片元着色器,0,0,0,0,1,0,0,1,0.24166666666666667
顶点着色器,0,0,0,0,1,0,0,1,0.24166666666666667
光栅阶段,0,0,0,0,1,0,0,1,0.24166666666666667
几何,0,0,0,0,1,0,0,1,0.24166666666666667
显示器,0,0,0,0,1,0,0,1,0.24166666666666667
拾取,0,0,0,0,1,0,0,1,0.24166666666666667
兴趣区域算法,0,0,0,0,1,0,0,1,0.24166666666666667
场景描述,0,0,0,0,1,0,0,1,0.24166666666666667
预处理器算法,0,0,0,0,1,0,0,1,0.24166666666666667
观察向量,0,0,0,0,2,0,0,2,0.48333333333333334
面法线,0,0,0,0,2,0,0,2,0.48333333333333334
不可见区域,0,0,0,0,2,0,0,2,0.48333333333333334
计算资源,0,0,0,0,2,0,0,2,0.48333333333333334
图形处理,0,0,0,0,1,0,0,1,0.24166666666666667
信息冗余,0,0,0,0,2,0,0,2,0.48333333333333334
多边形,0,0,0,0,1,0,0,1,0.24166666666666667
可视平面,0,0,0,0,1,0,0,1,0.24166666666666667
点乘,0,0,0,0,1,0,0,1,0.24166666666666667
视点向量,0,0,0,0,1,0,0,1,0.24166666666666667
surfacenomial,0,0,0,0,1,0,0,1,0.24166666666666667
叉乘运算,0,0,0,0,1,0,0,1,0.24166666666666667
顺时针,0,0,0,0,1,0,0,1,0.24166666666666667
绕向,0,0,0,0,1,0,0,1,0.24166666666666667
三角面法向量,0,0,0,0,1,0,0,1,0.24166666666666667
视线向量,0,0,0,0,1,0,0,1,0.24166666666666667
法向量,0,0,0,0,1,0,0,1,0.24166666666666667
叉乘,0,0,0,0,1,0,0,1,0.24166666666666667
背面消除算法,0,0,0,0,1,0,0,1,0.24166666666666667
运算效率,0,0,0,0,1,0,0,1,0.24166666666666667
相机视点,0,0,0,0,1,0,0,1,0.24166666666666667
背向视点,0,0,0,0,1,0,0,1,0.24166666666666667
可见区域,0,0,0,0,1,0,0,1,0.24166666666666667
模型区域,0,0,0,0,1,0,0,1,0.24166666666666667
用户视角,0,0,0,0,1,0,0,1,0.24166666666666667
3d场景,0,0,0,0,1,0,0,1,0.24166666666666667
背面,0,0,0,0,1,0,0,1,0.24166666666666667
反射面,0,0,0,1,0,0,0,1,0.125
面结构,0,0,0,1,0,0,0,1,0.125
辅助信息,0,0,0,1,0,2,0,3,0.6083333333333334
高保真建模,0,0,0,1,0,0,0,1,0.125
物体信息,0,0,0,1,0,0,0,1,0.125
渐进式加载过程,0,0,0,1,0,0,0,1,0.125
仿真结,0,0,0,0,0,1,0,1,0.24166666666666667
仿真实,0,0,0,0,0,1,0,1,0.24166666666666667
传输系统,0,0,0,0,0,1,0,1,0.24166666666666667
系统,0,0,0,0,0,1,0,1,0.24166666666666667
扇形区域,0,0,0,11,0,0,0,11,1.375
传输内容,0,0,0,4,0,0,0,4,0.5
圆形区域,0,0,0,3,0,0,0,3,0.375
圆形兴趣区域,0,0,0,2,0,0,0,2,0.25
组合区域,0,0,0,2,0,0,0,2,0.25
欧式距离,0,0,0,2,0,0,0,2,0.25
组合兴趣区域,0,0,0,1,0,0,0,1,0.125
扇形兴趣区域,0,0,0,1,0,0,0,1,0.125
相关性,0,0,0,1,0,0,0,1,0.125
相关度,0,0,0,1,0,0,0,1,0.125
a3算法,0,0,0,1,0,0,0,1,0.125
视觉内容断层,0,0,0,1,0,0,0,1,0.125
临近,0,0,0,1,0,0,0,1,0.125
用户体验,0,0,0,1,0,0,0,1,0.125
视觉断层现象,0,0,0,1,0,0,0,1,0.125
客户端内容,0,0,0,1,0,0,0,1,0.125
扇形角度,0,0,0,1,0,0,0,1,0.125
相机内参,1,0,0,1,0,0,0,2,1.125
客户端渲染管线,0,0,0,1,0,0,0,1,0.125
fov限制,0,0,0,1,0,0,0,1,0.125
非相关区域,0,0,0,1,0,0,0,1,0.125
可视半径,0,0,0,1,0,0,0,1,0.125
虚拟环境,0,0,0,1,0,0,0,1,0.125
平移操作,0,0,0,1,0,0,0,1,0.125
旋转操,0,0,0,1,0,0,0,1,0.125
平移,0,0,0,2,0,0,0,2,0.25
旋转,0,0,0,2,0,2,0,4,0.7333333333333334
oi,0,0,0,1,0,0,0,1,0.125
y轴,0,0,0,1,0,0,0,1,0.125
圆形,0,0,0,1,0,0,0,1,0.125
场景更新,0,0,0,1,0,0,0,1,0.125
数据传输,0,0,0,1,0,0,0,1,0.125
视频流媒体,0,0,0,1,0,0,0,1,0.125
渐进式传输过程,0,0,0,1,0,0,0,1,0.125
psnr,0,0,0,0,0,3,0,3,0.725
3号模型,0,0,0,0,0,2,0,2,0.48333333333333334
仿真,1,0,0,0,0,2,0,3,1.4833333333333334
三角面数,0,0,0,0,0,2,0,2,0.48333333333333334
web网页,0,0,0,0,0,2,0,2,0.48333333333333334
场景内模型,0,0,0,0,0,2,0,2,0.48333333333333334
视觉质量评价,0,0,0,0,0,1,0,1,0.24166666666666667
距离参数,0,0,0,0,0,1,0,1,0.24166666666666667
屏幕,0,0,0,0,1,1,0,2,0.48333333333333334
白色面积,0,0,0,0,0,1,0,1,0.24166666666666667
性信息,0,0,0,0,0,1,0,1,0.24166666666666667
观察视点,0,0,0,0,0,1,0,1,0.24166666666666667
旋转坐标,0,0,0,0,0,1,0,1,0.24166666666666667
下载时长,0,0,0,0,0,1,0,1,0.24166666666666667
距离相机,0,0,0,0,0,1,0,1,0.24166666666666667
细节失真程度,0,0,0,0,0,1,0,1,0.24166666666666667
更新算法,0,0,0,0,0,1,0,1,0.24166666666666667
画面视觉评价指,0,0,0,0,0,1,0,1,0.24166666666666667
全分辨率模型,0,0,0,0,0,1,0,1,0.24166666666666667
帧画面,0,0,0,0,0,1,0,1,0.24166666666666667
投影,0,0,0,0,0,1,0,1,0.24166666666666667
相机视场,0,0,0,0,0,1,0,1,0.24166666666666667
模型数量,0,0,0,0,0,1,0,1,0.24166666666666667
初始化数,0,0,0,0,0,1,0,1,0.24166666666666667
网络速率,0,0,0,0,0,1,0,1,0.24166666666666667
投影方,0,0,0,0,0,1,0,1,0.24166666666666667
远近剪裁平面,0,0,0,0,0,1,0,1,0.24166666666666667
场景初始化,0,0,0,0,0,1,0,1,0.24166666666666667
角色控制器,0,0,0,0,0,1,0,1,0.24166666666666667
用户视点,0,0,0,0,0,1,0,1,0.24166666666666667
网页,0,0,0,0,0,1,0,1,0.24166666666666667
初始化,0,0,0,0,0,1,0,1,0.24166666666666667
客户端场景,0,0,0,0,0,1,0,1,0.24166666666666667
modelsize,0,0,0,0,0,1,0,1,0.24166666666666667
rmadillo模型,0,0,0,0,0,1,0,1,0.24166666666666667
粗糙区域,0,0,0,0,0,1,0,1,0.24166666666666667
ill,0,0,0,0,0,1,0,1,0.24166666666666667
bunnydragon,0,0,0,0,0,1,0,1,0.24166666666666667
armadillo,0,0,0,0,0,1,0,1,0.24166666666666667
angek,0,0,0,0,0,1,0,1,0.24166666666666667
stanford模型数据库,0,0,0,0,0,1,0,1,0.24166666666666667
three.js,0,0,0,0,0,1,0,1,0.24166666666666667
多分辨率,0,0,0,0,0,1,0,1,0.24166666666666667
预处理,0,0,0,0,0,1,0,1,0.24166666666666667
客户端模型,0,0,0,0,0,1,0,1,0.24166666666666667
渐进,0,0,0,0,0,1,0,1,0.24166666666666667
webgl接口,0,0,0,0,0,1,0,1,0.24166666666666667
更新策略,0,0,0,0,0,1,0,1,0.24166666666666667
纹理块,0,0,0,0,3,0,0,3,0.725
降采样率,0,0,0,0,2,0,0,2,0.48333333333333334
失真度,0,0,0,0,2,0,0,2,0.48333333333333334
r-d,0,0,0,0,1,0,0,1,0.24166666666666667
比特率,0,0,0,0,1,0,0,1,0.24166666666666667
祐伽,0,0,0,0,1,0,0,1,0.24166666666666667
丫角囚伽,0,0,0,0,1,0,0,1,0.24166666666666667
带约束,0,0,0,0,1,0,0,1,0.24166666666666667
拉格朗日代价函数,0,0,0,0,1,0,0,1,0.24166666666666667
otalo,0,0,0,0,1,0,0,1,0.24166666666666667
ixigg,0,0,0,0,1,0,0,1,0.24166666666666667
总误差,0,0,0,0,1,0,0,1,0.24166666666666667
误差口,0,0,0,0,1,0,0,1,0.24166666666666667
比率,0,0,0,0,1,0,0,1,0.24166666666666667
外观误差,0,0,0,0,1,0,0,1,0.24166666666666667
简化模型,0,0,0,0,1,0,0,1,0.24166666666666667
权重系数,0,0,0,0,1,0,0,1,0.24166666666666667
误差计算,0,0,0,0,1,0,0,1,0.24166666666666667
mipmap链,0,0,0,0,3,0,0,3,0.725
屏幕屏变率,0,0,0,0,1,0,0,1,0.24166666666666667
图片区,0,0,0,0,1,0,0,1,0.24166666666666667
映射,0,0,0,0,1,0,0,1,0.24166666666666667
模型顶点,0,0,0,0,1,0,0,1,0.24166666666666667
有纹理映射,0,0,0,0,1,0,0,1,0.24166666666666667
简化纹理,0,0,0,0,1,0,0,1,0.24166666666666667
纹理压缩编码,0,0,0,0,1,0,0,1,0.24166666666666667
三维场景渐进式系统,0,0,0,0,1,0,0,1,0.24166666666666667
secondlife,0,0,0,0,1,0,0,1,0.24166666666666667
离线,0,0,0,0,3,0,0,3,0.725
mipmap,0,0,0,0,4,0,0,4,0.9666666666666667
存储成本,0,0,0,0,2,0,0,2,0.48333333333333334
时间成本,0,0,0,0,1,0,0,1,0.24166666666666667
空间成本,0,0,0,0,1,0,0,1,0.24166666666666667
绘制速度,0,0,0,0,1,0,0,1,0.24166666666666667
缓存效率,0,0,0,0,1,0,0,1,0.24166666666666667
mipmap技,0,0,0,0,1,0,0,1,0.24166666666666667
纹理对象,0,0,0,0,1,0,0,1,0.24166666666666667
3mipmap技术,0,0,0,0,1,0,0,1,0.24166666666666667
质量评价指标,0,0,0,0,1,0,0,1,0.24166666666666667
兴趣区域管理机制,0,0,0,0,1,0,0,1,0.24166666666666667
著性信息,0,0,0,0,1,0,0,1,0.24166666666666667
视点特征,0,0,0,0,1,0,0,1,0.24166666666666667
背面剔除,0,0,0,0,1,0,0,1,0.24166666666666667
数字建模,0,0,0,2,0,0,0,2,0.25
三维重建工,0,0,0,1,0,0,0,1,0.125
点信息,0,0,0,1,0,0,0,1,0.125
autodesk123d,0,0,0,1,0,0,0,1,0.125
realitycapture,0,0,0,1,0,0,0,1,0.125
多图建模软件,0,0,0,1,0,0,0,1,0.125
多角度图片,0,0,0,1,0,0,0,1,0.125
高清相机,0,0,0,1,0,0,0,1,0.125
数字信号,0,0,0,1,0,0,0,1,0.125
物体空间,0,0,0,1,0,0,0,1,0.125
结构光设备,0,0,0,1,0,0,0,1,0.125
激光扫描,0,0,0,1,0,0,0,1,0.125
深度相机,0,0,0,1,0,0,0,1,0.125
扫描工具,0,0,0,1,0,0,0,1,0.125
虚拟角色,0,0,0,1,0,0,0,1,0.125
影视,0,0,0,1,0,0,0,1,0.125
缩放,0,0,0,1,0,0,0,1,0.125
立方体,0,0,0,1,0,0,0,1,0.125
几何元素,0,0,0,1,0,0,0,1,0.125
3dsmax,0,0,0,1,0,0,0,1,0.125
maya,0,0,0,1,0,0,0,1,0.125
建模,0,0,0,1,0,0,0,1,0.125
三维软件,0,0,0,1,0,0,0,1,0.125
网格显著性,0,1,0,0,0,0,0,1,2.0
内容更新,1,0,0,0,0,0,0,1,1.0
视距参数,1,0,0,0,0,0,0,1,1.0
自适应,1,0,0,0,0,0,0,1,1.0
用户体验场景,1,0,0,0,0,0,0,1,1.0
纹理简化,1,0,0,0,0,0,0,1,1.0
匹配结,1,0,0,0,0,0,0,1,1.0
ar),1,0,0,0,0,0,0,1,1.0
3dvirtualenvironments,1,0,0,0,0,0,0,1,1.0
ar试穿,1,0,0,0,0,0,0,1,1.0
2d媒体,1,0,0,0,0,0,0,1,1.0
