,摘要,关键词,第一章,第二章,第三章,第四章,第五章,总词频,加权得分
权重更新,0,0,0,0,3,0,0,3,0.725
稀疏性,0,0,0,0,1,0,0,1,0.24166666666666667
权值,0,0,0,0,3,0,0,3,0.725
正则化参数,0,0,0,0,5,0,0,5,1.2083333333333333
学习速率,0,0,0,0,4,0,0,4,0.9666666666666667
动量参数,0,0,0,0,2,0,0,2,0.48333333333333334
加权平均值,0,0,0,0,1,0,0,1,0.24166666666666667
控制指数,0,0,0,0,1,0,0,1,0.24166666666666667
动量,0,0,0,0,2,0,0,2,0.48333333333333334
收敛速度,1,0,0,0,2,0,0,3,1.4833333333333334
权重,0,0,2,3,8,1,0,14,2.8
指数,0,0,0,0,3,0,0,3,0.725
梯度,1,0,4,1,18,0,2,26,6.458333333333333
动量梯度下降法,0,0,0,0,1,0,0,1,0.24166666666666667
梯度下降法,0,0,0,0,1,0,0,1,0.24166666666666667
混响室,0,0,7,22,0,0,0,29,3.625
混响室法,0,0,8,11,0,0,1,20,2.6166666666666667
被测设备,0,0,12,30,12,3,0,57,8.875
信道模拟器,3,0,7,19,10,3,0,42,9.391666666666666
基站模拟器,0,0,0,6,0,0,0,6,0.75
瑞利衰落信号,0,0,0,3,0,0,0,3,0.375
信号,0,0,6,21,1,1,0,29,3.8583333333333334
搅拌器,0,0,0,3,0,0,0,3,0.375
转台,0,0,0,3,0,0,0,3,0.375
信道参数,0,0,1,2,0,3,1,7,1.3416666666666668
测试,1,0,6,16,6,2,0,31,5.683333333333334
多普勒,0,0,1,4,1,0,0,6,0.8666666666666667
性能指标,0,0,2,2,0,0,0,4,0.5
mimo设备,1,0,4,10,0,0,0,15,2.75
电磁场,0,0,0,4,0,0,0,4,0.5
反射,0,0,0,5,1,0,0,6,0.8666666666666667
电磁场环境,0,0,0,3,0,0,0,3,0.375
到达角,0,0,1,5,2,1,0,9,1.475
交叉极化比,0,0,0,2,0,0,0,2,0.25
暗室多探头,0,0,2,1,0,0,0,3,0.375
mim001a,0,0,0,1,0,0,0,1,0.125
暗室,0,0,3,11,12,3,0,29,5.375
瑞利衰落信道,0,0,0,1,0,0,0,1,0.125
测试系统,0,0,4,6,6,0,2,18,3.1833333333333336
mimoota测试,0,0,5,11,0,2,2,20,2.966666666666667
混响室测试系统,0,0,1,1,0,0,0,2,0.25
参数,1,0,1,3,5,3,1,14,3.675
时延,0,0,1,6,1,2,0,10,1.6
电磁场结构,0,0,0,1,0,0,0,1,0.125
模式搅拌,0,0,0,1,0,0,0,1,0.125
天线,0,0,4,25,8,6,0,43,7.008333333333333
mimoota测试系统,0,0,0,2,0,0,0,2,0.25
吞吐率,0,0,0,2,1,0,0,3,0.4916666666666667
衰落信道,0,0,1,1,0,0,0,2,0.25
性能测试,0,0,3,4,0,0,1,8,1.1166666666666667
射频指标,0,0,3,1,0,0,0,4,0.5
tis,0,0,0,1,0,0,0,1,0.125
trp,0,0,0,1,0,0,0,1,0.125
定点扫描测试,0,0,0,1,0,0,0,1,0.125
均匀特性,0,0,0,1,0,0,0,1,0.125
射频测试,0,0,0,1,0,0,0,1,0.125
射频,0,0,2,1,0,0,0,3,0.375
腔体内壁,0,0,0,1,0,0,0,1,0.125
金属搅拌器,0,0,0,1,0,0,0,1,0.125
封闭金属腔体,0,0,0,1,0,0,0,1,0.125
反射环境,0,0,0,1,0,0,0,1,0.125
探头墙,0,0,0,0,18,0,0,18,4.35
探头,6,0,17,34,78,37,6,178,41.61666666666667
测试区,0,0,0,6,4,1,0,11,1.9583333333333333
角度,0,0,0,9,3,0,0,12,1.85
探头天线,0,0,2,0,9,3,0,14,3.15
更新步长,0,0,0,0,1,0,0,1,0.24166666666666667
更新间隔,0,0,0,0,1,0,0,1,0.24166666666666667
初始,0,0,0,0,1,0,0,1,0.24166666666666667
批量,0,0,0,0,2,0,0,2,0.48333333333333334
迭代次数,0,0,0,0,3,0,0,3,0.725
数值,0,0,0,1,1,0,0,2,0.3666666666666667
符号,0,0,0,0,1,0,0,1,0.24166666666666667
初始参数,0,0,0,0,1,3,0,4,0.9666666666666667
初始权重向量,0,0,0,0,1,0,0,1,0.24166666666666667
采样天线,0,0,0,0,1,0,0,1,0.24166666666666667
波长,0,0,0,1,3,1,0,5,1.0916666666666668
半径,0,0,0,2,2,0,0,4,0.7333333333333334
候选探头,0,0,0,0,3,0,0,3,0.725
探头间距,0,0,0,0,1,0,0,1,0.24166666666666667
间距,0,0,0,0,1,0,0,1,0.24166666666666667
仰角,0,0,0,0,1,0,0,1,0.24166666666666667
仿真配置,0,0,0,0,1,0,0,1,0.24166666666666667
大规模mimo设备,0,0,0,0,1,0,0,1,0.24166666666666667
硬件资源,0,0,0,1,1,0,0,2,0.3666666666666667
扇形探头墙,0,0,0,0,1,0,0,1,0.24166666666666667
dut,0,0,0,1,1,0,0,2,0.3666666666666667
mpacota测试系统,0,0,0,0,1,0,0,1,0.24166666666666667
二维探头环,0,0,0,0,1,0,0,1,0.24166666666666667
可视化,0,0,0,0,1,0,0,1,0.24166666666666667
测试区域,1,0,0,2,6,3,0,12,3.425
红点,0,0,0,0,1,0,0,1,0.24166666666666667
球面,0,0,0,0,2,0,0,2,0.48333333333333334
扇形mpac,0,0,0,0,1,0,0,1,0.24166666666666667
镜面反射特性,0,0,0,0,1,0,0,1,0.24166666666666667
毫米波信道,0,0,0,0,1,0,0,1,0.24166666666666667
移动通信系统,0,0,0,0,1,0,0,1,0.24166666666666667
仿真设,0,0,0,0,2,0,0,2,0.48333333333333334
开关电路,0,0,0,0,8,0,0,8,1.9333333333333333
功率放大器,0,0,0,2,5,0,0,7,1.4583333333333333
ota探头,0,0,0,8,5,2,0,15,2.6916666666666664
终端模拟器,0,0,0,0,4,0,0,4,0.9666666666666667
信道,2,0,7,23,14,37,2,85,18.558333333333334
损耗,0,0,0,0,3,0,0,3,0.725
massivemimo设备,0,0,1,6,5,0,0,12,2.083333333333333
功放,0,0,0,1,2,0,0,3,0.6083333333333334
远场,0,0,1,0,2,0,0,3,0.6083333333333334
衰落信号,0,0,0,0,2,0,0,2,0.48333333333333334
扇形结构,0,0,1,0,2,0,0,3,0.6083333333333334
信道环境,0,0,1,0,4,0,0,5,1.0916666666666668
massivemimoota测试系统,0,0,2,1,7,0,0,10,2.0666666666666664
assivemimoota测试系统,0,0,0,0,2,0,0,2,0.48333333333333334
信令控制,0,0,0,0,1,0,0,1,0.24166666666666667
接收,0,0,0,0,1,0,0,1,0.24166666666666667
发射,0,0,0,0,1,0,0,1,0.24166666666666667
模拟终端信号,0,0,0,0,1,0,0,1,0.24166666666666667
信道模拟器厂,0,0,0,0,1,0,0,1,0.24166666666666667
频带,0,0,0,0,1,0,0,1,0.24166666666666667
频点,0,0,0,0,1,0,0,1,0.24166666666666667
毫米波频段,0,0,3,5,2,0,0,10,1.4833333333333334
massivemimoota,0,0,3,1,1,0,1,6,0.9833333333333334
信道重构,3,1,6,0,2,10,2,24,9.133333333333333
端口资源,0,0,0,0,1,0,0,1,0.24166666666666667
端口数,0,0,0,0,1,0,0,1,0.24166666666666667
极化,0,0,0,7,1,0,0,8,1.1166666666666667
多径衰落环境,0,0,0,1,1,0,0,2,0.3666666666666667
线性区间,0,0,0,0,1,0,0,1,0.24166666666666667
自由传输损耗,0,0,0,0,1,0,0,1,0.24166666666666667
线性度,0,0,0,0,1,0,0,1,0.24166666666666667
尺寸,0,0,0,0,2,0,0,2,0.48333333333333334
隔离度,0,0,0,0,1,0,0,1,0.24166666666666667
插入损耗,0,0,0,0,1,0,0,1,0.24166666666666667
开关速度,0,0,0,0,1,0,0,1,0.24166666666666667
透镜式,0,0,0,0,1,0,0,1,0.24166666666666667
机械,0,0,0,0,1,0,0,1,0.24166666666666667
动态波束赋形,0,0,0,0,1,0,0,1,0.24166666666666667
连接,0,0,0,1,1,0,0,2,0.3666666666666667
资源,0,0,1,0,1,0,0,2,0.3666666666666667
控制信道模拟器,0,0,0,0,1,0,0,1,0.24166666666666667
信道模拟器端口,0,0,1,1,1,0,0,3,0.4916666666666667
全向,0,0,0,0,1,0,0,1,0.24166666666666667
增益,0,0,0,1,1,0,0,2,0.3666666666666667
贴片天线,0,0,0,0,1,0,0,1,0.24166666666666667
ota探头天线,0,0,0,0,2,0,0,2,0.48333333333333334
接收信号,0,0,0,0,1,0,0,1,0.24166666666666667
辐射信号,0,0,0,0,1,0,0,1,0.24166666666666667
探头间耦合,0,0,0,0,1,0,0,1,0.24166666666666667
步进式运动装置,0,0,0,0,1,0,0,1,0.24166666666666667
角度间隔,0,0,0,0,1,0,0,1,0.24166666666666667
系统,2,0,3,0,2,0,0,7,2.8583333333333334
暗室空间,0,0,0,1,1,0,0,2,0.3666666666666667
扇形,0,0,0,0,1,0,0,1,0.24166666666666667
来波,0,0,0,0,1,0,0,1,0.24166666666666667
子径,0,0,1,22,3,24,0,50,9.4
暗室尺寸,0,0,1,0,1,0,0,2,0.3666666666666667
内部信号,0,0,0,0,1,0,0,1,0.24166666666666667
干扰,0,0,0,0,1,0,0,1,0.24166666666666667
外部电磁波,0,0,0,0,1,0,0,1,0.24166666666666667
吸波材料,0,0,0,0,1,0,0,1,0.24166666666666667
误码率,0,0,0,1,1,0,0,2,0.3666666666666667
波束赋形,0,0,0,2,1,0,0,3,0.4916666666666667
组件,0,0,0,0,1,0,0,1,0.24166666666666667
通信过程,0,0,0,0,1,0,0,1,0.24166666666666667
下行链路,0,0,0,0,1,0,0,1,0.24166666666666667
通信,0,0,1,0,2,0,0,3,0.6083333333333334
上行链路,0,0,0,0,1,0,0,1,0.24166666666666667
自由空间,0,0,1,7,1,0,0,9,1.2416666666666667
链路,0,0,0,0,1,0,0,1,0.24166666666666667
动态控制测试,0,0,0,0,1,0,0,1,0.24166666666666667
动态波束赋形测试,0,0,0,0,2,0,0,2,0.48333333333333334
球形结构,0,0,0,0,1,0,0,1,0.24166666666666667
环状,0,0,0,0,1,0,0,1,0.24166666666666667
测设备,0,0,0,0,1,0,0,1,0.24166666666666667
基站面板,0,0,0,1,2,0,0,3,0.6083333333333334
多径信号,0,0,0,2,1,0,0,3,0.4916666666666667
无线电环境,0,0,0,0,1,0,0,1,0.24166666666666667
终端设备,0,0,0,2,2,0,0,4,0.7333333333333334
波束赋形能力,0,0,0,0,1,0,0,1,0.24166666666666667
4gmimoota测试,0,0,1,0,1,0,0,2,0.3666666666666667
mpac,0,0,1,9,3,2,0,15,2.458333333333333
5g,1,0,7,1,0,0,0,9,2.0
预衰落合成法,7,1,18,15,3,8,4,56,16.75
5g设备,3,0,8,2,2,0,0,15,4.733333333333333
目标信道,3,0,6,5,5,29,1,49,12.833333333333334
暗室多探头法,3,1,9,22,0,0,4,39,9.841666666666667
ota测试,0,0,6,5,1,8,1,21,3.7916666666666665
5g商用设备,0,0,3,0,0,0,0,3,0.375
5g技术,0,0,3,0,0,0,0,3,0.375
终端,0,0,3,4,0,0,0,7,0.875
5g毫米波,0,0,2,0,0,0,0,2,0.25
5gmimoota测试,0,0,3,0,0,0,0,3,0.375
空间相关性,1,0,7,13,1,23,1,46,9.541666666666668
5gmassivemimo设备,0,0,4,1,0,0,0,5,0.625
传导测试,0,0,3,0,1,0,0,4,0.6166666666666667
5g通信系统,0,0,2,0,0,0,0,2,0.25
5g商用产品,0,0,2,0,0,0,0,2,0.25
技术,0,0,2,0,0,0,0,2,0.25
芯片,0,0,3,4,0,0,0,7,0.875
imt-2020,0,0,2,0,0,0,0,2,0.25
业化,0,0,1,0,0,0,0,1,0.125
商用设备,0,0,1,0,0,0,0,1,0.125
产学研,0,0,1,0,0,0,0,1,0.125
性能,0,0,4,3,3,2,0,12,2.083333333333333
5gota测试实验,0,0,1,0,0,0,0,1,0.125
5g基站,0,0,2,0,0,0,0,2,0.25
5g毫米波产业,0,0,1,0,0,0,0,1,0.125
芯片测试,0,0,1,0,0,0,0,1,0.125
5g毫米波基站,0,0,1,0,0,0,0,1,0.125
终端厂,0,0,1,0,0,0,0,1,0.125
基站,0,0,1,12,1,0,0,14,1.8666666666666667
高通,0,0,1,0,0,0,0,1,0.125
中兴,0,0,1,0,1,0,0,2,0.3666666666666667
华为,0,0,1,0,0,0,0,1,0.125
玉衡系统,0,0,1,0,0,0,0,1,0.125
性能测试平台,0,0,1,0,0,0,0,1,0.125
ota端到端,0,0,1,0,0,0,0,1,0.125
信息通信,0,0,1,0,0,0,0,1,0.125
ota商用测试系统,0,0,1,0,0,0,0,1,0.125
电子科技大,0,0,1,0,0,0,0,1,0.125
邮电大学,0,0,1,0,0,0,0,1,0.125
mimiota测试系统,0,0,1,0,0,0,0,1,0.125
信道重构理论,0,0,2,0,0,1,0,3,0.4916666666666667
效率,2,0,3,0,2,0,0,7,2.8583333333333334
空间特性,1,0,1,1,0,2,0,5,1.7333333333333334
相位校准,0,0,1,4,0,1,1,7,1.1083333333333334
平面波合成法,0,0,3,10,1,0,1,15,2.1083333333333334
电磁传播环境,0,0,2,0,0,0,0,2,0.25
reverberation,0,0,1,0,0,0,0,1,0.125
ac,0,0,1,0,0,0,0,1,0.125
oiccham,0,0,1,0,0,0,0,1,0.125
multi-probeane,0,0,1,0,0,0,0,1,0.125
5g设备测试,0,0,1,0,0,0,0,1,0.125
波束赋形设备,0,0,1,2,0,0,0,3,0.375
设备,0,0,5,4,0,0,0,9,1.125
接线操作,0,0,2,0,0,0,0,2,0.25
空间辐射,0,0,1,0,0,0,0,1,0.125
暗室环境,0,0,1,0,0,0,0,1,0.125
ta,0,0,1,0,0,0,0,1,0.125
air,0,0,1,0,0,0,0,1,0.125
the,0,0,1,0,0,0,0,1,0.125
空中接口,0,0,1,0,0,0,0,1,0.125
测试技,0,0,1,0,0,0,0,1,0.125
4g设备,0,0,1,0,0,0,0,1,0.125
测试接口,0,0,1,0,0,0,0,1,0.125
under-test,0,0,1,0,0,0,0,1,0.125
device,0,0,1,0,0,0,0,1,0.125
体化,0,0,1,0,0,0,0,1,0.125
天线射频,0,0,1,0,0,0,0,1,0.125
带宽,0,0,2,0,0,0,0,2,0.25
频段,0,0,3,1,1,0,0,5,0.7416666666666667
毫米波技术,0,0,1,0,0,0,0,1,0.125
线路连接,0,0,1,0,0,0,0,1,0.125
线缆连接,0,0,1,0,0,0,0,1,0.125
mimo阵列,0,0,1,0,0,0,0,1,0.125
频谱效率,0,0,1,0,0,0,1,2,0.3666666666666667
通信速率,0,0,1,0,0,0,0,1,0.125
通信系统,0,0,1,1,0,0,0,2,0.25
高频段毫米波技术,0,0,1,0,0,0,0,1,0.125
massivemimo,0,0,1,1,0,0,0,2,0.25
multiple,1,0,1,0,0,0,0,2,1.125
massivemultipleinput,0,0,1,0,0,0,0,1,0.125
多入多出,1,0,1,0,0,0,0,2,1.125
通信性能,0,0,1,0,0,0,0,1,0.125
商用产品,0,0,1,0,0,0,0,1,0.125
5g产品测试,0,0,1,0,0,0,0,1,0.125
预商用测试,0,0,1,0,0,0,0,1,0.125
3gpp,0,0,3,1,1,4,0,9,1.7083333333333333
5g产品,0,0,1,0,0,0,0,1,0.125
5g试验,0,0,1,0,0,0,0,1,0.125
试验,0,0,1,0,0,0,0,1,0.125
产业,0,0,1,0,0,0,0,1,0.125
标准,0,0,1,0,0,0,0,1,0.125
产品研发,0,0,1,0,0,0,0,1,0.125
产业链,0,0,1,0,0,0,0,1,0.125
研发设备,0,0,1,0,0,0,0,1,0.125
高校,0,0,1,0,0,0,0,1,0.125
研究院所,0,0,1,0,0,0,0,1,0.125
仪表,0,0,1,0,0,0,0,1,0.125
运营商,0,0,1,0,0,0,0,1,0.125
推进组,0,0,1,0,0,0,0,1,0.125
工业和信息化,0,0,1,0,0,0,0,1,0.125
社会,0,0,1,0,0,0,0,1,0.125
信息通信技术,0,0,1,0,0,0,0,1,0.125
同步,0,0,1,0,0,0,0,1,0.125
4g,0,0,1,0,0,0,0,1,0.125
3g,0,0,1,0,0,0,0,1,0.125
通信产业,0,0,1,0,0,0,0,1,0.125
误差,1,0,3,1,8,4,1,18,4.641666666666667
仿真,1,0,3,1,8,6,1,20,5.125
探头选择算法,2,0,3,1,0,0,0,6,2.5
复杂度,1,0,3,2,15,0,1,22,5.491666666666667
备选探头,1,0,2,0,5,0,1,9,2.7
空间相关性复现精度,0,0,1,0,0,0,0,1,0.125
标准mimo信道,0,0,1,0,0,0,0,1,0.125
多簇信道,0,0,1,0,2,2,1,6,1.3333333333333333
初始相位向量,0,0,1,0,0,1,0,2,0.3666666666666667
列向量,1,0,1,0,0,9,1,12,3.5416666666666665
矩阵,1,0,1,0,0,5,0,7,2.333333333333333
正交性,1,0,1,0,0,1,1,4,1.6083333333333334
离散傅里叶变换矩阵,2,0,1,0,0,0,0,3,2.125
信道建模,0,0,4,7,0,3,0,14,2.1
信道模型,2,0,4,11,1,3,2,23,5.325
相位,1,0,2,2,0,3,0,8,2.225
空时联合,0,0,1,0,0,3,1,5,1.0916666666666668
ota信道模型,0,0,1,0,0,0,0,1,0.125
子径信息,0,0,1,0,0,0,0,1,0.125
合成信道模型,0,0,1,0,0,0,0,1,0.125
数学实验仿真,0,0,1,0,0,0,0,1,0.125
凸优化算法,1,0,1,0,1,0,0,3,1.3666666666666667
非零功率,0,0,1,0,1,0,0,2,0.3666666666666667
正则化函数,1,0,1,0,3,0,1,6,2.091666666666667
杂度,0,0,1,0,2,0,0,3,0.6083333333333334
批次迭代策,0,0,1,0,1,0,0,2,0.3666666666666667
动量梯度,1,0,1,0,1,0,0,3,1.3666666666666667
速率,0,0,1,0,2,0,0,3,0.6083333333333334
迭代,0,0,1,1,7,0,0,9,1.9416666666666667
探头权重,1,0,1,3,1,1,2,9,2.466666666666667
权重向量,0,0,1,0,8,0,0,9,2.0583333333333336
目标函数,1,0,1,0,3,0,1,6,2.091666666666667
备选探头集,0,0,1,0,0,0,0,1,0.125
信道复杂度,0,0,1,0,0,0,0,1,0.125
测试精度,0,0,1,0,0,0,0,1,0.125
扇形探头墙结构,0,0,1,0,0,0,0,1,0.125
环形结构,0,0,1,0,0,0,0,1,0.125
4gota测,0,0,1,0,0,0,0,1,0.125
massivemimoota测试,0,0,2,2,0,0,0,4,0.5
内部信道重构,0,0,1,0,0,0,0,1,0.125
暗室多探头系统,0,0,1,0,0,0,0,1,0.125
设备测试系统,0,0,1,0,0,0,0,1,0.125
5gmim0,0,0,1,0,0,0,0,1,0.125
siso设备,0,0,0,2,0,0,0,2,0.25
两步法,0,0,1,2,0,0,1,4,0.6166666666666667
mimoota,0,0,1,2,1,1,1,6,1.1
指标数据,0,0,0,1,0,0,0,1,0.125
无线电衰落信道环境,0,0,0,1,0,0,0,1,0.125
整机性能,0,0,0,1,0,0,0,1,0.125
totalradiatedsensitivity,0,0,0,1,0,0,0,1,0.125
总辐射灵敏度,0,0,0,1,0,0,0,1,0.125
totalradiatedpower,0,0,0,1,0,0,0,1,0.125
总辐射功率,0,0,0,1,0,0,0,1,0.125
imoota测试,0,0,0,1,0,0,0,1,0.125
multi-shot算法,0,0,1,2,18,0,1,22,4.966666666666667
one-shot算法,0,0,0,0,2,0,0,2,0.48333333333333334
基站设备,0,0,1,1,2,0,0,4,0.7333333333333334
massivemimo技术,0,0,0,0,2,0,0,2,0.48333333333333334
5gmimo设备,0,0,0,0,1,0,0,1,0.24166666666666667
信道重构效率,1,0,0,0,2,0,0,3,1.4833333333333334
算法,1,0,1,1,9,0,0,12,3.425
动态参数,0,0,0,0,1,0,0,1,0.24166666666666667
目标探头,0,0,0,0,3,0,0,3,0.725
高频段,0,0,0,0,1,0,0,1,0.24166666666666667
垂直区域,0,0,0,0,1,0,0,1,0.24166666666666667
水平区域,0,0,0,0,1,0,0,1,0.24166666666666667
ota,0,0,0,2,1,0,0,3,0.4916666666666667
大规模天线,0,0,0,0,1,0,2,3,0.725
探头布置结构,0,0,0,0,1,0,0,1,0.24166666666666667
4glteota测试系统,0,0,0,0,1,0,0,1,0.24166666666666667
定向接受信号,0,0,0,0,1,0,0,1,0.24166666666666667
仿真精度,0,0,0,0,4,0,0,4,0.9666666666666667
凸优化,0,0,0,2,2,0,0,4,0.7333333333333334
除算法,0,0,0,0,1,0,0,1,0.24166666666666667
连续探头,0,0,0,0,1,0,0,1,0.24166666666666667
功率权重,0,0,0,0,3,0,0,3,0.725
候选天线,0,0,0,0,1,0,0,1,0.24166666666666667
中暴力算法,0,0,0,0,1,0,0,1,0.24166666666666667
凸优化框架,0,0,0,0,1,0,0,1,0.24166666666666667
连续探头消除算法,0,0,0,0,1,0,0,1,0.24166666666666667
暴力算法,0,0,0,0,2,0,0,2,0.48333333333333334
合成信道,0,0,0,0,1,18,0,19,4.591666666666667
探头数量,0,0,0,2,1,2,0,5,0.975
输出端口,0,0,0,0,1,0,0,1,0.24166666666666667
功率系数,0,0,0,0,1,0,0,1,0.24166666666666667
mpac装置,0,0,0,0,1,0,0,1,0.24166666666666667
5gmassivemimoota,0,0,0,1,1,0,0,2,0.3666666666666667
多探头暗室,0,0,0,0,1,0,0,1,0.24166666666666667
空口辐射,0,0,2,1,1,0,0,4,0.6166666666666667
射频导线,0,0,1,2,1,0,0,4,0.6166666666666667
射频器件,0,0,0,1,1,0,0,2,0.3666666666666667
5gmassivemimo基站设备,0,0,0,0,1,0,0,1,0.24166666666666667
hz,0,0,0,3,1,0,0,4,0.6166666666666667
标准化,0,0,0,0,1,0,0,1,0.24166666666666667
数据传输速率,0,0,0,0,1,0,0,1,0.24166666666666667
系统容量,0,0,0,0,1,0,0,1,0.24166666666666667
链路速率,0,0,0,0,1,0,1,2,0.48333333333333334
天线阵列,0,0,0,1,1,0,0,2,0.3666666666666667
发送端,0,0,0,3,1,0,0,4,0.6166666666666667
接收端,0,0,0,4,1,2,0,7,1.225
sps,0,0,0,0,10,0,0,10,2.4166666666666665
鲁棒性,0,0,1,0,2,0,1,4,0.85
multi-shot,0,0,0,0,3,0,0,3,0.725
cdl-c,0,0,0,0,1,1,0,2,0.48333333333333334
cdl,0,0,0,0,1,2,0,3,0.725
cdl-,0,0,0,0,1,2,0,3,0.725
单簇信道,0,0,0,0,1,0,0,1,0.24166666666666667
cdl信道模型,0,0,0,0,1,0,0,1,0.24166666666666667
非视距场,0,0,0,0,1,0,0,1,0.24166666666666667
扩展,0,0,0,0,1,0,0,1,0.24166666666666667
拟合误差,0,0,0,0,1,0,0,1,0.24166666666666667
精度,1,0,0,0,2,0,0,3,1.4833333333333334
rmsd,0,0,0,0,6,0,0,6,1.45
目标探头数,0,0,0,0,1,0,0,1,0.24166666666666667
斯分布,0,0,0,0,1,0,0,1,0.24166666666666667
拉普拉,0,0,0,0,1,0,0,1,0.24166666666666667
簇内子径,0,0,0,2,2,0,0,4,0.7333333333333334
单簇信道模型,0,0,0,0,1,0,0,1,0.24166666666666667
角度参数,0,0,0,0,1,0,0,1,0.24166666666666667
单簇环,0,0,0,0,3,0,0,3,0.725
仿真实验,0,0,0,0,2,3,1,6,1.45
功率角度谱,0,0,1,9,0,1,0,11,1.4916666666666667
虚拟天线,0,0,0,6,9,0,0,15,2.925
拉普拉斯分布,0,0,0,6,1,0,0,7,0.9916666666666667
pas,0,0,0,4,2,1,0,7,1.225
相关性,0,0,0,3,4,8,2,17,3.7583333333333333
权重系数,0,0,0,4,0,1,0,5,0.7416666666666667
拟合空间,0,0,0,3,6,1,0,10,2.0666666666666664
采样,0,0,0,3,3,0,0,6,1.1
目标空间,0,0,0,2,5,1,0,8,1.7
空间,0,0,0,4,3,7,0,14,2.9166666666666665
傅里叶变换,0,0,0,2,0,2,0,4,0.7333333333333334
功率,0,0,0,4,3,4,0,11,2.1916666666666664
稀疏特性,0,0,1,2,0,0,0,3,0.375
相位信息,0,0,0,2,0,0,0,2,0.25
实数,0,0,0,1,0,0,0,1,0.125
空间相关性拟合,0,0,0,1,0,0,0,1,0.125
目标曲线,0,0,0,1,0,0,0,1,0.125
现象,0,0,0,1,0,0,0,1,0.125
flyback,0,0,0,1,0,0,0,1,0.125
天线间距,0,0,0,1,0,1,0,2,0.3666666666666667
ge,0,0,0,1,0,0,0,1,0.125
空间相关,1,0,0,1,0,2,0,4,1.6083333333333334
角度矢量,0,0,0,1,1,0,0,2,0.3666666666666667
虚拟线,0,0,0,1,0,0,0,1,0.125
空间角度矢量,0,0,0,1,0,0,0,1,0.125
位置矢量,0,0,0,4,1,0,0,5,0.7416666666666667
虚拟,0,0,0,1,0,0,0,1,0.125
同向性天线,0,0,0,1,0,1,0,2,0.3666666666666667
中心点,0,0,0,1,0,0,0,1,0.125
均匀采样,0,0,0,1,0,0,0,1,0.125
圆环,0,0,0,1,0,0,0,1,0.125
还原,0,0,0,1,0,0,0,1,0.125
pj闪巧,0,0,0,1,0,0,0,1,0.125
复现信道,0,0,0,1,0,0,0,1,0.125
空间环境,0,0,0,1,0,0,0,1,0.125
mimo信道,0,0,0,3,0,0,0,3,0.375
空间特征,0,0,0,1,0,0,0,1,0.125
角度功率谱,0,0,0,1,0,0,0,1,0.125
aoa,0,0,0,1,1,1,0,3,0.6083333333333334
中心,0,0,0,1,0,1,0,2,0.3666666666666667
标准差,0,0,0,1,0,0,0,1,0.125
归一化因子,0,0,0,1,0,0,0,1,0.125
高斯,0,0,0,1,0,0,0,1,0.125
分布信息,0,0,0,1,0,0,0,1,0.125
分布函数,0,0,0,1,0,0,0,1,0.125
性质,0,0,0,1,0,0,0,1,0.125
spatialcorrelationfunction,0,0,0,1,0,0,0,1,0.125
离散采样,0,0,0,1,0,0,0,1,0.125
powerangularspectrum,0,0,0,1,0,0,0,1,0.125
gbsm模型,0,0,0,9,0,3,0,12,1.85
范数,0,0,0,0,6,0,0,6,1.45
误差函数,0,0,0,0,6,0,0,6,1.45
正则化,0,0,0,0,7,0,0,7,1.6916666666666667
稀疏,0,0,0,0,2,0,0,2,0.48333333333333334
仏正则化函数,0,0,0,0,1,0,0,1,0.24166666666666667
稀疏表示,0,0,0,0,1,0,0,1,0.24166666666666667
函数,0,0,0,0,1,1,0,2,0.48333333333333334
np-hard性质,0,0,0,0,1,0,0,1,0.24166666666666667
ospsl,0,0,0,0,1,0,0,1,0.24166666666666667
内部权重,0,0,0,0,1,0,0,1,0.24166666666666667
正则化约束,0,0,0,0,1,0,0,1,0.24166666666666667
神经网络模型,0,0,0,0,1,0,0,1,0.24166666666666667
空时相关性,0,0,1,0,0,6,0,7,1.575
目标信道模型,0,0,1,0,0,0,0,1,0.125
复杂度分析,0,0,1,0,0,0,0,1,0.125
仿真验证,0,0,1,1,0,0,0,2,0.25
梯度下降理论,0,0,1,0,0,0,0,1,0.125
重构理论,0,0,1,0,0,0,0,1,0.125
测试系统架构,0,0,1,0,0,0,0,1,0.125
随机信道模型,0,0,1,4,0,0,1,6,0.8666666666666667
信道建模技术,0,0,2,1,0,0,0,3,0.375
mimoota测试理论,0,0,1,2,0,0,0,3,0.375
内容,0,0,1,0,0,0,0,1,0.125
变化曲线,0,0,0,0,1,0,0,1,0.24166666666666667
对比算法,0,0,0,0,1,0,0,1,0.24166666666666667
凸优化类算法,0,0,0,0,1,0,0,1,0.24166666666666667
数学仿真时延,0,0,0,0,1,0,0,1,0.24166666666666667
仿真结,0,0,0,0,1,1,0,2,0.48333333333333334
梯度计算,0,0,0,0,3,0,0,3,0.725
非零功率探头,0,0,0,0,1,0,0,1,0.24166666666666667
信道重构技术,1,0,0,2,0,0,1,4,1.4916666666666667
数学公式,0,0,0,1,0,0,0,1,0.125
mimo信道模型,0,0,0,1,0,1,0,2,0.3666666666666667
信道重构技,0,0,0,2,0,0,1,3,0.4916666666666667
维度,0,0,0,0,2,0,0,2,0.48333333333333334
二阶锥规划,0,0,0,0,2,0,0,2,0.48333333333333334
ulti-shot算法,0,0,0,0,1,0,0,1,0.24166666666666667
3d探头,0,0,0,0,1,0,0,1,0.24166666666666667
探头数,0,0,0,0,1,0,0,1,0.24166666666666667
阶等式约束,0,0,0,0,1,0,0,1,0.24166666666666667
二阶锥,0,0,0,0,1,0,0,1,0.24166666666666667
次迭代,0,0,0,0,1,0,0,1,0.24166666666666667
子集,0,0,0,0,3,2,0,5,1.2083333333333333
初始化参数,0,0,0,0,1,0,0,1,0.24166666666666667
传输因子,0,0,0,1,2,0,0,3,0.6083333333333334
时间,1,0,0,0,1,15,0,17,4.866666666666667
动态信道仿真,0,0,0,0,1,0,0,1,0.24166666666666667
dft矩阵,0,0,0,0,0,17,2,19,4.591666666666667
初始相位,1,0,0,0,0,27,0,28,7.525
相位旋转因子,0,0,0,0,0,8,0,8,1.9333333333333333
向量,0,0,0,0,0,2,0,2,0.48333333333333334
列向量点,0,0,0,0,0,2,0,2,0.48333333333333334
随机性,0,0,0,0,1,4,0,5,1.2083333333333333
pfs,0,0,1,0,0,23,4,28,6.65
pfs合成信道,0,0,0,0,0,14,0,14,3.3833333333333333
个列向量,0,0,0,0,0,1,0,1,0.24166666666666667
m阶dft矩阵,0,0,0,0,0,1,0,1,0.24166666666666667
子径数量,0,0,0,0,0,1,0,1,0.24166666666666667
pfs改进算法,0,0,0,0,0,1,0,1,0.24166666666666667
映射,0,0,0,1,0,1,0,2,0.3666666666666667
空间相关性误差,0,0,0,0,0,1,0,1,0.24166666666666667
随机变量,0,0,0,1,0,2,0,3,0.6083333333333334
分布,0,0,0,1,0,1,0,2,0.3666666666666667
expuak,0,0,0,0,0,1,0,1,0.24166666666666667
畸变,0,0,0,0,0,1,0,1,0.24166666666666667
时间相关性,0,0,0,0,0,12,0,12,2.9
信道时间序列,1,0,0,0,0,4,0,5,1.9666666666666668
正交性质,0,0,0,0,0,1,0,1,0.24166666666666667
傅里叶矩阵,0,0,0,0,0,1,0,1,0.24166666666666667
离散傅里叶矩阵,0,0,0,0,0,1,0,1,0.24166666666666667
正交基,0,0,0,0,0,1,0,1,0.24166666666666667
护护,0,0,0,0,0,1,0,1,0.24166666666666667
单位向量,0,0,0,0,0,1,0,1,0.24166666666666667
复数,0,0,0,1,1,1,0,3,0.6083333333333334
元素,0,0,0,0,0,1,0,1,0.24166666666666667
mxm,0,0,0,0,0,1,0,1,0.24166666666666667
快速傅里叶算法,0,0,0,0,0,1,0,1,0.24166666666666667
dft,0,0,0,0,0,1,0,1,0.24166666666666667
discretefouriertransform,0,0,0,0,0,1,0,1,0.24166666666666667
离散傅里叶变换,0,0,0,0,0,1,0,1,0.24166666666666667
预衰落合成法信道,0,0,0,0,0,1,0,1,0.24166666666666667
丰炉,0,0,0,0,0,1,0,1,0.24166666666666667
纵叽叶,0,0,0,0,0,1,0,1,0.24166666666666667
交叉项,0,0,0,0,0,2,0,2,0.48333333333333334
执行时间,0,0,0,0,8,0,0,8,1.9333333333333333
线性,0,0,0,0,1,1,0,2,0.48333333333333334
梯度下降算法,0,0,0,0,1,0,0,1,0.24166666666666667
运行,0,0,0,0,1,0,0,1,0.24166666666666667
运行批次,0,0,0,0,1,0,0,1,0.24166666666666667
相关性集合,0,0,0,0,1,0,0,1,0.24166666666666667
ia,0,0,0,0,1,0,0,1,0.24166666666666667
rootmeansquared,0,0,0,0,1,0,0,1,0.24166666666666667
均方根偏差,0,0,0,0,1,0,0,1,0.24166666666666667
cdl-a信道模型,0,0,0,0,1,0,0,1,0.24166666666666667
执行速度,0,0,0,0,1,0,0,1,0.24166666666666667
内置探查器命令,0,0,0,0,1,0,0,1,0.24166666666666667
运行速度,0,0,0,0,1,0,0,1,0.24166666666666667
瞬时稀疏状态,0,0,0,0,1,0,0,1,0.24166666666666667
正则化约束项,0,0,0,0,1,0,0,1,0.24166666666666667
稀疏约束,0,0,0,0,1,0,0,1,0.24166666666666667
massivemimoota系统,0,0,0,0,1,0,0,1,0.24166666666666667
空口,0,0,0,0,1,0,0,1,0.24166666666666667
移动端,0,0,0,17,0,2,0,19,2.6083333333333334
基站端,0,0,0,10,0,0,0,10,1.25
天线增益,0,0,0,5,0,0,0,5,0.625
直射径,0,0,0,5,0,0,0,5,0.625
相位差,0,0,0,4,0,0,0,4,0.5
散射体,0,0,0,8,0,1,0,9,1.2416666666666667
法线,0,0,0,3,0,0,0,3,0.375
传播环境,0,0,0,3,0,0,0,3,0.375
0极化,0,0,0,2,0,0,0,2,0.25
极化泄露比,0,0,0,2,0,0,0,2,0.25
多普勒频偏,0,0,0,2,0,0,0,2,0.25
离开,0,0,0,2,0,0,0,2,0.25
个数,0,0,0,2,0,0,0,2,0.25
参考线,0,0,0,2,0,0,0,2,0.25
阵列,0,0,0,2,0,0,0,2,0.25
单位角度矢量,0,0,0,2,0,0,0,2,0.25
三维向量,0,0,0,2,0,0,0,2,0.25
到达,0,0,0,2,0,0,0,2,0.25
多径信道,0,0,0,5,0,0,0,5,0.625
传输环境,0,0,0,3,0,0,0,3,0.375
接收机,0,0,0,2,0,0,0,2,0.25
接收天线,0,0,0,2,0,0,0,2,0.25
双极化,0,0,0,1,0,1,0,2,0.3666666666666667
随机相位,0,0,0,1,0,0,0,1,0.125
极化分量,0,0,0,1,0,0,0,1,0.125
gbsm,0,0,0,2,0,1,0,3,0.4916666666666667
分量,0,0,0,1,0,0,0,1,0.125
极化特征,0,0,0,1,0,0,0,1,0.125
自由空间传播,0,0,0,1,0,0,0,1,0.125
多径特征,0,0,0,1,0,0,0,1,0.125
折射,0,0,0,1,0,0,0,1,0.125
发送天线,0,0,0,1,0,0,0,1,0.125
传输,0,0,0,2,0,0,0,2,0.25
随机数,0,0,0,1,0,0,0,1,0.125
j^m,0,0,0,1,0,0,0,1,0.125
妙代,0,0,0,1,0,0,0,1,0.125
初始随机相位,0,0,0,1,0,0,0,1,0.125
条子径,0,0,0,1,0,1,0,2,0.3666666666666667
相位偏移,0,0,0,1,0,0,0,1,0.125
运动矢量,0,0,0,1,0,0,0,1,0.125
速度矢量,0,0,0,1,0,0,0,1,0.125
角氏,0,0,0,1,0,0,0,1,0.125
基站法线,0,0,0,1,0,0,0,1,0.125
随机信道模型参数,0,0,0,1,0,0,0,1,0.125
sq,0,0,0,1,0,0,0,1,0.125
信道公式,0,0,0,2,0,0,0,2,0.25
高斯分布,0,0,0,1,0,0,0,1,0.125
part,0,0,0,1,0,0,0,1,0.125
arrivalof,0,0,0,1,0,0,0,1,0.125
离开角,0,0,0,1,0,1,0,2,0.3666666666666667
信道测量,0,0,0,3,0,0,0,3,0.375
线性排布,0,0,0,1,0,0,0,1,0.125
movestation,0,0,0,1,0,0,0,1,0.125
移动,0,0,0,1,0,0,0,1,0.125
basestation,0,0,0,1,0,0,0,1,0.125
发端,0,0,0,2,0,2,0,4,0.7333333333333334
收端,0,0,0,1,0,2,0,3,0.6083333333333334
几何体,0,0,0,1,0,0,0,1,0.125
规则几何体,0,0,0,1,0,0,0,1,0.125
圆柱形,0,0,0,1,0,0,0,1,0.125
圆形,0,0,0,1,0,0,0,1,0.125
球形,0,0,0,1,0,0,0,1,0.125
非规则形状模型,0,0,0,1,0,0,0,1,0.125
规则形状,0,0,0,1,0,0,0,1,0.125
几何,0,0,0,1,0,0,0,1,0.125
坐标系,0,0,0,1,0,0,0,1,0.125
随机性信道模型,0,0,0,2,0,0,0,2,0.25
辐射,0,0,5,5,0,0,0,10,1.25
辐射两步法,0,0,3,2,0,0,0,5,0.625
5g信道,0,0,2,0,0,0,0,2,0.25
rts,0,0,2,10,0,0,0,12,1.5
传输矩阵,0,0,2,5,0,0,0,7,0.875
高阶mimo设备,0,0,2,1,0,0,0,3,0.375
方向图,0,0,2,5,0,0,0,7,0.875
多径环境,0,0,2,0,0,0,0,2,0.25
5gmimoota,1,0,1,0,0,0,0,2,1.125
标准信道模型,0,0,1,0,0,1,0,2,0.3666666666666667
远场条,0,0,1,0,0,0,0,1,0.125
补偿,0,0,1,0,0,0,0,1,0.125
近场传输矩阵,0,0,1,0,0,0,0,1,0.125
暗室补偿,0,0,1,0,0,0,0,1,0.125
5g通信,0,0,1,0,0,0,1,2,0.3666666666666667
mimo技术,0,0,1,1,0,0,0,2,0.25
规模天线设备,0,0,1,0,0,0,0,1,0.125
相位补偿矩阵,0,0,1,0,0,0,0,1,0.125
调相网络,0,0,1,0,0,0,0,1,0.125
保证算法,0,0,1,0,0,0,0,1,0.125
探头选择,0,0,1,0,0,0,0,1,0.125
信道复现精度,0,0,1,0,0,0,0,1,0.125
端口,0,0,1,2,1,0,0,4,0.6166666666666667
5gmassivemimoota测试系统,0,0,1,0,0,0,0,1,0.125
大规模天线设备,0,0,1,1,0,0,3,5,0.975
评价,0,0,1,0,0,0,0,1,0.125
相似性,0,0,1,0,0,0,0,1,0.125
算法理论,0,0,1,0,0,0,0,1,0.125
波束赋形测试,0,0,1,0,0,0,0,1,0.125
模天线设备,0,0,1,0,0,0,0,1,0.125
建模思想,0,0,1,1,0,0,0,2,0.25
planewavesynthesis,0,0,1,0,0,0,0,1,0.125
fadedsignalsynthe,0,0,1,0,0,0,0,1,0.125
pre,0,0,1,0,0,0,0,1,0.125
天线探头,0,0,1,0,0,0,0,1,0.125
射频屏蔽设备,0,0,1,0,0,0,0,1,0.125
多载波设备,0,0,1,0,0,0,0,1,0.125
吞吐量测,0,0,1,0,0,0,0,1,0.125
wlan,0,0,1,0,0,0,0,1,0.125
tw,0,0,1,0,0,0,0,1,0.125
calare,0,0,1,0,0,0,0,1,0.125
wireless,0,0,1,0,0,0,0,1,0.125
无线局域网,0,0,1,0,0,0,0,1,0.125
数据上报,0,0,1,2,0,0,0,3,0.375
互异性,0,0,1,0,0,0,0,1,0.125
测试复杂度,0,0,1,0,0,0,0,1,0.125
求解算法,0,0,1,0,0,0,0,1,0.125
粒子群,0,0,1,0,0,0,0,1,0.125
设备天线端口,0,0,1,0,0,0,0,1,0.125
测试效率,0,0,1,0,0,0,0,1,0.125
求解时间,0,0,1,0,0,0,0,1,0.125
逆矩阵,0,0,1,1,0,0,0,2,0.25
快速逆矩阵求解算法,0,0,1,0,0,0,0,1,0.125
空口传输矩阵,0,0,1,1,0,0,0,2,0.25
信号传输,0,0,1,0,0,0,0,1,0.125
空口传播,0,0,1,0,0,0,0,1,0.125
幅度,0,0,1,0,0,0,0,1,0.125
被测设备天线,0,0,1,1,0,0,0,2,0.25
mimoota测试技术,0,0,2,1,0,0,1,4,0.6166666666666667
测试验证,0,0,1,0,0,0,0,1,0.125
无线传播信道,0,0,1,1,0,0,0,2,0.25
高铁,0,0,1,0,0,0,0,1,0.125
同向性,0,0,1,0,0,0,0,1,0.125
arri,0,0,1,0,0,0,0,1,0.125
angle,0,0,1,0,0,0,0,1,0.125
angularspread,0,0,1,0,0,0,0,1,0.125
角度扩展,0,0,1,0,0,0,0,1,0.125
数量,0,0,1,0,2,0,0,3,0.6083333333333334
mpc,0,0,1,0,0,0,0,1,0.125
multi-pathcomponents,0,0,1,0,0,0,0,1,0.125
多径分量,0,0,1,0,0,0,0,1,0.125
接受功率,0,0,1,0,0,0,0,1,0.125
多径信道特性控制,0,0,1,0,0,0,0,1,0.125
莱斯因子,0,0,1,0,0,0,0,1,0.125
模拟信道,0,0,1,0,0,0,0,1,0.125
信噪比,0,0,1,0,0,0,0,1,0.125
吞吐量,0,0,1,0,0,0,0,1,0.125
通信链路,0,0,1,1,0,0,0,2,0.25
通信场景,0,0,1,0,0,0,0,1,0.125
mimo,1,0,1,0,0,0,0,2,1.125
so,0,0,1,0,0,0,0,1,0.125
singleinput,0,0,1,0,0,0,0,1,0.125
单出,0,0,1,0,0,0,0,1,0.125
通信设备,0,0,1,0,0,0,0,1,0.125
拨片,0,0,1,0,0,0,0,1,0.125
金属搅拌浆,0,0,1,0,0,0,0,1,0.125
金属腔体,0,0,1,0,0,0,0,1,0.125
mimo阵列设备,0,0,1,0,0,0,0,1,0.125
geometry-basedstochastic,0,0,0,1,0,0,0,1,0.125
随机性信道建模,0,0,0,2,0,0,0,2,0.25
确定性信道建模,0,0,0,2,0,0,0,2,0.25
建模,0,0,0,3,0,0,0,3,0.375
mimo信道建模技术,0,0,0,2,0,0,0,2,0.25
建模技术,0,0,0,2,0,0,0,2,0.25
2mimo信道建模技术,0,0,0,1,0,0,0,1,0.125
信道重构精度,0,0,0,0,0,1,0,1,0.24166666666666667
空间相关性复现,0,0,0,0,0,1,0,1,0.24166666666666667
信道传递函数,0,0,0,0,0,2,0,2,0.48333333333333334
空时联,0,0,0,0,0,1,1,2,0.48333333333333334
时间平均,0,0,0,0,0,2,1,3,0.725
信道空时相关性重构,0,0,0,0,0,1,0,1,0.24166666666666667
零阶范数,0,0,0,0,2,0,0,2,0.48333333333333334
np-hard问,0,0,0,0,1,0,0,1,0.24166666666666667
非凸优驶,0,0,0,0,1,0,0,1,0.24166666666666667
二阶范数,0,0,0,0,1,0,0,1,0.24166666666666667
卜林,0,0,0,0,1,0,0,1,0.24166666666666667
误差平方,0,0,0,0,1,0,0,1,0.24166666666666667
合成空间,0,0,0,0,1,2,0,3,0.725
空间性,0,0,0,0,1,0,0,1,0.24166666666666667
采样点,0,0,0,7,2,0,0,9,1.3583333333333334
矢量,0,0,0,0,1,0,0,1,0.24166666666666667
操作符,0,0,0,0,1,0,0,1,0.24166666666666667
信道仿真器,0,0,0,0,1,0,0,1,0.24166666666666667
约束公式,0,0,0,0,1,0,0,1,0.24166666666666667
非负约束,0,0,0,0,2,0,0,2,0.48333333333333334
单位,0,0,0,0,1,0,0,1,0.24166666666666667
功率值,0,0,0,0,1,0,0,1,0.24166666666666667
探头天线数,0,0,0,0,1,0,0,1,0.24166666666666667
立体角矢量,0,0,0,0,1,0,0,1,0.24166666666666667
天线单元,0,0,0,0,1,0,0,1,0.24166666666666667
个采样,0,0,0,0,1,0,0,1,0.24166666666666667
采样对,0,0,0,0,1,0,0,1,0.24166666666666667
rival,0,0,0,0,1,0,0,1,0.24166666666666667
ead,0,0,0,0,1,0,0,1,0.24166666666666667
zenithangles,0,0,0,0,1,0,0,1,0.24166666666666667
垂直角度扩展,0,0,0,0,1,0,0,1,0.24166666666666667
val,0,0,0,0,1,0,0,1,0.24166666666666667
ar,0,0,0,0,1,0,0,1,0.24166666666666667
zenithangle,0,0,0,0,1,0,0,1,0.24166666666666667
垂直到达角,0,0,0,0,1,0,0,1,0.24166666666666667
垂直,0,0,0,0,2,0,0,2,0.48333333333333334
azimuthangles,0,0,0,0,1,0,0,1,0.24166666666666667
水平角度,0,0,0,0,1,0,0,1,0.24166666666666667
sphericalpowerspectrum,0,0,0,0,1,0,0,1,0.24166666666666667
球形功率谱,0,0,0,0,1,0,0,1,0.24166666666666667
垂直域,0,0,0,0,1,0,0,1,0.24166666666666667
椭圆球面,0,0,0,0,1,0,0,1,0.24166666666666667
mimo天线阵列,0,0,0,0,1,0,0,1,0.24166666666666667
收端天线,0,0,0,0,0,6,0,6,1.45
信道传输函数,0,0,0,0,0,6,0,6,1.45
工工,0,0,0,0,0,1,0,1,0.24166666666666667
空时,1,0,0,0,0,4,0,5,1.9666666666666668
发端天线,0,0,0,0,0,3,0,3,0.725
广义平稳,0,0,0,0,0,2,0,2,0.48333333333333334
自由空间传输损耗,0,0,0,0,0,1,0,1,0.24166666666666667
相位旋转,0,0,0,0,0,1,0,1,0.24166666666666667
传输时延,0,0,0,0,0,1,0,1,0.24166666666666667
传输函数,0,0,0,0,0,1,0,1,0.24166666666666667
多普勒分量,0,0,0,0,0,5,0,5,1.2083333333333333
均匀分布,0,0,0,0,0,2,0,2,0.48333333333333334
加条子径,0,0,0,0,0,1,0,1,0.24166666666666667
nen,0,0,0,0,0,1,0,1,0.24166666666666667
单极化mpac,0,0,0,0,0,1,0,1,0.24166666666666667
角度信息,0,0,0,0,0,7,0,7,1.6916666666666667
来波角度,0,0,0,0,0,2,0,2,0.48333333333333334
标准信道,0,0,0,0,0,2,0,2,0.48333333333333334
dft映射,0,0,0,0,0,1,0,1,0.24166666666666667
多簇,0,0,0,0,0,1,0,1,0.24166666666666667
无交集,0,0,0,0,0,1,0,1,0.24166666666666667
列向量集合,0,0,0,0,0,1,0,1,0.24166666666666667
复用,0,0,0,0,0,1,0,1,0.24166666666666667
初始相位矢量,0,0,0,0,0,1,0,1,0.24166666666666667
马工,0,0,0,0,0,1,0,1,0.24166666666666667
奋工,0,0,0,0,0,1,0,1,0.24166666666666667
中子径,2,0,0,0,0,1,0,3,2.2416666666666667
龙尺,0,0,0,0,0,1,0,1,0.24166666666666667
交叉,0,0,0,0,0,1,0,1,0.24166666666666667
ky,0,0,0,0,0,1,0,1,0.24166666666666667
hg工,0,0,0,0,0,1,0,1,0.24166666666666667
序号,0,0,0,0,0,1,0,1,0.24166666666666667
中簇,0,0,0,0,0,1,0,1,0.24166666666666667
时延扩展,0,0,0,0,0,1,0,1,0.24166666666666667
winner,0,0,0,0,0,1,0,1,0.24166666666666667
多簇信道环,0,0,0,0,0,1,0,1,0.24166666666666667
通信标准,0,0,0,0,0,1,0,1,0.24166666666666667
cdl信道,0,0,0,0,0,1,0,1,0.24166666666666667
winner信道,0,0,0,0,0,1,0,1,0.24166666666666667
无线传输环境,0,0,0,0,0,1,0,1,0.24166666666666667
来波角,0,0,0,2,0,0,0,2,0.25
内部信道,0,0,0,1,0,0,0,1,0.125
dut尺寸,0,0,0,1,0,0,0,1,0.125
5gmassivemimo,0,0,0,1,0,0,0,1,0.125
资源数量,0,0,0,2,0,0,0,2,0.25
测试环境,0,0,0,1,0,0,0,1,0.125
ota放置,0,0,0,1,0,0,0,1,0.125
信道维度,0,0,0,1,0,0,0,1,0.125
双极化探头,0,0,0,1,0,0,0,1,0.125
空间信息,0,0,0,1,0,0,0,1,0.125
远场条件,0,0,0,2,0,0,0,2,0.25
传输损耗,0,0,0,1,0,0,0,1,0.125
路径损耗,0,0,0,2,0,0,0,2,0.25
测试信号,0,0,0,1,0,0,0,1,0.125
增强,0,0,0,1,0,0,0,1,0.125
放大,0,0,0,1,0,0,0,1,0.125
多径,0,0,0,1,0,0,0,1,0.125
poweramplifier,0,0,0,1,0,0,0,1,0.125
特性,0,0,0,2,0,0,0,2,0.25
masisvemimo设备,0,0,0,1,0,0,0,1,0.125
信道复现评判因子,0,0,0,1,0,0,0,1,0.125
空间谱相似度,0,0,0,1,0,0,0,1,0.125
信道复现,0,0,0,1,0,0,0,1,0.125
暗室体积,0,0,0,1,0,0,0,1,0.125
低阶mimo设备,0,0,0,1,0,0,0,1,0.125
性能测,0,0,0,1,0,0,0,1,0.125
设备测,0,0,0,1,0,0,0,1,0.125
毫米波频段信道,0,0,0,1,0,0,0,1,0.125
电磁反射环境,0,0,0,1,0,0,0,1,0.125
5g测试,0,0,0,1,0,0,0,1,0.125
终端测试,0,0,0,1,0,0,0,1,0.125
上报,0,0,0,1,0,0,0,1,0.125
massive,0,0,0,1,0,0,0,1,0.125
系统复杂度,0,0,0,1,0,0,0,1,0.125
对比角度,0,0,0,1,0,0,0,1,0.125
rc,0,0,0,1,0,0,0,1,0.125
侵入,0,0,0,1,0,0,0,1,0.125
siso暗室,0,0,0,2,0,0,0,2,0.25
随机信道,0,0,0,1,0,0,0,1,0.125
非零权重,0,0,0,0,2,0,0,2,0.48333333333333334
收敛,0,0,0,0,2,0,0,2,0.48333333333333334
振荡,0,0,0,0,1,0,0,1,0.24166666666666667
正则化项,0,0,0,0,1,0,0,1,0.24166666666666667
梯度分量,0,0,0,0,1,0,0,1,0.24166666666666667
非负象限,0,0,0,0,1,0,0,1,0.24166666666666667
运算符,0,0,0,0,1,0,0,1,0.24166666666666667
慢启动,0,0,0,0,1,0,0,1,0.24166666666666667
正则化系数,0,0,0,0,2,0,0,2,0.48333333333333334
总迭代次数,0,0,0,0,1,0,0,1,0.24166666666666667
算法流程,0,0,0,0,1,0,0,1,0.24166666666666667
曲线,0,0,0,0,0,5,0,5,1.2083333333333333
运动速度,0,0,0,0,0,3,0,3,0.725
频谱分量,0,0,0,0,0,3,0,3,0.725
圆圈,0,0,0,0,0,3,0,3,0.725
解析tcf,0,0,0,0,0,2,0,2,0.48333333333333334
模拟tcf,0,0,0,0,0,2,0,2,0.48333333333333334
多普勒频谱,0,0,0,0,0,2,0,2,0.48333333333333334
内部参数,0,0,0,0,0,2,0,2,0.48333333333333334
时间相关性仿真,0,0,0,0,0,1,0,1,0.24166666666666667
时间相,0,0,0,0,0,1,0,1,0.24166666666666667
震荡,0,0,0,0,0,1,0,1,0.24166666666666667
速度,0,0,0,0,0,2,0,2,0.48333333333333334
自相关函数,0,0,0,0,0,1,0,1,0.24166666666666667
时间自相关函数,0,0,0,0,0,1,0,1,0.24166666666666667
移动端速度,0,0,0,0,0,1,0,1,0.24166666666666667
合成时间,0,0,0,0,0,1,0,1,0.24166666666666667
标信道,0,0,0,0,0,1,0,1,0.24166666666666667
仿真图,0,0,0,0,0,1,0,1,0.24166666666666667
解析scf,0,0,0,0,0,1,0,1,0.24166666666666667
信道序列,0,0,0,0,0,1,0,1,0.24166666666666667
模拟scf,0,0,0,0,0,2,0,2,0.48333333333333334
性仿真,0,0,0,0,0,1,0,1,0.24166666666666667
空间相,0,0,0,0,0,1,0,1,0.24166666666666667
累加,0,0,0,0,0,1,0,1,0.24166666666666667
高阶特性,0,0,0,0,0,1,0,1,0.24166666666666667
统计平均,0,0,0,0,0,1,0,1,0.24166666666666667
pfs重构信道,0,0,0,0,0,1,0,1,0.24166666666666667
重构信道,0,0,0,0,0,1,0,1,0.24166666666666667
无线信道,0,0,0,7,0,0,0,7,0.875
射线追踪,0,0,0,4,0,0,0,4,0.5
数学建模,0,0,0,3,0,0,0,3,0.375
cbsm,0,0,0,2,0,0,0,2,0.25
随机模型,0,0,0,2,0,0,0,2,0.25
镜像点,0,0,0,2,0,0,0,2,0.25
反射面,0,0,0,2,0,0,0,2,0.25
发射点,0,0,0,2,0,0,0,2,0.25
反弹射线法,0,0,0,2,0,0,0,2,0.25
入射,0,0,0,2,0,0,0,2,0.25
镜像法,0,0,0,2,0,0,0,2,0.25
性建模,0,0,0,2,0,0,0,2,0.25
电磁波,0,0,0,2,0,0,0,2,0.25
fdtd,0,0,0,2,0,0,0,2,0.25
确定性建模,0,0,0,2,0,0,0,2,0.25
确定性模型,0,0,0,2,0,0,0,2,0.25
时域,0,0,0,2,0,0,0,2,0.25
参数提取,0,0,0,2,0,0,0,2,0.25
无线传输信道,0,0,0,2,0,0,0,2,0.25
信道衰落,0,0,0,2,0,0,0,2,0.25
链路级仿真,0,0,0,1,0,0,0,1,0.125
通信算法,0,0,0,1,0,0,0,1,0.125
mim0信道容量,0,0,0,1,0,0,0,1,0.125
系统级仿真,0,0,0,1,0,0,0,1,0.125
mim0信道,0,0,0,1,0,0,0,1,0.125
mim0信道矩阵,0,0,0,1,0,0,0,1,0.125
du,0,0,0,1,0,0,0,1,0.125
kronecker,0,0,0,1,0,0,0,1,0.125
克罗内克积,0,0,0,1,0,0,0,1,0.125
3gpp模型,0,0,0,1,0,0,0,1,0.125
winnerii模型,0,0,0,1,0,0,0,1,0.125
scm模型,0,0,0,1,0,0,0,1,0.125
接收体,0,0,0,1,0,0,0,1,0.125
发射体,0,0,0,1,0,0,0,1,0.125
ogbsm,0,0,0,1,0,0,0,1,0.125
correlation-basedstochastic,0,0,0,1,0,0,0,1,0.125
随即向信道模型,0,0,0,1,0,0,0,1,0.125
内在特征,0,0,0,1,0,0,0,1,0.125
概率函数,0,0,0,1,0,0,0,1,0.125
随机性信道,0,0,0,1,0,0,0,1,0.125
信道传环境,0,0,0,1,0,0,0,1,0.125
射线追踪管,0,0,0,1,0,0,0,1,0.125
球形空间,0,0,0,1,0,0,0,1,0.125
射线管,0,0,0,1,0,0,0,1,0.125
传播路径,0,0,0,1,0,0,0,1,0.125
反射点,0,0,0,1,0,0,0,1,0.125
连线,0,0,0,1,0,0,0,1,0.125
接受点,0,0,0,1,0,0,0,1,0.125
bouncing,0,0,0,1,0,0,0,1,0.125
shooting,0,0,0,1,0,0,0,1,0.125
imagebased,0,0,0,1,0,0,0,1,0.125
衍射,0,0,0,1,0,0,0,1,0.125
透射,0,0,0,1,0,0,0,1,0.125
传播,0,0,0,1,0,0,0,1,0.125
geometryoptic,0,0,0,1,0,0,0,1,0.125
几何光学,0,0,0,1,0,0,0,1,0.125
差分,0,0,0,1,0,0,0,1,0.125
空域,0,0,0,1,0,0,0,1,0.125
麦克斯韦方程组,0,0,0,1,0,0,0,1,0.125
raytra,0,0,0,1,0,0,0,1,0.125
dtd,0,0,0,1,0,0,0,1,0.125
differencetime-domain,0,0,0,1,0,0,0,1,0.125
finite-,0,0,0,1,0,0,0,1,0.125
时域有限差分,0,0,0,1,0,0,0,1,0.125
确定性信道,0,0,0,1,0,0,0,1,0.125
5mimo信道模型,0,0,0,1,0,0,0,1,0.125
几何模型,0,0,0,1,0,0,0,1,0.125
随机性模型,0,0,0,1,0,0,0,1,0.125
相关性模型,0,0,0,1,0,0,0,1,0.125
mlmo信道模型,0,0,0,1,0,0,0,1,0.125
有限差分,0,0,0,1,0,0,0,1,0.125
特性分析,0,0,0,1,0,0,0,1,0.125
移动通信,0,0,0,1,0,0,0,1,0.125
4mimo系统,0,0,0,1,0,0,0,1,0.125
传输环,0,0,0,1,0,0,0,1,0.125
遮挡,0,0,0,1,0,0,0,1,0.125
建筑体,0,0,0,1,0,0,0,1,0.125
车辆,0,0,0,1,0,0,0,1,0.125
天气,0,0,0,1,0,0,0,1,0.125
承载通道,0,0,0,1,0,0,0,1,0.125
传输数据,0,0,0,1,0,0,0,1,0.125
信号处理,0,0,0,1,0,0,0,1,0.125
发射天线,0,0,0,1,0,0,0,1,0.125
编码,0,0,0,1,0,0,0,1,0.125
调制,0,0,0,1,0,0,0,1,0.125
发送数据,0,0,0,1,0,0,0,1,0.125
mimo系统,0,0,0,1,0,0,0,1,0.125
imo信道模型,0,0,0,1,0,0,0,1,0.125
1m,0,0,0,1,0,0,0,1,0.125
收敛性,0,0,0,0,2,0,0,2,0.48333333333333334
批次迭代,0,0,0,0,1,0,0,1,0.24166666666666667
数据,0,0,0,1,1,0,0,2,0.3666666666666667
计算复杂度,0,0,0,0,1,0,0,1,0.24166666666666667
批次,0,0,0,0,1,0,0,1,0.24166666666666667
数据子集,0,0,0,0,1,0,0,1,0.24166666666666667
算法迭代,0,0,0,0,1,0,0,1,0.24166666666666667
t'et,0,0,0,0,1,0,0,1,0.24166666666666667
虚部,0,0,0,0,1,0,0,1,0.24166666666666667
实部,0,0,0,0,1,0,0,1,0.24166666666666667
乖订警,0,0,0,0,1,0,0,1,0.24166666666666667
链式法,0,0,0,0,1,0,0,1,0.24166666666666667
pntpmy,0,0,0,0,1,0,0,1,0.24166666666666667
复数误差,0,0,0,0,1,0,0,1,0.24166666666666667
scf,0,0,0,0,0,4,0,4,0.9666666666666667
mpac法,0,0,0,0,0,3,0,3,0.725
时间平均函数,0,0,0,0,0,2,0,2,0.48333333333333334
多普勒频移,0,0,0,0,0,2,0,2,0.48333333333333334
m^m,0,0,0,0,0,1,0,1,0.24166666666666667
表达式,0,0,0,0,0,1,0,1,0.24166666666666667
关性,0,0,0,0,0,1,0,1,0.24166666666666667
遍历性,0,0,0,0,0,1,0,1,0.24166666666666667
常数,0,0,0,0,0,1,0,1,0.24166666666666667
快拍,0,0,0,0,0,1,0,1,0.24166666666666667
od,0,0,0,0,0,1,0,1,0.24166666666666667
平均功率,0,0,0,0,0,1,0,1,0.24166666666666667
时间采样点,0,0,0,0,0,1,0,1,0.24166666666666667
单极化,0,0,0,0,0,1,0,1,0.24166666666666667
空间结构,0,0,0,0,0,1,0,1,0.24166666666666667
角度偏移,0,0,0,0,0,1,0,1,0.24166666666666667
散射,0,0,0,0,0,1,0,1,0.24166666666666667
散射点,0,0,0,0,0,1,0,1,0.24166666666666667
路径,0,0,0,0,0,1,0,1,0.24166666666666667
真实传播通道,0,0,0,0,0,1,0,1,0.24166666666666667
天线效应,0,0,0,0,0,1,0,1,0.24166666666666667
传播参数,0,0,0,0,0,1,0,1,0.24166666666666667
区域,1,0,0,0,0,1,0,2,1.2416666666666667
平均时间,0,0,0,0,0,1,0,1,0.24166666666666667
平均,1,0,0,0,0,1,1,3,1.4833333333333334
时间序列,0,0,0,0,0,1,0,1,0.24166666666666667
随机参数,1,0,0,0,0,1,0,2,1.2416666666666667
mpac配置,0,0,0,0,0,1,0,1,0.24166666666666667
克罗内克结构,0,0,0,0,0,1,0,1,0.24166666666666667
space-timecorrelationfunction,0,0,0,0,0,1,0,1,0.24166666666666667
联合空时相关函数,0,0,0,0,0,1,0,1,0.24166666666666667
探头功率权重,0,0,0,0,0,1,0,1,0.24166666666666667
空间相关函数,0,0,0,0,0,1,0,1,0.24166666666666667
pws,0,0,0,0,0,1,0,1,0.24166666666666667
细粒度控制,0,0,0,0,0,1,0,1,0.24166666666666667
空间多径结构,0,0,0,0,0,1,0,1,0.24166666666666667
实传输环境,0,0,0,0,0,1,0,1,0.24166666666666667
天线设备,1,0,0,0,0,0,3,4,1.725
稀疏化,0,0,0,0,0,0,2,2,0.48333333333333334
规模,0,0,0,0,0,0,2,2,0.48333333333333334
信道重构性能,0,0,0,0,0,0,1,1,0.24166666666666667
复现误差,0,0,0,0,0,0,1,1,0.24166666666666667
时间响应,0,0,0,0,0,0,1,1,0.24166666666666667
单簇,0,0,0,0,0,0,1,1,0.24166666666666667
合成空间相关性,0,0,0,0,0,0,1,1,0.24166666666666667
精确度,0,0,0,1,0,0,1,2,0.3666666666666667
动态参数调节,0,0,0,0,0,0,1,1,0.24166666666666667
择算,0,0,0,0,0,0,1,1,0.24166666666666667
复现目标空间,0,0,0,0,0,0,1,1,0.24166666666666667
部件,0,0,0,0,0,0,1,1,0.24166666666666667
ota测试系统,0,0,0,0,0,0,1,1,0.24166666666666667
凸优化探头,0,0,0,0,0,0,1,1,0.24166666666666667
5g基站设备,0,0,0,0,0,0,1,1,0.24166666666666667
大规模天线技术,0,0,0,0,0,0,1,1,0.24166666666666667
平面波,0,0,0,4,0,0,0,4,0.5
复权重系数,0,0,0,2,0,0,0,2,0.25
相位漂移,0,0,0,1,0,0,0,1,0.125
4g终端测试,0,0,0,1,0,0,0,1,0.125
频率,0,0,0,1,0,1,0,2,0.3666666666666667
矩阵求逆法,0,0,0,1,0,0,0,1,0.125
复权重向量,0,0,0,1,0,0,0,1,0.125
电磁场矢量,0,0,0,1,0,0,0,1,0.125
传输因子矩阵,0,0,0,1,0,0,0,1,0.125
复权重矢量,0,0,0,1,0,0,0,1,0.125
复权重因子,0,0,0,1,0,0,0,1,0.125
取模操作,0,0,0,1,0,0,0,1,0.125
eqexp,0,0,0,1,0,0,0,1,0.125
波数,0,0,0,1,0,0,0,1,0.125
2dmim00ta测试系统,0,0,0,1,0,0,0,1,0.125
天线端口,0,0,0,2,0,0,0,2,0.25
测量,0,0,0,2,0,0,0,2,0.25
天线数量,0,0,0,1,0,0,0,1,0.125
端口数量,0,0,0,1,0,0,0,1,0.125
阶mimo设备,0,0,0,1,0,0,0,1,0.125
sisoota暗室,0,0,0,1,0,0,0,1,0.125
辐射两步法测试系统,0,0,0,1,0,0,0,1,0.125
暗窒,0,0,0,1,0,0,0,1,0.125
无线电缆法,0,0,0,1,0,0,0,1,0.125
导线连接,0,0,0,1,0,0,0,1,0.125
预编码,0,0,0,1,0,0,0,1,0.125
输出信号,0,0,0,1,0,0,0,1,0.125
模拟器端口,0,0,0,1,0,0,0,1,0.125
暗室内部信道,0,0,0,1,0,0,0,1,0.125
传导两步法,0,0,0,1,0,0,0,1,0.125
一体化技术,0,0,0,1,0,0,0,1,0.125
射频天线,0,0,0,1,0,0,0,1,0.125
传导两步,0,0,0,1,0,0,0,1,0.125
传导两,0,0,0,1,0,0,0,1,0.125
设备性能,0,0,0,1,0,0,0,1,0.125
向图,0,0,0,1,0,0,0,1,0.125
安捷伦,0,0,0,1,0,0,0,1,0.125
扩展角,0,0,0,0,2,0,0,2,0.48333333333333334
相关性误差,0,0,0,0,1,0,0,1,0.24166666666666667
绝对值误差,0,0,0,0,1,0,0,1,0.24166666666666667
采样球面,0,0,0,0,1,0,0,1,0.24166666666666667
中心角度,0,0,0,0,1,0,0,1,0.24166666666666667
实心圆,0,0,0,0,1,0,0,1,0.24166666666666667
空间角度,0,0,0,0,1,0,0,1,0.24166666666666667
黑色空心圆圈,0,0,0,0,1,0,0,1,0.24166666666666667
水平,0,0,0,0,1,0,0,1,0.24166666666666667
信道合成,0,0,0,0,1,0,0,1,0.24166666666666667
效果,0,0,0,0,1,0,0,1,0.24166666666666667
非零探头,0,0,0,0,2,0,0,2,0.48333333333333334
自适应调整,0,0,0,0,1,0,0,1,0.24166666666666667
反向,0,0,0,0,1,0,0,1,0.24166666666666667
仿真误差波动,0,0,0,0,1,0,0,1,0.24166666666666667
相关性误差值,0,0,0,0,1,0,0,1,0.24166666666666667
迭代过程,0,0,0,0,1,0,0,1,0.24166666666666667
非零权值,0,0,0,0,1,0,0,1,0.24166666666666667
仿真误差,0,0,0,0,1,0,0,1,0.24166666666666667
权重个数,0,0,0,0,1,0,0,1,0.24166666666666667
阶段,0,0,0,0,1,0,0,1,0.24166666666666667
正则,0,0,0,0,1,0,0,1,0.24166666666666667
非零权重个数,0,0,0,0,1,0,0,1,0.24166666666666667
非直射,0,0,0,0,0,4,0,4,0.9666666666666667
探头信号,0,0,0,0,0,3,0,3,0.725
cdl-b信道,0,0,0,0,0,2,0,2,0.48333333333333334
cdl-a,0,0,0,0,0,2,0,2,0.48333333333333334
内部子径,0,0,0,0,0,2,0,2,0.48333333333333334
pfs信道,0,0,0,0,0,2,0,2,0.48333333333333334
空间相关性曲线,0,0,0,0,0,2,0,2,0.48333333333333334
单簇场景,0,0,0,0,0,2,0,2,0.48333333333333334
cdl-c信道,0,0,0,0,0,1,0,1,0.24166666666666667
cdl-a信道仿真,0,0,0,0,0,1,0,1,0.24166666666666667
scf仿真,0,0,0,0,0,1,0,1,0.24166666666666667
tcf,0,0,0,0,0,1,0,1,0.24166666666666667
cdl-b,0,0,0,0,0,1,0,1,0.24166666666666667
内部空间,1,0,0,0,0,1,0,2,1.2416666666666667
直射,0,0,0,0,0,1,0,1,0.24166666666666667
中径个数,0,0,0,0,0,1,0,1,0.24166666666666667
簇个数,0,0,0,0,0,1,0,1,0.24166666666666667
随机相位旋转因子,0,0,0,0,0,1,0,1,0.24166666666666667
理论空间,0,0,0,0,0,1,0,1,0.24166666666666667
2dmimoota,0,0,0,0,0,1,0,1,0.24166666666666667
探头分布,0,0,0,0,0,1,0,1,0.24166666666666667
区域半径,0,0,0,0,0,1,0,1,0.24166666666666667
仿真参数,0,0,0,0,0,1,0,1,0.24166666666666667
cdl模型,0,0,0,0,0,1,0,1,0.24166666666666667
多簇场景,0,0,0,0,0,1,0,1,0.24166666666666667
空口测试,1,1,0,0,0,0,0,2,3.0
ota信道,1,0,0,0,0,0,0,1,1.0
空时联合相关性,1,0,0,0,0,0,0,1,1.0
空间相关性合成误差,1,0,0,0,0,0,0,1,1.0
动态,1,0,0,0,0,0,0,1,1.0
果精度,1,0,0,0,0,0,0,1,1.0
商业化,1,0,0,0,0,0,0,1,1.0
multi,1,0,0,0,0,0,0,1,1.0
input,1,0,0,0,0,0,0,1,1.0
模mimo技术,1,0,0,0,0,0,0,1,1.0
airtesting,1,0,0,0,0,0,0,1,1.0
otatesting,1,0,0,0,0,0,0,1,1.0
