,摘要,关键词,第一章,第二章,第三章,第四章,第五章,总词频,加权得分
清洁度,1,0,2,0,0,17,2,22,5.841666666666667
fasterr-cnn,1,0,14,11,20,14,2,62,12.825
fasterr,0,0,0,2,4,8,0,14,3.15
cnn,0,0,2,3,2,7,0,14,2.8
性能,1,0,7,2,6,10,2,28,6.475
baseline,0,0,0,0,11,8,0,19,4.591666666666667
rpn,0,0,4,7,0,11,1,23,4.275
数据,0,0,0,0,1,13,0,14,3.3833333333333333
ghmloss,1,0,1,0,0,9,2,13,3.783333333333333
anchor,0,0,3,41,0,44,0,88,16.133333333333333
数据增强,0,1,2,0,0,9,1,13,4.666666666666666
测试集,0,0,1,0,4,3,0,8,1.8166666666666667
缺陷,0,0,0,0,0,16,0,16,3.8666666666666667
不平衡,0,0,0,3,0,4,0,7,1.3416666666666668
样本,0,0,1,8,1,23,0,33,6.925
增强数据,0,0,0,0,0,5,0,5,1.2083333333333333
验证集,0,0,0,0,0,2,0,2,0.48333333333333334
训练集,0,0,0,0,1,3,0,4,0.9666666666666667
x光图像集,0,0,0,0,0,4,0,4,0.9666666666666667
内容维度,1,0,3,4,0,9,2,19,4.533333333333333
小目标检测,3,1,24,8,4,3,6,49,12.141666666666666
内容,1,0,1,1,0,4,1,8,2.458333333333333
优化,0,0,0,0,0,2,0,2,0.48333333333333334
baseline性能,0,0,0,0,1,1,0,2,0.48333333333333334
anchor样本,0,0,0,0,0,4,0,4,0.9666666666666667
rpn训练,0,0,0,0,0,2,0,2,0.48333333333333334
噪声,0,0,1,0,2,8,0,11,2.5416666666666665
rpn网络,1,0,1,5,0,14,0,21,5.133333333333333
hm,0,0,0,0,0,2,0,2,0.48333333333333334
综合优化,0,0,0,0,0,3,0,3,0.725
负面效应,0,0,0,0,0,1,0,1,0.24166666666666667
梯度均衡机制,0,0,1,0,0,5,1,7,1.575
loss,0,0,0,0,0,3,0,3,0.725
检测精度,0,0,7,1,8,3,0,19,3.658333333333333
回归分支,0,0,0,0,0,2,0,2,0.48333333333333334
分类分支,0,0,0,0,0,2,0,2,0.48333333333333334
目标,0,0,3,6,6,5,1,21,4.025
测试,0,0,0,0,2,1,0,3,0.725
map基线,0,0,0,0,1,1,0,2,0.48333333333333334
轮毂,0,0,1,0,0,13,0,14,3.2666666666666666
ap值,0,0,0,0,11,1,0,12,2.9
原始数据集,0,0,0,0,0,1,0,1,0.24166666666666667
学习率,0,0,0,0,2,1,0,3,0.725
学习率衰减,0,0,0,0,2,1,0,3,0.725
习率,0,0,0,0,0,1,0,1,0.24166666666666667
keraso,0,0,0,0,0,1,0,1,0.24166666666666667
深度学习框架,0,0,0,0,2,1,0,3,0.725
图像,0,0,5,13,11,16,1,46,9.016666666666666
数据分布,0,0,0,0,0,1,0,1,0.24166666666666667
增强,0,0,0,0,1,6,1,8,1.9333333333333333
x光图,0,0,0,0,0,1,0,1,0.24166666666666667
采样操,0,0,0,0,0,1,0,1,0.24166666666666667
缺陷等级分布,0,0,0,0,0,1,0,1,0.24166666666666667
图像张数,0,0,0,0,0,1,0,1,0.24166666666666667
分布,0,0,0,1,2,3,0,6,1.3333333333333333
汽车轮毂,0,0,0,0,0,12,0,12,2.9
召回率,0,0,0,1,7,0,0,8,1.8166666666666667
精确率,0,0,0,0,7,0,0,7,1.6916666666666667
iou,0,0,0,5,10,14,0,29,6.425
pr曲线,0,0,0,0,5,0,0,5,1.2083333333333333
候选框,0,0,0,9,5,1,0,15,2.575
precision,0,0,0,0,4,0,0,4,0.9666666666666667
tp,0,0,0,0,4,0,0,4,0.9666666666666667
目标框,0,0,0,1,4,5,0,10,2.3
预测,0,0,0,7,2,0,0,9,1.3583333333333334
检测器,0,0,1,3,2,1,0,7,1.225
置信度,0,0,0,1,2,3,0,6,1.3333333333333333
正样本,0,0,0,4,2,8,0,14,2.9166666666666665
fp,0,0,0,0,2,0,0,2,0.48333333333333334
个数,0,0,0,0,2,0,0,2,0.48333333333333334
voc数据集,0,0,0,0,10,0,0,10,2.4166666666666665
阈值,0,0,0,0,2,1,0,3,0.725
真负例,0,0,0,0,2,0,0,2,0.48333333333333334
假正例,0,0,0,0,2,0,0,2,0.48333333333333334
数据集,2,0,7,0,7,20,3,39,10.125
平均,0,0,0,0,3,0,0,3,0.725
meanaverageprecision,0,0,0,0,1,0,0,1,0.24166666666666667
插值,0,0,0,0,1,0,0,1,0.24166666666666667
面积,0,0,2,2,4,1,0,9,1.7083333333333333
p-r值,0,0,0,0,1,0,0,1,0.24166666666666667
将置信,0,0,0,0,1,0,0,1,0.24166666666666667
p-r,0,0,0,0,1,0,0,1,0.24166666666666667
纵坐标,0,0,0,0,1,0,0,1,0.24166666666666667
横坐标,0,0,0,0,1,0,0,1,0.24166666666666667
recall,0,0,0,0,1,0,0,1,0.24166666666666667
fn,0,0,0,0,1,0,0,1,0.24166666666666667
漏检,0,0,0,1,1,0,0,2,0.3666666666666667
假负例,0,0,0,0,1,0,0,1,0.24166666666666667
tn,0,0,0,0,1,0,0,1,0.24166666666666667
俞框,0,0,0,0,1,0,0,1,0.24166666666666667
iou阈值,0,0,0,0,2,0,0,2,0.48333333333333334
coco数据集,0,0,0,0,9,4,0,13,3.1416666666666666
negatives,0,0,0,0,1,0,0,1,0.24166666666666667
负例,0,0,0,0,1,0,0,1,0.24166666666666667
truenegative,0,0,0,0,1,0,0,1,0.24166666666666667
falsepositive,0,0,0,0,1,0,0,1,0.24166666666666667
性质,0,0,0,0,1,0,0,1,0.24166666666666667
iou值,0,0,0,0,1,1,0,2,0.48333333333333334
相关度,0,0,0,0,1,0,0,1,0.24166666666666667
并集,0,0,0,0,1,0,0,1,0.24166666666666667
交集,0,0,0,0,1,0,0,1,0.24166666666666667
groundtruth,0,0,0,6,1,7,0,14,2.6833333333333336
candidatebound,0,0,0,0,1,0,0,1,0.24166666666666667
交并,0,0,0,0,1,0,0,1,0.24166666666666667
union,0,0,0,0,1,0,0,1,0.24166666666666667
intersection,0,0,0,0,1,0,0,1,0.24166666666666667
汽车,0,0,1,0,0,8,0,9,2.0583333333333336
数据增强策略,0,0,0,0,0,3,0,3,0.725
缺陷位置检测,0,0,0,0,0,1,0,1,0.24166666666666667
x光图像,0,0,0,0,0,12,0,12,2.9
x光数据集,0,0,1,0,0,9,0,10,2.3
实例,0,0,0,0,0,1,0,1,0.24166666666666667
掩膜,1,0,2,0,0,10,2,15,4.15
小目标,2,0,8,0,1,7,4,22,5.9
数据扩充,0,0,0,0,0,1,0,1,0.24166666666666667
拟合,0,0,0,0,0,1,0,1,0.24166666666666667
模型,0,0,1,2,3,10,0,16,3.5166666666666666
检测任务,0,0,0,0,1,1,0,2,0.48333333333333334
分类,0,0,2,3,0,6,0,11,2.075
目标检测,2,0,9,10,3,3,0,27,5.825
图像分类任务,0,0,0,0,0,1,0,1,0.24166666666666667
对比度增强,0,0,0,0,0,1,0,1,0.24166666666666667
镜像,0,0,0,0,0,1,0,1,0.24166666666666667
平移,0,0,0,0,1,1,0,2,0.48333333333333334
重采样,0,0,0,0,0,2,0,2,0.48333333333333334
数据增强技术,0,0,0,0,0,1,0,1,0.24166666666666667
fsfm,0,0,0,0,23,0,0,23,5.558333333333334
特征尺度增强模块,1,0,1,0,6,0,2,10,3.0583333333333336
小目标检测算法,0,0,5,1,2,0,0,8,1.2333333333333334
特征尺度,3,0,5,5,10,4,2,29,8.116666666666667
fsem,0,0,0,0,11,0,0,11,2.658333333333333
无用信息,0,0,0,0,1,0,0,1,0.24166666666666667
有用信息,0,0,0,0,1,0,0,1,0.24166666666666667
通道注意力增强模块,0,0,0,0,2,0,0,2,0.48333333333333334
感受野,0,0,1,0,9,0,0,10,2.3
多尺度感受野模块,0,0,0,0,1,0,0,1,0.24166666666666667
训练样本,1,0,1,0,0,2,1,5,1.85
检测性能,2,0,5,0,2,2,1,12,3.833333333333333
数据量,0,0,0,0,0,1,0,1,0.24166666666666667
特征尺度优,0,0,0,0,1,1,0,2,0.48333333333333334
缺陷等级,0,0,0,0,0,1,0,1,0.24166666666666667
内容维度优化,0,0,0,0,0,2,0,2,0.48333333333333334
特征尺度优化,0,0,0,0,2,2,0,4,0.9666666666666667
长颈鹿,0,0,0,0,0,3,0,3,0.725
负样本,0,0,0,4,0,6,0,10,1.95
参数,0,0,1,5,5,2,0,13,2.4416666666666664
分类标签,0,0,0,0,0,2,0,2,0.48333333333333334
判断,0,0,0,0,0,1,0,1,0.24166666666666667
模型更新,0,0,0,0,0,1,0,1,0.24166666666666667
参数更新,0,0,0,0,0,1,0,1,0.24166666666666667
梯度,0,0,0,1,3,5,0,9,2.0583333333333336
模型训练,0,0,0,0,0,3,0,3,0.725
本质影响,0,0,0,0,0,1,0,1,0.24166666666666667
检测算法,0,0,11,5,1,1,2,20,2.966666666666667
正负样本数,0,0,0,0,0,1,0,1,0.24166666666666667
多媒体实验室,0,0,0,0,0,1,0,1,0.24166666666666667
待检测目标,0,0,0,0,0,1,0,1,0.24166666666666667
尺寸,0,0,4,6,8,1,0,19,3.425
特征提取网络,0,0,3,4,0,1,0,8,1.1166666666666667
vgg-16,0,0,0,5,17,1,0,23,4.975
or,0,0,0,1,0,1,0,2,0.3666666666666667
困难样本,1,0,2,6,0,3,1,13,2.966666666666667
简单样本,1,0,1,3,0,3,1,9,2.466666666666667
正负样本,1,0,2,6,0,3,1,13,2.966666666666667
nchor样本,0,0,0,0,0,1,0,1,0.24166666666666667
anchor类别,0,0,0,0,0,1,0,1,0.24166666666666667
focalloss,0,0,1,7,0,2,0,10,1.4833333333333334
ohem,0,0,0,0,0,1,0,1,0.24166666666666667
样本噪声,0,0,0,0,0,1,0,1,0.24166666666666667
标签,0,0,0,2,0,4,0,6,1.2166666666666668
正负样本集合,0,0,0,0,0,1,0,1,0.24166666666666667
外观,0,0,0,0,0,1,0,1,0.24166666666666667
笔记本电脑,0,0,0,0,0,1,0,1,0.24166666666666667
绿色汽车,0,0,0,0,0,1,0,1,0.24166666666666667
卡车,0,0,0,0,0,1,0,1,0.24166666666666667
背景噪声,0,0,0,0,0,1,0,1,0.24166666666666667
不规则,0,0,0,0,0,1,0,1,0.24166666666666667
ve,0,0,0,0,0,1,0,1,0.24166666666666667
negative,0,0,0,0,0,1,0,1,0.24166666666666667
卡阈值,0,0,0,0,0,1,0,1,0.24166666666666667
roundtrutli,0,0,0,0,0,1,0,1,0.24166666666666667
分布不平衡,0,0,0,0,0,1,0,1,0.24166666666666667
nchor噪声,0,0,0,0,0,1,0,1,0.24166666666666667
1a,0,0,0,0,0,1,0,1,0.24166666666666667
特征图,1,0,7,15,20,1,3,47,9.55
特征,1,0,7,7,12,0,2,29,6.133333333333333
卷积神经网络,0,0,4,1,0,0,2,7,1.1083333333333334
目标检测算法,0,0,9,3,2,1,2,17,2.708333333333333
小目标检测性能,0,0,2,1,1,2,1,7,1.3416666666666668
目标实例,1,0,1,0,0,0,0,2,1.125
小目标实例增强策,1,0,1,0,0,0,0,2,1.125
增强策略,1,0,1,0,0,8,1,11,3.3
旋转,1,0,2,0,1,3,0,7,2.216666666666667
增强算法,1,0,2,0,0,1,1,5,1.7333333333333334
小目标数据,1,0,2,0,0,0,1,4,1.4916666666666667
损失函数,1,0,3,5,1,3,1,14,3.208333333333333
hmloss,0,0,1,0,0,0,0,1,0.125
echanism,0,0,1,0,0,0,0,1,0.125
gradientharmonize,0,0,1,0,0,0,0,1,0.125
梯度协调机制,0,0,1,0,0,0,0,1,0.125
卷积网络,1,0,2,2,0,0,1,6,1.7416666666666667
语义信息,0,0,2,0,5,0,1,8,1.7
细节信息,0,0,1,0,0,0,1,2,0.3666666666666667
通道注意力,1,0,1,0,1,0,1,4,1.6083333333333334
多尺度感受野,1,0,1,0,2,0,1,5,1.85
超像素卷积,1,0,1,0,10,0,1,13,3.783333333333333
尺度特征层,1,0,1,0,0,0,1,3,1.3666666666666667
通道数,1,0,1,0,9,0,1,12,3.5416666666666665
特征尺度融合模块,1,0,1,0,6,0,2,10,3.0583333333333336
特征信息,0,0,3,0,0,0,1,4,0.6166666666666667
基础模型,0,0,1,0,0,0,0,1,0.125
精度,0,0,3,2,2,1,0,8,1.35
速度,0,0,2,5,1,1,0,9,1.3583333333333334
复现,0,0,1,0,0,0,0,1,0.125
目标检测模型,0,0,1,1,0,0,0,2,0.25
尺度维度,0,0,1,4,0,0,1,6,0.8666666666666667
深度学习,1,0,8,4,0,0,2,15,2.9833333333333334
小目标实例,0,0,0,0,0,4,0,4,0.9666666666666667
网球掩膜,0,0,0,0,0,1,0,1,0.24166666666666667
图像边界,0,0,0,0,0,1,0,1,0.24166666666666667
小目标掩膜,0,0,0,0,0,1,0,1,0.24166666666666667
图像失真,0,0,0,0,0,1,0,1,0.24166666666666667
续目标,0,0,0,0,0,1,0,1,0.24166666666666667
复制,0,0,0,0,0,1,0,1,0.24166666666666667
掩膜信息,0,0,0,0,0,3,0,3,0.725
标注信息,0,0,0,0,0,1,0,1,0.24166666666666667
概率,0,0,0,2,0,4,0,6,1.2166666666666668
anch,0,0,0,0,0,1,0,1,0.24166666666666667
anchor数量,0,0,0,0,0,1,0,1,0.24166666666666667
信息,0,0,0,1,3,1,0,5,1.0916666666666668
mask,0,0,0,0,0,1,0,1,0.24166666666666667
目标掩膜,0,0,0,0,0,1,0,1,0.24166666666666667
非目标背景内容,0,0,0,0,0,1,0,1,0.24166666666666667
检测,0,0,3,7,5,3,0,18,3.1833333333333336
候选区域,0,0,4,6,0,0,0,10,1.25
池化层,0,0,0,5,3,0,0,8,1.35
卷积层,0,0,3,7,4,0,0,14,2.216666666666667
全连接层,0,0,0,3,1,0,0,4,0.6166666666666667
维度,0,0,0,3,1,0,0,4,0.6166666666666667
激活层,0,0,0,3,0,0,0,3,0.375
同变性,0,0,0,3,0,0,0,3,0.375
不变形,0,0,0,3,0,0,0,3,0.375
边框回归损失,0,0,0,2,0,0,0,2,0.25
区域,0,0,0,2,0,0,0,2,0.25
roi池化层,0,0,0,2,0,0,0,2,0.25
roi池化,0,0,0,2,0,0,0,2,0.25
分类回归层,0,0,0,2,0,0,0,2,0.25
边界框,0,0,0,4,0,1,0,5,0.7416666666666667
背景,0,0,0,2,0,1,0,3,0.4916666666666667
坐标,0,0,0,2,0,12,0,14,3.15
mxn,0,0,0,2,0,0,0,2,0.25
网络,0,0,3,3,2,0,0,8,1.2333333333333334
fasterr-cnn网络,0,0,0,1,0,0,0,1,0.125
hl,0,0,0,1,0,0,0,1,0.125
sm,0,0,0,1,0,0,0,1,0.125
分类损失,0,0,0,1,0,2,0,3,0.6083333333333334
多任务损失,0,0,0,1,0,0,0,1,0.125
全连接,0,0,0,2,0,0,0,2,0.25
分类回归结果,0,0,0,1,0,0,0,1,0.125
回归结果,0,0,0,1,0,0,0,1,0.125
卷积,0,0,1,3,9,0,0,13,2.675
并行分支,0,0,2,1,1,0,0,4,0.6166666666666667
偏移量,0,0,0,1,0,0,0,1,0.125
分类置信度,0,0,0,1,0,3,0,4,0.85
多任务分类,0,0,0,1,0,0,0,1,0.125
特征向量,0,0,0,1,3,0,0,4,0.85
区域维度,0,0,0,1,0,0,0,1,0.125
特征映射,0,0,0,1,1,0,0,2,0.3666666666666667
矩形,0,0,0,1,0,0,0,1,0.125
子区域,0,0,0,1,0,0,0,1,0.125
数量,0,0,0,1,0,0,0,1,0.125
候选识别区域,0,0,0,1,0,0,0,1,0.125
spp-net,0,0,3,1,0,0,0,4,0.5
神经元,0,0,0,1,0,0,0,1,0.125
回归层,0,0,0,1,0,0,0,1,0.125
regionofinterest,0,0,0,1,0,0,0,1,0.125
roi,0,0,0,1,0,0,0,1,0.125
回归损失,0,0,0,1,0,0,0,1,0.125
smoothl1损失,0,0,0,1,0,0,0,1,0.125
交叉爛损失,0,0,0,2,0,0,0,2,0.25
损失,0,0,1,5,0,5,0,11,1.9583333333333333
坐标回归系数,0,0,0,1,0,0,0,1,0.125
物体,0,0,1,4,7,0,0,12,2.3166666666666664
xwx4,0,0,0,1,0,0,0,1,0.125
xwx2k,0,0,0,1,0,0,0,1,0.125
张量,0,0,0,1,1,0,0,2,0.3666666666666667
分支,0,0,0,3,1,0,0,4,0.6166666666666667
边界框回归,0,0,0,1,0,0,0,1,0.125
置信度预测,0,0,0,1,0,0,0,1,0.125
检测框,0,0,0,1,0,0,0,1,0.125
锚框,0,0,1,1,0,0,0,2,0.25
ofasterr-cnn,0,0,0,1,0,0,0,1,0.125
图像处理,0,0,1,1,0,0,0,2,0.25
vgg-16网络,0,0,0,1,0,0,0,1,0.125
长宽,0,0,0,1,0,0,0,1,0.125
计算量,0,0,1,2,9,0,0,12,2.55
池化核,0,0,0,1,0,0,0,1,0.125
池化,0,0,0,2,5,0,0,7,1.4583333333333333
表达能力,0,0,0,1,1,0,0,2,0.3666666666666667
非线性激活函数,0,0,0,1,0,0,0,1,0.125
卷积结果,0,0,0,1,0,0,0,1,0.125
激活操作,0,0,0,1,0,0,0,1,0.125
局部特征,0,0,0,1,0,0,0,1,0.125
局部,0,0,0,1,0,0,0,1,0.125
卷积核,0,0,0,3,8,0,0,11,2.3083333333333336
卷积操作,0,0,0,1,1,0,0,2,0.3666666666666667
定位,0,0,1,1,1,0,0,3,0.4916666666666667
尺度,0,0,3,5,0,0,0,8,1.0
定位问题,0,0,0,1,0,0,0,1,0.125
高层语义信息,1,0,0,1,1,0,0,3,1.3666666666666667
属性,0,0,0,1,0,0,0,1,0.125
图像特征,0,0,0,1,0,0,0,1,0.125
质量,2,0,0,1,0,1,0,4,2.3666666666666667
综合性能,0,0,0,1,0,0,0,1,0.125
分类回归,0,0,0,1,0,0,0,1,0.125
特征提取,0,0,0,3,0,0,0,3,0.375
端到端,0,0,1,1,0,2,0,4,0.7333333333333334
深度学习技术,0,0,0,1,0,1,0,2,0.3666666666666667
fastr-cnn,0,0,3,1,0,0,0,4,0.5
r-cnn,0,0,6,1,0,0,0,7,0.875
cnn算法,0,0,0,1,0,0,0,1,0.125
训练数据集,0,0,1,0,0,4,0,5,1.0916666666666668
loss优化,0,0,0,0,0,1,0,1,0.24166666666666667
anchor样本分布,0,0,0,0,0,1,0,1,0.24166666666666667
小目标内容信息,0,0,2,0,0,0,0,2,0.25
图像比,0,0,2,0,4,0,0,6,1.2166666666666668
像素,0,0,3,0,3,0,0,6,1.1
计算机视觉,0,0,3,1,0,1,0,5,0.7416666666666667
安全救援,0,0,1,0,0,0,0,1,0.125
交通,0,0,1,0,0,0,1,2,0.3666666666666667
通信,0,0,1,0,0,0,1,2,0.3666666666666667
图像信息,0,0,1,0,0,0,0,1,0.125
无人机摄像头,0,0,1,0,0,0,1,2,0.3666666666666667
图像捕获设备,0,0,1,0,0,0,1,2,0.3666666666666667
通信基站摄像机,0,0,1,0,0,0,1,2,0.3666666666666667
医疗影像,0,0,2,0,0,0,1,3,0.4916666666666667
工业,0,0,1,0,0,0,1,2,0.3666666666666667
x光探测,0,0,1,0,0,0,1,2,0.3666666666666667
通图像,0,0,1,0,0,0,1,2,0.3666666666666667
高级计算机视觉任务,0,0,1,0,0,0,1,2,0.3666666666666667
目标识别,0,0,1,0,0,0,1,2,0.3666666666666667
图像语义理解,0,0,1,0,0,0,1,2,0.3666666666666667
性能极差,0,0,1,0,0,0,0,1,0.125
网络模型,0,0,1,0,2,0,1,4,0.85
回空间,0,0,1,0,0,0,0,1,0.125
检测效果,0,0,1,1,0,0,0,2,0.25
采样倍数,0,0,1,0,0,0,0,1,0.125
采样倍率,0,0,1,0,0,0,0,1,0.125
网络速度,0,0,1,0,0,0,0,1,0.125
卷积特征,0,0,1,0,0,0,0,1,0.125
多层,0,0,1,0,0,0,0,1,0.125
灰度信息,0,0,1,0,0,0,0,1,0.125
边缘信息,0,0,1,0,0,0,0,1,0.125
小目标特征信息,0,0,1,0,0,0,0,1,0.125
mscocor,0,0,1,0,0,0,0,1,0.125
son,0,0,1,0,0,0,0,1,0.125
city,0,0,1,0,0,0,0,1,0.125
空间,0,0,1,1,1,0,0,3,0.4916666666666667
病灶检测,0,0,1,0,0,0,0,1,0.125
医学影像,0,0,1,0,0,0,0,1,0.125
障碍物检测,0,0,1,0,0,0,0,1,0.125
车载摄像机,0,0,1,0,0,0,0,1,0.125
道路,0,0,1,0,0,0,0,1,0.125
卫星图像,0,0,1,0,0,0,0,1,0.125
飞机航拍,0,0,1,0,0,0,0,1,0.125
人脸,0,0,1,0,0,0,0,1,0.125
自动定位,0,0,1,0,0,0,0,1,0.125
数码相机,0,0,1,0,0,0,0,1,0.125
机器人导航,0,0,1,0,0,0,0,1,0.125
智能视频监控,0,0,1,0,0,0,0,1,0.125
目标检测技术,0,0,2,0,0,0,0,2,0.25
智能监控系统,0,0,1,0,0,0,0,1,0.125
计算机视觉学科,0,0,1,0,0,0,0,1,0.125
人力,0,0,1,0,0,0,0,1,0.125
计算机视觉技术,0,0,1,0,0,0,0,1,0.125
图像分割,0,0,1,0,0,0,0,1,0.125
图像分类,0,0,2,0,0,0,0,2,0.25
视觉识别,0,0,1,0,0,0,0,1,0.125
神经网络,0,0,1,1,1,0,0,3,0.4916666666666667
数据增强算法,0,0,0,0,0,1,0,1,0.24166666666666667
ss,0,0,0,0,0,2,0,2,0.48333333333333334
空间不平衡,0,0,0,1,0,1,0,2,0.3666666666666667
初始化,0,0,0,0,0,4,0,4,0.9666666666666667
梯度模长,0,0,0,0,0,4,0,4,0.9666666666666667
样本数量,0,0,0,0,0,3,0,3,0.725
梯度优化,0,0,0,0,0,3,0,3,0.725
取值,0,0,0,0,0,2,0,2,0.48333333333333334
密度,0,0,0,0,0,2,0,2,0.48333333333333334
梯度密度,0,0,0,0,0,2,0,2,0.48333333333333334
模型参数,0,0,0,0,0,2,0,2,0.48333333333333334
离群样本,0,0,0,0,0,2,0,2,0.48333333333333334
样本梯度,0,0,0,0,0,2,0,2,0.48333333333333334
ces,0,0,0,0,0,3,0,3,0.725
in,0,0,0,0,0,3,0,3,0.725
降序排列,0,0,0,0,0,2,0,2,0.48333333333333334
args,0,0,0,0,0,1,0,1,0.24166666666666667
indices,0,0,0,0,0,1,0,1,0.24166666666666667
forgtegt,0,0,0,0,0,2,0,2,0.48333333333333334
最优初始化,0,0,0,0,0,1,0,1,0.24166666666666667
回归,0,0,1,2,0,5,0,8,1.5833333333333333
本集,0,0,0,0,0,2,0,2,0.48333333333333334
调节因子,0,0,0,0,0,2,0,2,0.48333333333333334
回归精度,0,0,0,0,0,3,0,3,0.725
tzanchor,0,0,0,0,0,1,0,1,0.24166666666666667
clsjcz,0,0,0,0,0,1,0,1,0.24166666666666667
anchor集,0,0,0,0,0,1,0,1,0.24166666666666667
oc,0,0,0,0,0,1,0,1,0.24166666666666667
综合优化算法,0,0,0,0,0,1,0,1,0.24166666666666667
算法,0,0,1,1,0,1,0,3,0.4916666666666667
洁度,0,0,0,0,0,1,0,1,0.24166666666666667
bias,0,0,0,0,0,1,0,1,0.24166666666666667
mc,0,0,0,0,0,1,0,1,0.24166666666666667
np,0,0,0,0,0,1,0,1,0.24166666666666667
导数,0,0,0,0,0,1,0,1,0.24166666666666667
正负损失,0,0,0,0,0,1,0,1,0.24166666666666667
防损失,0,0,0,0,0,1,0,1,0.24166666666666667
预测概率值,0,0,0,0,0,1,0,1,0.24166666666666667
样本量,0,0,0,0,0,1,0,1,0.24166666666666667
ghm,0,0,0,0,0,1,0,1,0.24166666666666667
gradientdensityharmonizingparameter,0,0,0,0,0,1,0,1,0.24166666666666667
梯度密度协调参数,0,0,0,0,0,1,0,1,0.24166666666666667
梯度密度函数,0,0,0,0,0,1,0,1,0.24166666666666667
se,0,0,0,0,1,1,0,2,0.48333333333333334
other,0,0,0,0,0,1,0,1,0.24166666666666667
样本总量,0,0,0,0,0,1,0,1,0.24166666666666667
batch,0,0,0,0,0,1,0,1,0.24166666666666667
长度,0,0,0,0,1,1,0,2,0.48333333333333334
unitregion,0,0,0,0,0,1,0,1,0.24166666666666667
单位区域,0,0,0,0,0,1,0,1,0.24166666666666667
体积,0,0,0,0,0,1,0,1,0.24166666666666667
gradientdensity,0,0,0,0,0,1,0,1,0.24166666666666667
ghm损失函数,0,0,0,0,0,1,0,1,0.24166666666666667
重构损失函数,0,0,0,0,0,1,0,1,0.24166666666666667
权重,0,0,0,9,7,1,0,17,3.0583333333333336
贡献量,0,0,0,0,0,1,0,1,0.24166666666666667
加权,0,0,0,0,0,1,0,1,0.24166666666666667
梯度均衡,0,0,0,0,0,1,0,1,0.24166666666666667
标准,0,0,0,0,0,1,0,1,0.24166666666666667
模长,0,0,0,0,0,1,0,1,0.24166666666666667
outlier,0,0,0,0,0,1,0,1,0.24166666666666667
样本比,0,0,0,0,0,1,0,1,0.24166666666666667
检测模型,0,0,0,2,1,1,0,4,0.7333333333333334
分类概率,0,0,0,0,0,2,0,2,0.48333333333333334
cross-entropy,0,0,0,0,0,1,0,1,0.24166666666666667
梯度信息,0,0,0,0,0,1,0,1,0.24166666666666667
梯度幅值,0,0,0,0,0,1,0,1,0.24166666666666667
样本分布,0,0,0,0,0,1,0,1,0.24166666666666667
样本过度,0,0,0,0,0,1,0,1,0.24166666666666667
超参数,0,0,0,0,0,2,0,2,0.48333333333333334
单样本,0,0,0,0,0,1,0,1,0.24166666666666667
3ghmloss,0,0,0,0,0,1,0,1,0.24166666666666667
骨干网络,0,0,0,0,9,0,0,9,2.175
resnet-101,0,0,0,0,5,0,0,5,1.2083333333333333
vgg,0,0,0,0,6,0,0,6,1.45
单步检测算法,0,0,0,0,3,0,0,3,0.725
101,0,0,0,0,2,0,0,2,0.48333333333333334
resnet,0,0,0,0,2,0,0,2,0.48333333333333334
时间消耗,0,0,0,0,2,0,0,2,0.48333333333333334
时间,0,0,0,0,2,0,0,2,0.48333333333333334
验证图像,0,0,0,0,2,0,0,2,0.48333333333333334
训练图像,0,0,0,0,2,0,0,2,0.48333333333333334
refinedet,0,0,0,0,1,0,0,1,0.24166666666666667
两步检测算法,0,0,2,0,1,0,0,3,0.4916666666666667
检测速度,0,0,5,0,4,0,0,9,1.5916666666666668
时间花销,0,0,0,0,1,0,0,1,0.24166666666666667
实时目标检测,0,0,0,0,1,0,0,1,0.24166666666666667
时长,0,0,0,0,1,0,0,1,0.24166666666666667
特征处理能力,0,0,0,0,1,0,0,1,0.24166666666666667
残差,0,0,0,2,1,0,0,3,0.4916666666666667
fasterr-cnn算法,0,0,0,0,2,0,0,2,0.48333333333333334
步长,0,0,0,0,4,0,0,4,0.9666666666666667
处理时间,0,0,0,0,1,0,0,1,0.24166666666666667
sfm,0,0,0,0,1,0,0,1,0.24166666666666667
嵌入,0,0,0,0,1,0,0,1,0.24166666666666667
300,0,0,0,0,1,0,0,1,0.24166666666666667
ssd,0,0,0,0,1,0,0,1,0.24166666666666667
de,0,0,0,0,1,0,0,1,0.24166666666666667
fi,0,0,0,0,1,0,0,1,0.24166666666666667
dssd-300,0,0,0,0,1,0,0,1,0.24166666666666667
densenet,0,0,0,0,1,0,0,1,0.24166666666666667
dn,0,0,0,0,1,0,0,1,0.24166666666666667
r-fcn,0,0,1,0,1,0,0,2,0.3666666666666667
backbone,0,0,0,0,2,0,0,2,0.48333333333333334
最优网络,0,0,0,0,2,0,0,2,0.48333333333333334
参数初始化,0,0,0,0,1,0,0,1,0.24166666666666667
最优权重,0,0,0,0,1,0,0,1,0.24166666666666667
sem,0,0,0,0,1,0,0,1,0.24166666666666667
初始学习率,0,0,0,0,2,0,0,2,0.48333333333333334
era,0,0,0,0,2,0,0,2,0.48333333333333334
实验平台,0,0,0,0,1,0,0,1,0.24166666666666667
inval35,0,0,0,0,1,0,0,1,0.24166666666666667
测量标准,0,0,0,0,1,0,0,1,0.24166666666666667
trainval35,0,0,0,0,1,0,0,1,0.24166666666666667
测试图像,0,0,0,0,1,0,0,1,0.24166666666666667
目标检测任务,0,0,0,1,1,0,0,2,0.3666666666666667
目标图片,0,0,0,0,1,0,0,1,0.24166666666666667
自然图片,0,0,0,0,1,0,0,1,0.24166666666666667
pascalvoc数据集,0,0,0,0,1,0,0,1,0.24166666666666667
cocodataset,0,0,0,0,1,0,0,1,0.24166666666666667
公开学术数据集,0,0,0,0,2,0,0,2,0.48333333333333334
mscoco数据集,0,0,0,0,2,0,0,2,0.48333333333333334
3coco数据集,0,0,0,0,1,0,0,1,0.24166666666666667
清洁度指标,0,0,0,0,0,3,0,3,0.725
apos,0,0,0,0,0,2,0,2,0.48333333333333334
anchor回归,0,0,0,0,0,1,0,1,0.24166666666666667
清洁度评分,0,0,0,0,0,1,0,1,0.24166666666666667
forbi,0,0,0,0,0,1,0,1,0.24166666666666667
aposu,0,0,0,0,0,1,0,1,0.24166666666666667
apos-,0,0,0,0,0,1,0,1,0.24166666666666667
bzanchor,0,0,0,0,0,1,0,1,0.24166666666666667
aneg,0,0,0,0,0,1,0,1,0.24166666666666667
分数,0,0,0,0,0,1,0,1,0.24166666666666667
zoe,0,0,0,0,0,1,0,1,0.24166666666666667
连续性,0,0,0,0,0,1,0,1,0.24166666666666667
噪声水平,0,0,0,0,0,1,0,1,0.24166666666666667
人工经验,0,0,0,0,0,1,0,1,0.24166666666666667
自适应,0,0,0,0,0,1,0,1,0.24166666666666667
anchor分类标签,0,0,0,0,0,1,0,1,0.24166666666666667
交叉矯损失,0,0,0,2,0,1,0,3,0.4916666666666667
空洞卷积,0,0,0,0,12,0,0,12,2.9
空洞率,0,0,1,0,5,0,0,6,1.3333333333333333
普通卷积,0,0,0,0,3,0,0,3,0.725
像素点,0,0,0,0,3,0,0,3,0.725
指数,0,0,0,0,2,0,0,2,0.48333333333333334
红点,0,0,0,0,2,0,0,2,0.48333333333333334
卷积层数,0,0,0,0,2,0,0,2,0.48333333333333334
感受,0,0,0,0,2,0,0,2,0.48333333333333334
常规卷积,0,0,0,0,2,0,0,2,0.48333333333333334
像素数,0,0,0,0,2,0,0,2,0.48333333333333334
数层,0,0,0,0,2,0,0,2,0.48333333333333334
多尺度感受野增强模块,0,0,0,0,1,0,0,1,0.24166666666666667
受野信息,0,0,0,0,1,0,0,1,0.24166666666666667
多尺度感,0,0,0,0,1,0,0,1,0.24166666666666667
通道像素,0,0,0,0,1,0,0,1,0.24166666666666667
卷积核参数,0,0,0,0,2,0,0,2,0.48333333333333334
指数级,0,0,0,0,1,0,0,1,0.24166666666666667
洞卷积,0,0,0,0,1,0,0,1,0.24166666666666667
通道,0,0,0,0,8,0,0,8,1.9333333333333333
多尺度感受,0,0,0,0,1,0,0,1,0.24166666666666667
并行三分支架构,0,0,0,0,1,0,0,1,0.24166666666666667
泛化,0,0,0,0,1,0,0,1,0.24166666666666667
滤波功能,0,0,0,0,1,0,0,1,0.24166666666666667
深色区域,0,0,0,0,1,0,0,1,0.24166666666666667
f2,0,0,0,0,1,0,0,1,0.24166666666666667
正常,0,0,0,0,1,0,0,1,0.24166666666666667
野增长,0,0,0,0,1,0,0,1,0.24166666666666667
空洞卷积感受,0,0,0,0,1,0,0,1,0.24166666666666667
线性,0,0,0,0,1,0,0,1,0.24166666666666667
三层卷积,0,0,0,0,1,0,0,1,0.24166666666666667
3x3卷积,0,0,0,0,1,0,0,1,0.24166666666666667
感受野大小,0,0,0,0,1,0,0,1,0.24166666666666667
不丢失分辨率,0,0,0,0,1,0,0,1,0.24166666666666667
指数级扩张,0,0,0,0,1,0,0,1,0.24166666666666667
特征增强,0,0,0,0,2,0,0,2,0.48333333333333334
语义,0,0,2,2,1,0,0,5,0.7416666666666667
anchor函数,0,0,0,9,0,0,0,9,1.125
metaanchor,0,0,0,5,0,0,0,5,0.625
调制系数,0,0,0,4,0,0,0,4,0.5
生成器,0,0,0,2,0,0,0,2,0.25
anchor尺寸,0,0,0,5,0,0,0,5,0.625
先验框,0,0,1,3,0,0,0,4,0.5
anchor机制,0,0,0,3,0,0,0,3,0.375
函数,0,0,0,2,0,0,0,2,0.25
迁移,0,0,0,1,0,0,1,2,0.3666666666666667
边界框分布,0,0,0,1,0,0,0,1,0.125
目标检测系统,0,0,0,1,0,0,0,1,0.125
权重预测,0,0,0,1,0,0,0,1,0.125
标准锚点框,0,0,0,1,0,0,0,1,0.125
昭丽,0,0,0,1,0,0,0,1,0.125
向量,0,0,0,1,0,0,0,1,0.125
位置,0,0,0,2,1,0,0,3,0.4916666666666667
编码,0,0,0,1,0,0,0,1,0.125
方程,0,0,0,1,0,0,0,1,0.125
子空间,0,0,0,1,0,0,0,1,0.125
维数,0,0,0,1,0,0,0,1,0.125
隐藏神经元,0,0,0,1,0,0,0,1,0.125
激活函数,0,0,0,1,3,0,0,4,0.85
必和购,0,0,0,1,0,0,0,1,0.125
二层神经网络,0,0,0,1,0,0,0,1,0.125
共享参数,0,0,0,1,0,0,0,1,0.125
学习,0,0,0,1,0,0,0,1,0.125
函数建模,0,0,0,1,0,0,0,1,0.125
anchor函数生成器,0,0,0,1,0,0,0,1,0.125
边界,0,0,1,1,0,1,0,3,0.4916666666666667
metaanchor函数,0,0,0,1,0,0,0,1,0.125
先验,0,0,0,1,0,0,0,1,0.125
an,0,0,0,1,0,0,0,1,0.125
bigb,0,0,0,1,0,0,0,1,0.125
对象,0,0,0,1,0,0,0,1,0.125
区间,0,0,0,1,0,0,0,1,0.125
离散区间,0,0,0,1,0,0,0,1,0.125
框空间,0,0,0,1,0,0,0,1,0.125
metaanchoroanchor,0,0,0,1,0,0,0,1,0.125
m^eanchor,0,0,0,1,0,0,0,1,0.125
focusingparameter,0,0,0,1,0,0,0,1,0.125
聚焦参数,0,0,0,1,0,0,0,1,0.125
alloss,0,0,0,1,0,0,0,1,0.125
权重因子,0,0,0,1,0,0,0,1,0.125
标准交叉,0,0,0,1,0,0,0,1,0.125
共享权重,0,0,0,1,0,0,0,1,0.125
频次,0,0,0,1,0,0,0,1,0.125
potherwise,0,0,0,1,0,0,0,1,0.125
真实样本,0,0,0,1,0,0,0,1,0.125
crossentropy,0,0,0,1,0,0,0,1,0.125
交叉燔,0,0,0,1,0,0,0,1,0.125
二分类,0,0,0,1,0,0,0,1,0.125
ohem算法,0,0,0,1,0,0,0,1,0.125
输出概率,0,0,0,1,0,0,0,1,0.125
hardexample,0,0,0,1,0,0,0,1,0.125
难分样本挖掘,0,0,0,1,0,0,0,1,0.125
在线,0,0,0,1,0,0,0,1,0.125
类别,0,0,0,1,0,0,0,1,0.125
mateanchor,0,0,1,1,0,0,0,2,0.25
空间不,0,0,0,1,0,0,0,1,0.125
极度不平衡,0,0,0,1,0,0,0,1,0.125
内容维,0,0,0,1,0,0,0,1,0.125
网络训练,0,0,0,0,0,1,0,1,0.24166666666666667
fasterr-cnn检测算法,0,0,0,0,0,1,0,1,0.24166666666666667
brain,0,0,0,0,0,3,0,3,0.725
角度,0,0,0,0,0,2,0,2,0.48333333333333334
策略,0,0,0,0,0,2,0,2,0.48333333333333334
数据增强运算,0,0,0,0,0,2,0,2,0.48333333333333334
小目标数据集,0,0,0,0,0,2,0,2,0.48333333333333334
中心坐标,0,0,0,0,0,1,0,1,0.24166666666666667
目标框坐标,0,0,0,0,0,1,0,1,0.24166666666666667
注释文件,0,0,0,0,0,4,0,4,0.9666666666666667
水平矩形,0,0,0,0,0,2,0,2,0.48333333333333334
增强策,0,0,0,0,0,1,0,1,0.24166666666666667
识别性能,0,0,0,0,0,1,0,1,0.24166666666666667
小目标定位,0,0,0,0,0,1,0,1,0.24166666666666667
目标旋转策略,0,0,0,0,0,1,0,1,0.24166666666666667
最优数据,0,0,0,0,0,1,0,1,0.24166666666666667
搜索空间,0,0,0,0,0,1,0,1,0.24166666666666667
离散化,0,0,0,0,0,1,0,1,0.24166666666666667
强度,0,0,0,0,0,1,0,1,0.24166666666666667
运算,0,0,0,0,0,1,0,1,0.24166666666666667
增强运算,0,0,0,0,0,1,0,1,0.24166666666666667
子策略,0,0,0,0,0,1,0,1,0.24166666666666667
离散优化,0,0,0,0,0,1,0,1,0.24166666666666667
几何变换,0,0,0,0,0,1,0,1,0.24166666666666667
颜色,0,0,0,0,0,1,0,1,0.24166666666666667
输出尺寸,0,0,0,0,2,0,0,2,0.48333333333333334
blackl,0,0,0,0,2,0,0,2,0.48333333333333334
fsfm网络,0,0,0,0,2,0,0,2,0.48333333333333334
层名,0,0,0,0,2,0,0,2,0.48333333333333334
后续网络,0,0,0,0,1,0,0,1,0.24166666666666667
特征层,0,0,0,3,6,0,0,9,1.825
fsfm结构,0,0,0,0,2,0,0,2,0.48333333333333334
总参数,0,0,0,0,1,0,0,1,0.24166666666666667
vgg-16模型,0,0,0,0,1,0,0,1,0.24166666666666667
block块,0,0,0,0,1,0,0,1,0.24166666666666667
三通道彩色图像,0,0,0,0,1,0,0,1,0.24166666666666667
56,0,0,0,0,1,0,0,1,0.24166666666666667
图像重塑,0,0,0,0,1,0,0,1,0.24166666666666667
简化网络,0,0,0,0,1,0,0,1,0.24166666666666667
卷积神经网,0,0,0,0,1,0,0,1,0.24166666666666667
池化核参数,0,0,0,0,1,0,0,1,0.24166666666666667
填充,0,0,0,0,1,0,0,1,0.24166666666666667
卷积核尺寸,0,0,0,0,1,0,0,1,0.24166666666666667
height,0,0,0,0,1,0,0,1,0.24166666666666667
width,0,0,0,0,1,0,0,1,0.24166666666666667
kernelsize,0,0,0,0,1,0,0,1,0.24166666666666667
网络结构,0,0,2,0,1,0,0,3,0.4916666666666667
分辨率,0,0,5,4,9,0,0,18,3.3
图像金字塔,0,0,3,2,0,0,0,5,0.625
目标检测框架,0,0,3,0,1,0,0,4,0.6166666666666667
fcns,0,0,2,0,0,0,0,2,0.25
天空,0,0,2,0,0,0,0,2,0.25
通用数据集,0,0,2,0,2,0,0,4,0.7333333333333334
tridentnetwork,0,0,2,0,0,0,0,2,0.25
采样策略,0,0,2,0,0,0,0,2,0.25
sniper,0,0,2,0,0,0,0,2,0.25
snip,0,0,3,7,0,0,0,10,1.25
上下文信息,0,0,2,0,0,0,0,2,0.25
dssd,0,0,2,0,0,0,0,2,0.25
mscoco,0,0,2,0,0,0,0,2,0.25
yolov3,0,0,2,0,0,0,0,2,0.25
yolov2,0,0,2,0,0,0,0,2,0.25
yolo,0,0,2,2,0,0,0,4,0.5
区域提名,0,0,2,0,0,0,0,2,0.25
训练过程,0,0,1,0,0,0,0,1,0.125
网络优化,0,0,1,0,0,0,0,1,0.125
实时检测,0,0,1,0,0,0,0,1,0.125
自动驾驶汽车,0,0,1,0,0,0,0,1,0.125
检测效率,0,0,1,0,0,0,0,1,0.125
注意力机制,0,0,1,0,1,0,0,2,0.3666666666666667
自动驾驶,0,0,1,0,0,0,0,1,0.125
细粒度,0,0,1,0,0,0,0,1,0.125
递归神经网络,0,0,1,0,0,0,0,1,0.125
neuralnet,0,0,1,0,0,0,0,1,0.125
knowledge-basedrecurrentattentive,0,0,1,0,0,0,0,1,0.125
递归注意神经网络,0,0,1,0,0,0,0,1,0.125
知识,0,0,1,0,0,0,0,1,0.125
小图标,0,0,1,0,0,0,0,1,0.125
交通标志图像,0,0,1,0,0,0,0,1,0.125
光学遥感目标,0,0,1,0,0,0,0,1,0.125
遥感目标,0,0,1,0,0,0,0,1,0.125
遥感对象,0,0,1,0,0,0,0,1,0.125
共享特征,0,0,1,0,0,0,0,1,0.125
高分辨率特征图,0,0,1,0,1,0,0,2,0.3666666666666667
跳层,0,0,1,0,0,0,0,1,0.125
自顶,0,0,1,0,0,0,0,1,0.125
光学遥感图像,0,0,1,0,0,0,0,1,0.125
svm,0,0,1,0,0,0,0,1,0.125
supportvectormachi,0,0,1,0,0,0,0,1,0.125
向量机,0,0,1,0,0,0,0,1,0.125
全卷积网络,0,0,1,0,0,0,0,1,0.125
cnn检测器,0,0,1,0,0,0,0,1,0.125
小鸟,0,0,1,0,0,0,0,1,0.125
鸟类生态自动调查,0,0,1,0,0,0,0,1,0.125
遥感图像,0,0,1,0,0,0,0,1,0.125
损失均衡,0,0,1,0,0,0,0,1,0.125
空间均衡,0,0,1,0,0,0,0,1,0.125
采样均衡,0,0,1,0,0,0,0,1,0.125
平衡,0,0,1,0,0,0,0,1,0.125
小目标特征,0,0,1,0,0,0,0,1,0.125
目标数据,0,0,1,0,0,0,0,1,0.125
数据增广,0,0,1,0,0,0,0,1,0.125
isantal,0,0,1,0,0,0,0,1,0.125
共享网络,0,0,1,0,0,0,0,1,0.125
单尺度图像,0,0,1,0,0,0,0,1,0.125
tridentnetworks,0,0,1,0,0,0,0,1,0.125
三叉戟网络,0,0,1,0,0,0,0,1,0.125
多分支图像训练,0,0,1,0,0,0,0,1,0.125
采样,0,0,1,1,1,0,0,3,0.4916666666666667
forimagepyramid,0,0,1,0,0,0,0,1,0.125
scalenonnalization,0,0,1,0,0,0,0,1,0.125
图像金字塔尺度,0,0,1,0,0,0,0,1,0.125
高效重采样,0,0,1,0,0,0,0,1,0.125
信息表达,0,0,1,0,0,0,0,1,0.125
domain-shift,0,0,1,1,0,0,0,2,0.25
域移位,0,0,1,0,0,0,0,1,0.125
损失回传,0,0,1,0,0,0,0,1,0.125
forimagepyramids,0,0,1,0,0,0,0,1,0.125
scalenormaliza,0,0,1,0,0,0,0,1,0.125
深度,0,0,1,0,0,0,0,1,0.125
rollingconvolution,0,0,1,0,0,0,0,1,0.125
recurrent,0,0,1,0,0,0,0,1,0.125
循环滚动卷积,0,0,1,0,0,0,0,1,0.125
低维信息,0,0,1,0,0,0,0,1,0.125
沙漏结构,0,0,1,0,0,0,0,1,0.125
反卷积层,0,0,1,0,0,0,0,1,0.125
resnet-100,0,0,1,0,0,0,0,1,0.125
ingleshotdetector,0,0,1,0,0,0,0,1,0.125
deconvolutionals,0,0,1,0,0,0,0,1,0.125
ssd检测算法,0,0,1,0,0,0,0,1,0.125
强语义,0,0,1,1,0,0,0,2,0.25
横向连接网络,0,0,1,1,0,0,0,2,0.25
侧边融合通道,0,0,1,0,0,0,0,1,0.125
上采样,0,0,1,8,1,0,0,10,1.3666666666666667
featurepyramidnet,0,0,1,0,0,0,0,1,0.125
特征金字塔网络,0,0,1,0,0,0,0,1,0.125
复杂数据集,0,0,1,0,0,0,0,1,0.125
pascalvocu,0,0,1,0,0,0,0,1,0.125
目标数据集,0,0,1,1,0,0,0,2,0.25
darknet-53,0,0,1,0,0,0,0,1,0.125
残差结构,0,0,1,0,0,0,0,1,0.125
运算量,0,0,1,0,0,0,0,1,0.125
vgg-16u5,0,0,1,0,0,0,0,1,0.125
darknet-19,0,0,1,0,0,0,0,1,0.125
rs,0,0,1,0,0,0,0,1,0.125
多尺度检测,0,0,1,0,0,0,0,1,0.125
passthroughlayer,0,0,1,0,0,0,0,1,0.125
跨越层,0,0,1,0,0,0,0,1,0.125
yolov2z,0,0,1,0,0,0,0,1,0.125
长宽比,0,0,1,1,0,2,0,4,0.7333333333333334
连接层,0,0,1,0,0,0,0,1,0.125
分类网络,0,0,1,1,0,0,0,2,0.25
边界特征,0,0,1,0,0,0,0,1,0.125
网格,0,0,1,1,0,0,0,2,0.25
候选区,0,0,1,0,0,0,0,1,0.125
回归问题,0,0,1,0,0,0,0,1,0.125
物体检测任务,0,0,1,0,0,0,0,1,0.125
端到端训练,0,0,1,0,0,0,0,1,0.125
深度学习算法,0,0,1,0,0,0,0,1,0.125
回全卷积网络,0,0,1,0,0,0,0,1,0.125
regionproposalnetworks,0,0,1,0,0,0,0,1,0.125
多任务损失函数,0,0,1,0,0,0,0,1,0.125
加速,0,0,1,0,0,0,0,1,0.125
正反向训练,0,0,1,0,0,0,0,1,0.125
分层采样,0,0,1,0,0,0,0,1,0.125
随机采样,0,0,1,0,0,0,0,1,0.125
fastregionconvolutionalneuralnetworks,0,0,1,0,0,0,0,1,0.125
单尺度,0,0,1,0,0,0,0,1,0.125
多尺度,0,0,1,0,0,0,0,1,0.125
spp层,0,0,1,0,0,0,0,1,0.125
spatialpyramidpoolingnetworks,0,0,1,0,0,0,0,1,0.125
手工滑动窗口,0,0,1,0,0,0,0,1,0.125
regionconvolutionalneuralnetworks,0,0,1,0,0,0,0,1,0.125
singleshotmultiboxdetector,0,0,1,0,0,0,0,1,0.125
okonce,0,0,1,0,0,0,0,1,0.125
endtoend,0,0,1,0,0,0,0,1,0.125
lyconvolutionalnetworks,0,0,1,0,0,0,0,1,0.125
region-based,0,0,1,0,0,0,0,1,0.125
fasterregionconvolutionalneuralnetworks,0,0,1,0,0,0,0,1,0.125
sal,0,0,1,0,0,0,0,1,0.125
region,0,0,1,0,0,0,0,1,0.125
convolutionalneuralnet,0,0,1,0,0,0,0,1,0.125
挤压操作,0,0,0,0,4,0,0,4,0.9666666666666667
特征通道,0,0,0,0,4,0,0,4,0.9666666666666667
激励操作,0,0,0,0,3,0,0,3,0.725
sigmoid,0,0,0,0,2,0,0,2,0.48333333333333334
relu激活函数,0,0,0,0,2,0,0,2,0.48333333333333334
fscaze,0,0,0,0,1,0,0,1,0.24166666666666667
向量积,0,0,0,0,1,0,0,1,0.24166666666666667
权值矩阵,0,0,0,0,1,0,0,1,0.24166666666666667
hxwxc,0,0,0,0,1,0,0,1,0.24166666666666667
xc,0,0,0,0,1,0,0,1,0.24166666666666667
激励,0,0,0,0,1,0,0,1,0.24166666666666667
lxlxc,0,0,0,0,1,0,0,1,0.24166666666666667
挤压,0,0,0,0,1,0,0,1,0.24166666666666667
注意力增强模块,0,0,0,0,1,0,0,1,0.24166666666666667
非互斥关系,0,0,0,0,1,0,0,1,0.24166666666666667
非线性交互,0,0,0,0,1,0,0,1,0.24166666666666667
相关性,0,0,0,0,1,0,0,1,0.24166666666666667
信道,0,0,0,0,1,0,0,1,0.24166666666666667
实数,0,0,0,0,1,0,0,1,0.24166666666666667
空间压缩特征,0,0,0,0,1,0,0,1,0.24166666666666667
sq,0,0,0,0,1,0,0,1,0.24166666666666667
通道权重,0,0,0,0,1,0,0,1,0.24166666666666667
通道注意力机制,0,0,0,0,1,0,0,1,0.24166666666666667
mateanchoro,0,0,0,1,0,0,0,1,0.125
动态生成,0,0,0,1,0,0,0,1,0.125
后景平衡,0,0,0,1,0,0,0,1,0.125
图像尺度,0,0,1,3,2,0,0,6,0.9833333333333334
fpn,0,0,1,5,4,0,0,10,1.7166666666666668
一步检测算法,0,0,0,1,0,0,0,1,0.125
两步检测,0,0,0,1,0,0,0,1,0.125
摩托车,0,0,0,0,3,0,0,3,0.725
自行车,0,0,0,0,3,0,0,3,0.725
电视,0,0,0,0,2,0,0,2,0.48333333333333334
瓶子,0,0,0,0,2,0,0,2,0.48333333333333334
椅子,0,0,0,0,2,0,0,2,0.48333333333333334
盆栽,0,0,0,0,2,0,0,2,0.48333333333333334
bot,0,0,0,0,2,0,0,2,0.48333333333333334
voc2007,0,0,0,0,2,0,0,2,0.48333333333333334
pascalvoc,0,0,0,0,3,0,0,3,0.725
比值,0,0,0,0,1,0,0,1,0.24166666666666667
小汽车,0,0,0,0,1,0,0,1,0.24166666666666667
特征优化,0,0,0,0,1,0,0,1,0.24166666666666667
白棋,0,0,0,0,1,0,0,1,0.24166666666666667
黑白棋,0,0,0,0,1,0,0,1,0.24166666666666667
背景特征,0,0,0,0,1,0,0,1,0.24166666666666667
目标特征,0,0,0,0,1,0,0,1,0.24166666666666667
背景墙,0,0,0,0,1,0,0,1,0.24166666666666667
遮挡物,0,0,0,0,1,0,0,1,0.24166666666666667
chair,0,0,0,0,1,0,0,1,0.24166666666666667
plant,0,0,0,0,1,0,0,1,0.24166666666666667
mbike,0,0,0,0,1,0,0,1,0.24166666666666667
bike,0,0,0,0,1,0,0,1,0.24166666666666667
中大型数据集,0,0,0,0,1,0,0,1,0.24166666666666667
pers,0,0,0,0,1,0,0,1,0.24166666666666667
hors,0,0,0,0,1,0,0,1,0.24166666666666667
性能床,0,0,0,0,1,0,0,1,0.24166666666666667
voc2012trainval集,0,0,0,0,1,0,0,1,0.24166666666666667
voc2007trainval集,0,0,0,0,1,0,0,1,0.24166666666666667
pascalz,0,0,0,0,1,0,0,1,0.24166666666666667
robots,0,0,0,0,1,0,0,1,0.24166666666666667
voc2012,0,0,0,0,1,0,0,1,0.24166666666666667
计算机视觉社区竞赛,0,0,0,0,1,0,0,1,0.24166666666666667
小缺陷检测,0,0,1,0,0,0,0,1,0.125
目标增强,0,0,1,0,0,0,0,1,0.125
特征尺度融合,0,1,1,0,0,0,0,2,2.125
绪论,0,0,1,0,0,0,0,1,0.125
检测算,0,0,0,1,0,0,0,1,0.125
目标边框,0,0,0,1,0,0,0,1,0.125
候选,0,0,0,3,0,0,0,3,0.375
视频,0,0,0,1,0,0,0,1,0.125
最大池化,0,0,0,0,5,0,0,5,1.2083333333333333
超像素卷积层,0,0,0,0,3,0,0,3,0.725
反卷积,0,0,0,1,3,0,0,4,0.85
低分辨率特征,0,0,0,0,2,0,0,2,0.48333333333333334
高层特征,0,0,0,3,2,0,0,5,0.8583333333333334
周期性像素重排函数,0,0,0,0,2,0,0,2,0.48333333333333334
上采样因子,0,0,0,0,2,0,0,2,0.48333333333333334
卷积操,0,0,0,0,2,0,0,2,0.48333333333333334
图像重建,0,0,0,0,2,0,0,2,0.48333333333333334
图像超分辨率重建技术,0,0,0,0,2,0,0,2,0.48333333333333334
低分辨率,0,0,0,0,2,0,0,2,0.48333333333333334
高层特征图,0,0,0,0,2,0,0,2,0.48333333333333334
反向传播,0,0,0,0,2,0,0,2,0.48333333333333334
特征点,0,0,0,0,2,0,0,2,0.48333333333333334
融合,0,0,0,0,2,0,0,2,0.48333333333333334
位置信息,0,0,0,0,1,0,0,1,0.24166666666666667
低层特征,0,0,0,3,2,0,0,5,0.8583333333333334
损失函数数学,0,0,0,0,1,0,0,1,0.24166666666666667
训练网络,0,0,0,0,1,0,0,1,0.24166666666666667
mse,0,0,0,0,1,0,0,1,0.24166666666666667
像素均方误差,0,0,0,0,1,0,0,1,0.24166666666666667
ilr,0,0,0,0,1,0,0,1,0.24166666666666667
高分辨率特征,0,0,0,0,1,0,0,1,0.24166666666666667
数学公式,0,0,0,0,1,0,0,1,0.24166666666666667
高度,0,0,0,0,1,2,0,3,0.725
宽度,0,0,0,0,1,2,0,3,0.725
重建,0,0,0,0,1,0,0,1,0.24166666666666667
图像超分辨率重建,0,0,0,0,1,0,0,1,0.24166666666666667
fiqlr,0,0,0,0,1,0,0,1,0.24166666666666667
高分辨率图像,0,0,0,0,1,0,0,1,0.24166666666666667
wx,0,0,0,0,1,0,0,1,0.24166666666666667
rxr区域,0,0,0,0,1,0,0,1,0.24166666666666667
hr图像,0,0,0,0,1,0,0,1,0.24166666666666667
向量偏置,0,0,0,0,1,0,0,1,0.24166666666666667
特征数量,0,0,0,0,1,0,0,1,0.24166666666666667
2d卷积张量,0,0,0,0,1,0,0,1,0.24166666666666667
偏差,0,0,0,0,1,0,0,1,0.24166666666666667
权值,0,0,0,0,1,0,0,1,0.24166666666666667
重建网络,0,0,0,0,1,0,0,1,0.24166666666666667
特征通道数,0,0,0,0,1,0,0,1,0.24166666666666667
lr特征,0,0,0,0,1,0,0,1,0.24166666666666667
低分辨率图像,0,0,0,0,1,0,0,1,0.24166666666666667
重建过程,0,0,0,0,1,0,0,1,0.24166666666666667
高清图像,0,0,0,0,1,0,0,1,0.24166666666666667
resolution,0,0,0,0,1,0,0,1,0.24166666666666667
模糊图像,0,0,0,0,1,0,0,1,0.24166666666666667
lowresolution,0,0,0,0,1,0,0,1,0.24166666666666667
大尺寸特征图,0,0,0,0,1,0,0,1,0.24166666666666667
小特征图,0,0,0,0,1,0,0,1,0.24166666666666667
低层特征图,0,0,0,0,1,0,0,1,0.24166666666666667
反向传播过程,0,0,0,0,1,0,0,1,0.24166666666666667
前向,0,0,0,0,1,0,0,1,0.24166666666666667
前向传播,0,0,0,0,1,0,0,1,0.24166666666666667
纹理信息,0,0,0,0,1,0,0,1,0.24166666666666667
偏移,0,0,0,0,1,0,0,1,0.24166666666666667
均值,0,0,0,0,1,0,0,1,0.24166666666666667
参数误差,0,0,0,0,1,0,0,1,0.24166666666666667
伸缩,0,0,0,0,1,0,0,1,0.24166666666666667
标注框,0,0,0,0,0,3,0,3,0.725
粘贴,0,0,0,0,0,2,0,2,0.48333333333333334
标注,0,0,0,0,0,2,0,2,0.48333333333333334
绝对大小,0,0,0,0,0,2,0,2,0.48333333333333334
红色框,0,0,0,0,0,1,0,1,0.24166666666666667
原始缺陷,0,0,0,0,0,1,0,1,0.24166666666666667
黑色框,0,0,0,0,0,1,0,1,0.24166666666666667
新缺陷集灯,0,0,0,0,0,1,0,1,0.24166666666666667
ifmean,0,0,0,0,0,1,0,1,0.24166666666666667
掩膜区域,0,0,0,0,0,1,0,1,0.24166666666666667
ylilx2i,0,0,0,0,0,1,0,1,0.24166666666666667
刃和,0,0,0,0,0,1,0,1,0.24166666666666667
中心,0,0,0,0,0,1,0,1,0.24166666666666667
缺陷实例,0,0,0,0,0,1,0,1,0.24166666666666667
中心点,0,0,0,0,0,1,0,1,0.24166666666666667
空集,0,0,0,0,0,1,0,1,0.24166666666666667
灰色轮毂,0,0,0,0,0,1,0,1,0.24166666666666667
增强图像,0,0,0,0,0,1,0,1,0.24166666666666667
新缺陷集,0,0,0,0,0,1,0,1,0.24166666666666667
复次数,0,0,0,0,0,1,0,1,0.24166666666666667
缺陷集,0,0,0,0,0,1,0,1,0.24166666666666667
候选中心,0,0,0,0,0,1,0,1,0.24166666666666667
缺陷掩膜,0,0,0,0,0,1,0,1,0.24166666666666667
坐标点,0,0,0,0,0,1,0,1,0.24166666666666667
非轮毂区域,0,0,0,0,0,1,0,1,0.24166666666666667
轮毂区域,0,0,0,0,0,1,0,1,0.24166666666666667
二值,0,0,0,0,0,1,0,1,0.24166666666666667
像素值,0,0,0,0,0,1,0,1,0.24166666666666667
空白区域,0,0,0,0,0,1,0,1,0.24166666666666667
灰度图,0,0,0,0,0,1,0,1,0.24166666666666667
图像区域,0,0,0,0,0,1,0,1,0.24166666666666667
可粘贴区域,0,0,0,0,0,1,0,1,0.24166666666666667
增强流程,0,0,0,0,0,1,0,1,0.24166666666666667
外接矩形框,0,0,0,0,0,1,0,1,0.24166666666666667
一级缺陷,0,0,0,0,0,1,0,1,0.24166666666666667
三级缺陷,0,0,0,0,0,1,0,1,0.24166666666666667
目标检测数据集,0,0,0,0,0,1,0,1,0.24166666666666667
x光数据,0,0,0,0,0,1,0,1,0.24166666666666667
x光,0,0,0,0,0,1,0,1,0.24166666666666667
mscooc数据集,0,0,0,0,0,1,0,1,0.24166666666666667
wij,0,0,0,0,0,1,0,1,0.24166666666666667
ze,0,0,0,0,0,1,0,1,0.24166666666666667
tive,0,0,0,0,0,1,0,1,0.24166666666666667
re,0,0,0,0,0,1,0,1,0.24166666666666667
absolutesize,0,0,0,0,0,1,0,1,0.24166666666666667
轮辐,0,0,0,0,0,1,0,1,0.24166666666666667
工业专家,0,0,0,0,0,1,0,1,0.24166666666666667
数据集样式,0,0,0,0,0,1,0,1,0.24166666666666667
mscoc0,0,0,0,0,0,1,0,1,0.24166666666666667
文件,0,0,0,0,0,1,0,1,0.24166666666666667
边框,0,0,0,0,0,1,0,1,0.24166666666666667
注释工具,0,0,0,0,0,1,0,1,0.24166666666666667
原始图像,0,0,0,0,0,1,0,1,0.24166666666666667
轮毂x光,0,0,0,0,0,1,0,1,0.24166666666666667
dicastal,0,0,0,0,0,1,0,1,0.24166666666666667
标准数据集,0,0,0,0,0,1,0,1,0.24166666666666667
微小缺陷,0,0,0,0,0,1,0,1,0.24166666666666667
缺陷级别,0,0,0,0,0,1,0,1,0.24166666666666667
缺陷检测,0,0,0,0,0,1,0,1,0.24166666666666667
x射线检测,0,0,0,0,0,1,0,1,0.24166666666666667
金属部件,0,0,0,0,0,1,0,1,0.24166666666666667
汽车工业,0,0,0,0,0,1,0,1,0.24166666666666667
优化网络,0,0,0,0,0,0,1,1,0.24166666666666667
特征维度,0,0,0,0,0,0,1,1,0.24166666666666667
小目标检测技术,0,0,0,0,0,0,1,1,0.24166666666666667
救援,0,0,0,0,0,0,1,1,0.24166666666666667
安全,0,0,0,0,0,0,1,1,0.24166666666666667
小目标检测精度,0,0,0,0,1,0,0,1,0.24166666666666667
小目标图像,0,0,0,0,1,0,0,1,0.24166666666666667
voc±,0,0,0,0,1,0,0,1,0.24166666666666667
fasterr-cnn检测框架,0,0,0,0,1,0,0,1,0.24166666666666667
无用特征,0,0,0,0,2,0,0,2,0.48333333333333334
抑制,0,0,0,0,2,0,0,2,0.48333333333333334
featurescaleenhancementmodule,0,0,0,0,1,0,0,1,0.24166666666666667
关键信息,0,0,0,0,1,0,0,1,0.24166666666666667
背包,0,0,0,0,1,0,0,1,0.24166666666666667
上半身,0,0,0,0,1,0,0,1,0.24166666666666667
行人,0,0,0,0,1,0,0,1,0.24166666666666667
行人检测,0,0,0,0,1,0,0,1,0.24166666666666667
人脑,0,0,0,0,1,0,0,1,0.24166666666666667
注意力焦点,0,0,0,0,1,0,0,1,0.24166666666666667
定位过程,0,0,0,0,1,0,0,1,0.24166666666666667
转换,0,0,0,0,1,0,0,1,0.24166666666666667
变换,0,0,0,0,1,0,0,1,0.24166666666666667
特征尺度增强算法,0,0,0,0,1,0,0,1,0.24166666666666667
特征融合,0,0,0,0,1,0,0,1,0.24166666666666667
小目标分辨率,0,0,0,1,0,0,0,1,0.125
图片,0,0,0,2,0,0,0,2,0.25
sjnax,0,0,0,1,0,0,0,1,0.125
特征层数,0,0,0,1,0,0,0,1,0.125
smin,0,0,0,1,0,0,0,1,0.125
正方形,0,0,0,1,0,0,0,1,0.125
anchor尺度,0,0,0,1,0,0,0,1,0.125
anchor思想,0,0,0,1,0,0,0,1,0.125
重叠,0,0,0,1,0,0,0,1,0.125
anchor尺寸设计,0,0,0,1,0,0,0,1,0.125
覆盖,0,0,0,1,0,0,0,1,0.125
误差,0,0,0,1,0,0,0,1,0.125
roundtruth,0,0,0,1,0,0,0,1,0.125
defaultbox,0,0,0,1,0,0,0,1,0.125
特征金字塔,0,0,0,3,0,0,0,3,0.375
单层特征图,0,0,0,1,0,0,0,1,0.125
底层,0,0,0,1,0,0,0,1,0.125
cnn网络,0,0,0,1,0,0,0,1,0.125
多尺度特征图,0,0,0,1,0,0,0,1,0.125
maximumsuppression,0,0,0,1,0,0,0,1,0.125
非极大值抑制,0,0,0,1,0,0,0,1,0.125
预测框,0,0,0,1,0,0,0,1,0.125
fc8,0,0,0,1,0,0,0,1,0.125
dropout层,0,0,0,1,0,0,0,1,0.125
均匀密集采样,0,0,0,1,0,0,0,1,0.125
抽样,0,0,0,1,0,0,0,1,0.125
密集抽样,0,0,0,1,0,0,0,1,0.125
优化算法,0,0,0,0,1,0,0,1,0.24166666666666667
增强预测,0,0,0,0,1,0,0,1,0.24166666666666667
融合预测,0,0,0,0,1,0,0,1,0.24166666666666667
准确位置信息,0,0,0,0,1,0,0,1,0.24166666666666667
横向连接,0,0,0,2,0,0,0,2,0.25
小目标信息,0,0,0,1,0,0,0,1,0.125
nms,0,0,0,1,0,0,0,1,0.125
rescale,0,0,0,1,0,0,0,1,0.125
重塑,0,0,0,1,0,0,0,1,0.125
cnn分支,0,0,0,1,0,0,0,1,0.125
图像输入,0,0,0,1,0,0,0,1,0.125
snip算法,0,0,0,1,0,0,0,1,0.125
mst,0,0,0,1,0,0,0,1,0.125
回传损失,0,0,0,1,0,0,0,1,0.125
mst性能,0,0,0,1,0,0,0,1,0.125
multi-scaletra,0,0,0,1,0,0,0,1,0.125
多尺度训练,0,0,0,1,0,0,0,1,0.125
混叠效应,0,0,0,1,0,0,0,1,0.125
融合结果,0,0,0,1,0,0,0,1,0.125
复杂度,0,0,0,1,0,0,0,1,0.125
线性插值,0,0,0,1,0,0,0,1,0.125
邻上采样,0,0,0,1,0,0,0,1,0.125
upsampling,0,0,0,1,0,0,0,1,0.125
fpn算法,0,0,0,1,0,0,0,1,0.125
弱特征,0,0,0,1,0,0,0,1,0.125
鲁棒,0,0,0,1,0,0,0,1,0.125
深层网络,0,0,0,1,0,0,0,1,0.125
最高卷积层,0,0,0,1,0,0,0,1,0.125
金字塔,0,0,0,1,0,0,0,1,0.125
特征空间,0,0,0,1,0,0,0,1,0.125
内存,0,0,0,1,0,0,0,1,0.125
图像金字塔模型,0,0,0,1,0,0,0,1,0.125
侧边,0,0,0,1,0,0,0,1,0.125
提取特征,0,0,0,1,0,0,0,1,0.125
featurescalefusionmodule,0,0,0,0,1,0,0,1,0.24166666666666667
多尺度特征,0,0,0,0,1,0,0,1,0.24166666666666667
高层特征分辨率,0,0,0,0,1,0,0,1,0.24166666666666667
空间信息,0,0,0,0,1,0,0,1,0.24166666666666667
特征尺度融合算法,0,0,0,0,1,0,0,1,0.24166666666666667
特征尺度增强,0,1,0,0,0,0,0,1,2.0
样本均衡,0,1,0,0,0,0,0,1,2.0
图像特征图,1,0,0,0,0,0,0,1,1.0
增强优化结构,1,0,0,0,0,0,0,1,1.0
小目标检测任,1,0,0,0,0,0,0,1,1.0
计算机视觉领,1,0,0,0,0,0,0,1,1.0
卷积神经网络技术,1,0,0,0,0,0,0,1,1.0
